"","stat_area","tow_id","survey","year","month","day","doy","tow_duration","lat","lon","catch_n","catch_n_f","catch_n_m","catch_n_a","catch_n_j","vessel","area_swept"
"1",513,"FL00.1","ME",2000,10,30,304,17,43.0215,-70.5658,15,7,8,13,2,"ME",11.22
"2",513,"FL00.10","ME",2000,11,3,308,20,43.4209,-70.2942,165,66,99,95,70,"ME",15.8
"3",513,"FL00.11","ME",2000,11,3,308,20,43.5055,-70.3494,2,1,1,1,1,"ME",18.8
"4",513,"FL00.12","ME",2000,11,4,309,20,43.512,-70.1943,170,89,81,80,90,"ME",17
"5",513,"FL00.13","ME",2000,11,4,309,20,43.3987,-70.2338,44,22,22,28,16,"ME",18.6
"6",513,"FL00.14","ME",2000,11,4,309,18,43.4058,-70.138,3,1,2,3,0,"ME",13.32
"7",513,"FL00.16","ME",2000,11,4,309,20,43.5177,-70.1136,129,70,59,73,56,"ME",19.6
"8",513,"FL00.17","ME",2000,11,6,311,20,43.6487,-70.0962,149,82,67,73,76,"ME",19
"9",513,"FL00.18","ME",2000,11,6,311,20,43.725,-69.9106,3,2,1,2,1,"ME",23
"10",513,"FL00.19","ME",2000,11,7,312,20,43.5986,-69.875,35,19,16,31,4,"ME",20.2
"11",513,"FL00.2","ME",2000,10,30,304,20,43.002,-70.5171,14,5,9,14,0,"ME",16.4
"12",513,"FL00.20","ME",2000,11,7,312,20,43.6476,-69.8064,106,54,52,98,8,"ME",22.8
"13",513,"FL00.21","ME",2000,11,7,312,20,43.7114,-69.7724,17,9,8,12,5,"ME",15.4
"14",513,"FL00.22","ME",2000,11,8,313,20,43.7935,-69.6454,113,55,58,38,75,"ME",17.4
"15",513,"FL00.23","ME",2000,11,8,313,20,43.742,-69.6499,449,246,203,298,151,"ME",15.2
"16",513,"FL00.24","ME",2000,11,8,313,20,43.5411,-69.6942,1,1,0,1,0,"ME",18.6
"17",513,"FL00.25","ME",2000,11,8,313,18,43.6245,-69.6013,8,7,1,8,0,"ME",16.2
"18",513,"FL00.26","ME",2000,11,9,314,16,43.8046,-69.5291,575,309,266,289,286,"ME",9.28
"19",513,"FL00.27","ME",2000,11,9,314,18,43.8251,-69.4877,239,156,83,147,92,"ME",12.42
"20",513,"FL00.28","ME",2000,11,9,314,18,43.904,-69.456,12,7,5,4,8,"ME",13.86
"21",512,"FL00.29","ME",2000,11,10,315,14,43.7021,-69.2933,4,2,2,4,0,"ME",7.98
"22",513,"FL00.3","ME",2000,11,1,306,20,42.9354,-70.7462,33,14,19,20,13,"ME",17.8
"23",512,"FL00.30","ME",2000,11,10,315,20,43.8446,-69.2924,517,209,308,264,253,"ME",19.8
"24",512,"FL00.31","ME",2000,11,13,318,19,43.8351,-69.1135,259,105,154,160,99,"ME",17.1
"25",512,"FL00.32","ME",2000,11,13,318,18,43.858,-69.0842,613,333,280,483,130,"ME",19.98
"26",512,"FL00.33","ME",2000,11,13,318,20,43.9265,-69.122,466,333,133,254,212,"ME",18.8
"27",512,"FL00.34","ME",2000,11,13,318,20,43.953,-69.1426,906,398,508,437,469,"ME",15.8
"28",512,"FL00.35","ME",2000,11,14,319,20,44.39937,-68.8781,4,0,4,4,0,"ME",21.4
"29",512,"FL00.37","ME",2000,11,14,319,20,44.1872,-68.8967,6,2,4,4,2,"ME",20.4
"30",512,"FL00.38","ME",2000,11,14,319,20,44.1306,-68.9756,10,2,8,10,0,"ME",22.2
"31",512,"FL00.39","ME",2000,11,15,320,10,43.8507,-68.9297,3,3,0,3,0,"ME",5.6
"32",513,"FL00.4","ME",2000,11,1,306,20,42.9555,-70.6667,47,19,28,41,6,"ME",18.8
"33",512,"FL00.40","ME",2000,11,16,321,16,43.9285,-68.8612,242,124,118,231,11,"ME",12
"34",512,"FL00.41","ME",2000,11,16,321,17,43.9258,-68.7467,71,33,38,69,2,"ME",14.28
"35",512,"FL00.42","ME",2000,11,16,321,25,43.8859,-68.7451,124,77,47,117,7,"ME",19
"36",512,"FL00.44","ME",2000,11,20,325,16,43.9039,-68.6356,9,5,4,8,1,"ME",15.2
"37",512,"FL00.45","ME",2000,11,21,326,18,44.1566,-68.544,50,16,34,43,7,"ME",17.82
"38",512,"FL00.46","ME",2000,11,21,326,20,44.0078,-68.5552,27,8,19,27,0,"ME",28.2
"39",512,"FL00.47","ME",2000,11,21,326,20,43.9073,-68.5372,9,3,6,9,0,"ME",17.8
"40",512,"FL00.48","ME",2000,11,21,326,19,44.0436,-68.3214,16,9,7,14,2,"ME",17.86
"41",512,"FL00.49","ME",2000,11,22,327,20,44.134,-68.2498,23,7,16,22,1,"ME",17.4
"42",513,"FL00.5","ME",2000,11,1,306,20,42.9528,-70.5948,71,26,45,51,20,"ME",16.6
"43",512,"FL00.50","ME",2000,11,22,327,25,44.2142,-68.4205,48,19,29,44,4,"ME",24.75
"44",512,"FL00.52","ME",2000,11,27,332,20,44.1185,-68.1016,27,11,16,27,0,"ME",19.8
"45",512,"FL00.53","ME",2000,11,27,332,20,44.2217,-68.075,15,10,5,14,1,"ME",19.4
"46",512,"FL00.54","ME",2000,11,28,333,20,44.3068,-68.1718,96,50,46,48,48,"ME",20.2
"47",512,"FL00.55","ME",2000,11,28,333,20,44.2889,-68.1292,70,33,37,57,13,"ME",20.6
"48",512,"FL00.56","ME",2000,11,28,333,20,44.3618,-68.1563,7,6,1,7,0,"ME",20.2
"49",513,"FL00.6","ME",2000,11,1,306,20,42.9808,-70.6519,72,29,43,60,12,"ME",23.2
"50",512,"FL00.60","ME",2000,11,29,334,22,44.1623,-67.9533,6,2,4,3,3,"ME",22.66
"51",512,"FL00.61","ME",2000,11,29,334,19,44.2915,-67.9933,43,18,25,38,5,"ME",17.67
"52",511,"FL00.62","ME",2000,11,30,335,15,44.2968,-67.8075,64,35,29,25,39,"ME",14.85
"53",511,"FL00.63","ME",2000,11,30,335,22,44.3341,-67.8553,55,24,31,44,11,"ME",22.66
"54",511,"FL00.64","ME",2000,11,30,335,20,44.3863,-67.9405,18,4,14,17,1,"ME",22.8
"55",511,"FL00.66","ME",2000,12,1,336,20,44.2711,-67.6418,2,2,0,2,0,"ME",15.6
"56",511,"FL00.67","ME",2000,12,1,336,21,44.3,-67.6885,9,4,5,9,0,"ME",29.61
"57",511,"FL00.68","ME",2000,12,1,336,20,44.4185,-67.7505,69,31,38,59,10,"ME",30
"58",511,"FL00.69","ME",2000,12,1,336,20,44.4548,-67.7262,20,10,10,18,2,"ME",16.6
"59",513,"FL00.7","ME",2000,11,2,307,20,43.0692,-70.4196,18,12,6,18,0,"ME",19.2
"60",511,"FL00.70","ME",2000,12,2,337,20,44.4566,-67.6402,157,66,91,119,38,"ME",20.8
"61",511,"FL00.71","ME",2000,12,2,337,21,44.3866,-67.5442,49,23,26,40,9,"ME",23.73
"62",511,"FL00.72","ME",2000,12,2,337,22,44.4561,-67.382,54,28,26,38,16,"ME",23.76
"63",511,"FL00.73","ME",2000,12,2,337,23,44.5413,-67.5056,108,63,45,72,36,"ME",24.38
"64",511,"FL00.74","ME",2000,12,3,338,20,44.5834,-67.3111,104,51,53,40,64,"ME",29.8
"65",511,"FL00.75","ME",2000,12,3,338,20,44.6099,-67.2209,17,4,13,16,1,"ME",30.2
"66",511,"FL00.76","ME",2000,12,3,338,15,44.4596,-67.2063,1,1,0,1,0,"ME",12.75
"67",511,"FL00.77","ME",2000,12,4,339,20,44.6956,-67.0423,36,14,22,30,6,"ME",23.2
"68",467,"FL00.78","ME",2000,12,4,339,20,44.6968,-66.9431,6,5,1,6,0,"ME",23.4
"69",513,"FL00.8","ME",2000,11,2,307,20,43.1421,-70.3947,59,20,39,54,5,"ME",24.2
"70",513,"FL00.9","ME",2000,11,3,308,14,43.2968,-70.4961,87,40,47,32,55,"ME",10.36
"71",513,"FL01.1","ME",2001,9,24,267,20,42.9337,-70.7499,216,118,98,142,74,"ME",13.6
"72",513,"FL01.10","ME",2001,9,26,269,21,42.9543,-70.4738,1,0,1,1,0,"ME",15.96
"73",513,"FL01.11","ME",2001,9,26,269,18,42.9383,-70.5113,10,5,5,10,0,"ME",17.82
"74",513,"FL01.12","ME",2001,9,27,270,20,43.3666,-70.1938,5,0,5,5,0,"ME",15
"75",513,"FL01.14","ME",2001,9,27,270,20,43.4205,-70.2323,53,26,27,45,8,"ME",19.8
"76",513,"FL01.15","ME",2001,9,27,270,19,43.4183,-70.2913,162,77,84,97,65,"ME",20.52
"77",513,"FL01.16","ME",2001,9,28,271,20,43.5317,-70.2805,266,137,129,133,133,"ME",15.4
"78",513,"FL01.17","ME",2001,9,28,271,15,43.4705,-70.2679,218,107,111,143,75,"ME",9
"79",513,"FL01.18","ME",2001,10,1,274,20,43.6681,-69.9757,368,185,183,91,277,"ME",23.2
"80",513,"FL01.19","ME",2001,10,1,274,20,43.519,-70.0311,4,2,2,0,4,"ME",17
"81",513,"FL01.2","ME",2001,9,24,267,20,42.879,-70.6959,14,8,6,10,4,"ME",17.8
"82",513,"FL01.20","ME",2001,10,1,274,20,43.4967,-70.2088,326,150,176,108,218,"ME",18
"83",513,"FL01.21","ME",2001,10,2,275,21,43.5904,-69.9334,14,9,5,13,1,"ME",17.43
"84",513,"FL01.22","ME",2001,10,2,275,21,43.6036,-69.9005,24,9,15,18,6,"ME",17.64
"85",513,"FL01.23","ME",2001,10,2,275,22,43.6133,-69.8571,36,17,19,25,11,"ME",19.8
"86",513,"FL01.24","ME",2001,10,2,275,20,43.6515,-69.8086,60,34,26,56,4,"ME",16
"87",513,"FL01.25","ME",2001,10,2,275,17,43.7095,-69.7206,154,84,70,87,67,"ME",11.39
"88",513,"FL01.26","ME",2001,10,3,276,22,43.7803,-69.6945,758,339,419,310,448,"ME",19.36
"89",513,"FL01.27","ME",2001,10,3,276,20,43.6705,-69.8552,293,171,122,246,47,"ME",17.6
"90",513,"FL01.28","ME",2001,10,3,276,20,43.6736,-69.872,253,128,125,139,114,"ME",15.2
"91",513,"FL01.29","ME",2001,10,3,276,20,43.6963,-69.7634,310,168,142,223,87,"ME",16
"92",513,"FL01.3","ME",2001,9,24,267,20,42.8728,-70.6595,21,8,13,15,6,"ME",17.8
"93",513,"FL01.30","ME",2001,10,3,276,20,43.7059,-69.7443,316,157,159,248,68,"ME",16.2
"94",513,"FL01.31","ME",2001,10,4,277,21,43.7348,-69.6488,263,135,128,204,59,"ME",18.27
"95",513,"FL01.33","ME",2001,10,4,277,22,43.7344,-69.505,1,1,0,1,0,"ME",22.22
"96",513,"FL01.34","ME",2001,10,5,278,21,43.7227,-69.4074,4,3,1,4,0,"ME",19.53
"97",513,"FL01.35","ME",2001,10,5,278,20,43.8414,-69.4826,322,162,160,126,196,"ME",18.6
"98",513,"FL01.36","ME",2001,10,5,278,20,43.8566,-69.5279,350,160,187,134,216,"ME",17.4
"99",512,"FL01.37","ME",2001,10,8,281,20,43.8561,-69.0831,252,122,130,145,107,"ME",17.6
"100",512,"FL01.38","ME",2001,10,8,281,22,43.7979,-69.1223,58,28,30,44,14,"ME",23.1
"101",512,"FL01.39","ME",2001,10,8,281,15,43.759,-69.1287,3,3,0,3,0,"ME",11.1
"102",513,"FL01.4","ME",2001,9,24,267,20,42.8608,-70.7365,19,8,11,12,7,"ME",17.6
"103",512,"FL01.40","ME",2001,10,9,282,20,44.3371,-68.8314,3,2,1,3,0,"ME",18.2
"104",512,"FL01.41","ME",2001,10,9,282,21,44.2744,-68.8911,2,1,1,2,0,"ME",18.48
"105",512,"FL01.42","ME",2001,10,9,282,20,43.9214,-69.1271,1002,540,462,566,436,"ME",16.8
"106",512,"FL01.43","ME",2001,10,10,283,20,43.7972,-69.0426,109,47,62,92,17,"ME",18.2
"107",512,"FL01.45","ME",2001,10,10,283,19,43.7826,-68.7055,10,7,3,6,4,"ME",13.87
"108",512,"FL01.46","ME",2001,10,11,284,20,44.0998,-68.7686,117,47,70,73,44,"ME",17.8
"109",512,"FL01.47","ME",2001,10,11,284,19,44.1602,-68.7868,26,8,18,20,6,"ME",15.96
"110",512,"FL01.48","ME",2001,10,11,284,21,44.138,-68.7532,54,26,28,53,1,"ME",19.95
"111",512,"FL01.49","ME",2001,10,12,285,20,43.8968,-68.7558,137,56,81,114,23,"ME",21.4
"112",512,"FL01.50","ME",2001,10,12,285,18,43.9166,-68.6212,5,2,3,5,0,"ME",18.36
"113",512,"FL01.51","ME",2001,10,12,285,20,43.9202,-68.6329,11,8,3,11,0,"ME",19
"114",512,"FL01.52","ME",2001,10,15,288,20,44.0086,-68.5556,77,43,34,70,7,"ME",19.2
"115",512,"FL01.53","ME",2001,10,15,288,20,43.9442,-68.4451,1,1,0,1,0,"ME",19.4
"116",512,"FL01.54","ME",2001,10,15,288,20,44.1677,-68.528,214,78,136,167,47,"ME",17.8
"117",512,"FL01.55","ME",2001,10,16,289,20,44.2811,-68.5209,1,0,1,1,0,"ME",20.4
"118",512,"FL01.56","ME",2001,10,16,289,20,44.3311,-68.5485,1,1,0,1,0,"ME",17.6
"119",512,"FL01.58","ME",2001,10,16,289,19,44.2051,-68.4365,87,40,47,65,22,"ME",17.48
"120",512,"FL01.59","ME",2001,10,18,291,21,44.4582,-68.2236,8,4,4,7,1,"ME",19.32
"121",513,"FL01.6","ME",2001,9,25,268,21,43.0037,-70.467,3,2,1,3,0,"ME",17.22
"122",512,"FL01.60","ME",2001,10,18,291,21,44.4315,-68.1975,5,3,2,5,0,"ME",19.95
"123",512,"FL01.61","ME",2001,10,19,292,21,44.2993,-68.1255,137,78,59,94,43,"ME",18.69
"124",512,"FL01.62","ME",2001,10,19,292,20,44.3501,-68.1125,135,60,75,102,33,"ME",17.6
"125",512,"FL01.63","ME",2001,10,19,292,20,44.0262,-68.2184,1,0,1,1,0,"ME",17.2
"126",512,"FL01.64","ME",2001,10,19,292,23,44.0251,-68.3019,2,1,1,2,0,"ME",21.16
"127",512,"FL01.65","ME",2001,10,20,293,20,44.0543,-68.1338,4,4,0,3,1,"ME",21.4
"128",512,"FL01.67","ME",2001,10,20,293,20,44.1381,-67.945,6,5,1,6,0,"ME",18
"129",512,"FL01.68","ME",2001,10,20,293,21,44.1456,-68.0246,5,1,4,5,0,"ME",18.06
"130",513,"FL01.7","ME",2001,9,26,269,20,43.3037,-70.5095,232,122,110,58,174,"ME",16.4
"131",513,"FL01.8","ME",2001,9,26,269,18,43.296,-70.4883,163,67,96,55,108,"ME",16.38
"132",513,"FL01.9","ME",2001,9,26,269,20,43.1544,-70.3733,24,8,15,17,7,"ME",19.4
"133",513,"FL02.1","ME",2002,10,14,287,22,42.9368,-70.7462,129,56,73,91,38,"ME",18.26
"134",513,"FL02.10","ME",2002,10,17,290,20,43.17815,-70.43558,41,25,16,30,11,"ME",15.4
"135",513,"FL02.11","ME",2002,10,17,290,20,43.404,-70.13835,3,2,1,3,0,"ME",16.4
"136",513,"FL02.12","ME",2002,10,18,291,20,43.54827,-70.28533,99,52,47,25,74,"ME",16
"137",513,"FL02.13","ME",2002,10,18,291,21,43.50862,-70.19562,377,174,203,216,161,"ME",17.64
"138",513,"FL02.14","ME",2002,10,18,291,20,43.41872,-70.27908,118,59,59,79,39,"ME",12
"139",513,"FL02.15","ME",2002,10,18,291,21,43.5208,-70.2486,184,94,90,83,101,"ME",13.65
"140",513,"FL02.16","ME",2002,10,21,294,18,43.75087,-70.084,124,46,78,92,32,"ME",12.96
"141",513,"FL02.17","ME",2002,10,21,294,20,43.66608,-70.14837,574,269,305,325,249,"ME",15.2
"142",513,"FL02.18","ME",2002,10,21,294,18,43.65125,-70.09583,561,282,279,203,358,"ME",11.52
"143",513,"FL02.19","ME",2002,10,21,294,20,43.52168,-70.02668,3,3,0,2,1,"ME",15.2
"144",513,"FL02.2","ME",2002,10,14,287,20,42.91263,-70.6723,12,3,9,12,0,"ME",22.4
"145",513,"FL02.20","ME",2002,10,22,295,20,43.56713,-69.83483,1,1,0,1,0,"ME",20.4
"146",513,"FL02.21","ME",2002,10,22,295,20,43.59973,-69.87118,8,6,2,7,1,"ME",18.2
"147",513,"FL02.22","ME",2002,10,22,295,20,43.68597,-69.90458,417,225,192,309,108,"ME",18
"148",513,"FL02.23","ME",2002,10,22,295,17,43.6567,-69.97475,191,88,103,96,95,"ME",10.88
"149",513,"FL02.24","ME",2002,10,23,296,20,43.54177,-69.69105,1,1,0,1,0,"ME",15.6
"150",513,"FL02.25","ME",2002,10,23,296,19,43.63,-69.70035,5,4,1,5,0,"ME",16.91
"151",513,"FL02.26","ME",2002,10,23,296,20,43.6614,-69.79177,147,87,60,117,30,"ME",16.4
"152",513,"FL02.27","ME",2002,10,23,296,20,43.66698,-69.7466,135,73,62,120,15,"ME",18.8
"153",513,"FL02.28","ME",2002,10,23,296,20,43.70028,-69.74343,185,100,85,140,45,"ME",17.8
"154",513,"FL02.29","ME",2002,10,24,297,20,43.73375,-69.50647,2,1,1,2,0,"ME",18.4
"155",513,"FL02.3","ME",2002,10,14,287,13,42.94283,-70.68137,11,5,6,7,4,"ME",6.89
"156",513,"FL02.30","ME",2002,10,25,298,20,43.77578,-69.47787,34,19,15,31,3,"ME",19.6
"157",513,"FL02.31","ME",2002,10,25,298,20,43.8261,-69.48928,181,106,75,103,78,"ME",15.4
"158",513,"FL02.32","ME",2002,10,25,298,18,43.83643,-69.40857,334,178,156,268,66,"ME",15.48
"159",512,"FL02.33","ME",2002,10,28,301,20,43.74457,-69.15273,8,6,2,7,1,"ME",14.8
"160",512,"FL02.34","ME",2002,10,28,301,17,43.85935,-69.07097,1111,623,488,921,190,"ME",11.56
"161",512,"FL02.35","ME",2002,10,28,301,20,43.91603,-69.13073,661,314,347,545,116,"ME",16
"162",512,"FL02.36","ME",2002,10,29,302,15,44.15262,-69.02098,38,18,20,36,2,"ME",11.7
"163",512,"FL02.37","ME",2002,10,29,302,19,44.14833,-68.95862,13,4,9,13,0,"ME",24.13
"164",512,"FL02.38","ME",2002,10,29,302,20,44.18683,-68.90237,2,0,2,2,0,"ME",17.2
"165",512,"FL02.39","ME",2002,10,29,302,20,44.08193,-69.0054,113,44,69,113,0,"ME",18.2
"166",513,"FL02.4","ME",2002,10,14,287,20,42.98203,-70.65143,121,69,52,76,45,"ME",14.6
"167",512,"FL02.40","ME",2002,10,30,303,20,44.29128,-68.88178,1,1,0,1,0,"ME",17.6
"168",512,"FL02.43","ME",2002,10,30,303,20,44.15412,-68.76457,5,1,4,4,1,"ME",15.8
"169",512,"FL02.44","ME",2002,10,31,304,13,43.61252,-68.93938,1,1,0,1,0,"ME",7.8
"170",512,"FL02.45","ME",2002,10,31,304,20,43.77167,-68.72385,16,10,6,14,2,"ME",13
"171",512,"FL02.46","ME",2002,10,31,304,15,43.78512,-68.70483,14,11,3,14,0,"ME",9.15
"172",512,"FL02.47","ME",2002,11,1,305,20,43.87283,-68.59247,16,12,4,16,0,"ME",16.2
"173",512,"FL02.48","ME",2002,11,1,305,21,43.91105,-68.62445,56,36,20,53,3,"ME",17.85
"174",512,"FL02.49","ME",2002,11,1,305,20,43.9127,-68.75435,154,85,69,147,7,"ME",13.8
"175",512,"FL02.50","ME",2002,11,4,308,20,43.93187,-68.5537,59,34,25,57,2,"ME",16.4
"176",512,"FL02.51","ME",2002,11,4,308,19,44.01178,-68.54995,109,60,49,102,7,"ME",12.54
"177",512,"FL02.52","ME",2002,11,4,308,20,44.16547,-68.53493,86,29,57,65,21,"ME",17.8
"178",512,"FL02.53","ME",2002,11,5,309,20,43.95763,-68.40837,40,37,3,40,0,"ME",15
"179",512,"FL02.54","ME",2002,11,5,309,20,44.01908,-68.3472,61,34,27,52,9,"ME",16.2
"180",512,"FL02.55","ME",2002,11,5,309,20,44.0001,-68.205,16,16,0,16,0,"ME",15.6
"181",512,"FL02.56","ME",2002,11,5,309,20,44.05087,-68.25907,55,34,21,53,2,"ME",15.6
"182",512,"FL02.57","ME",2002,11,8,312,20,44.36238,-68.47905,1,1,0,1,0,"ME",11
"183",512,"FL02.58","ME",2002,11,8,312,20,44.24968,-68.43225,11,8,3,9,2,"ME",15.8
"184",512,"FL02.59","ME",2002,11,8,312,20,44.20588,-68.436,54,13,41,46,8,"ME",14.8
"185",513,"FL02.6","ME",2002,10,15,288,20,42.9966,-70.48913,14,6,8,14,0,"ME",19.6
"186",512,"FL02.60","ME",2002,11,9,313,20,44.44333,-68.16357,5,2,3,5,0,"ME",14.6
"187",512,"FL02.61","ME",2002,11,9,313,20,44.2841,-68.20385,222,91,131,177,45,"ME",15
"188",512,"FL02.62","ME",2002,11,10,314,17,44.28425,-68.12272,146,66,80,121,25,"ME",13.6
"189",512,"FL02.63","ME",2002,11,10,314,20,44.21182,-68.06978,184,106,78,161,23,"ME",14.2
"190",511,"FL02.64","ME",2002,11,12,316,16,44.3993,-67.93158,33,10,23,23,10,"ME",10.24
"191",511,"FL02.65","ME",2002,11,12,316,20,44.33355,-67.77865,204,116,88,141,63,"ME",14.8
"192",511,"FL02.66","ME",2002,11,13,317,15,44.4706,-67.80005,62,28,34,45,17,"ME",7.5
"193",511,"FL02.67","ME",2002,11,14,318,19,44.4658,-67.72768,265,104,161,136,129,"ME",12.92
"194",511,"FL02.68","ME",2002,11,14,318,21,44.25317,-67.75667,7,6,1,6,1,"ME",19.74
"195",511,"FL02.69","ME",2002,11,14,318,20,44.30935,-67.67298,34,15,19,34,0,"ME",14.6
"196",513,"FL02.7","ME",2002,10,15,288,20,43.0552,-70.4362,9,4,5,9,0,"ME",19.4
"197",511,"FL02.70","ME",2002,11,14,318,20,44.2972,-67.60413,15,6,9,15,0,"ME",15.8
"198",511,"FL02.71","ME",2002,11,15,319,20,44.3476,-67.64103,39,16,23,39,0,"ME",15.6
"199",511,"FL02.72","ME",2002,11,15,319,21,44.42492,-67.44987,84,44,40,76,8,"ME",17.01
"200",511,"FL02.73","ME",2002,11,19,323,20,44.54098,-67.50233,374,175,199,166,208,"ME",14
"201",511,"FL02.74","ME",2002,11,19,323,20,44.58433,-67.29767,169,95,74,29,140,"ME",14.8
"202",511,"FL02.75","ME",2002,11,19,323,20,44.62473,-67.33125,132,55,77,112,20,"ME",16
"203",511,"FL02.76","ME",2002,11,19,323,20,44.53673,-67.2963,100,59,41,78,22,"ME",17.22
"204",511,"FL02.77","ME",2002,11,19,323,15,44.549,-67.31513,123,61,62,63,60,"ME",9.3
"205",511,"FL02.78","ME",2002,11,20,324,20,44.60777,-67.10348,45,19,26,40,5,"ME",18.6
"206",511,"FL02.79","ME",2002,11,20,324,20,44.66237,-67.13075,105,51,54,85,20,"ME",17.2
"207",513,"FL02.8","ME",2002,10,15,288,21,43.09167,-70.39557,2,1,1,2,0,"ME",16.59
"208",511,"FL02.80","ME",2002,11,20,324,22,44.74643,-67.02095,17,7,10,17,0,"ME",18.26
"209",467,"FL02.81","ME",2002,11,20,324,20,44.70687,-66.9513,9,3,6,9,0,"ME",22
"210",513,"FL02.9","ME",2002,10,15,288,19,43.14283,-70.39293,30,13,17,28,2,"ME",16.91
"211",513,"FL03.1","ME",2003,10,13,286,18,42.939,-70.745,156,85,71,98,58,"ME",13.68
"212",513,"FL03.11","ME",2003,10,16,289,20,43.31167,-70.17617,1,0,1,1,0,"ME",14.6
"213",513,"FL03.12","ME",2003,10,17,290,20,43.25683,-70.57633,343,173,170,238,105,"ME",15.6
"214",513,"FL03.13","ME",2003,10,17,290,16,43.28933,-70.50017,241,113,128,97,144,"ME",8.96
"215",513,"FL03.14","ME",2003,10,17,290,15,43.42383,-70.27717,130,54,76,72,58,"ME",8.1
"216",513,"FL03.15","ME",2003,10,17,290,16,43.5305,-70.26367,239,96,143,133,106,"ME",9.6
"217",513,"FL03.16","ME",2003,10,17,290,20,43.51283,-70.1915,304,136,168,134,170,"ME",14.6
"218",513,"FL03.19","ME",2003,10,20,293,20,43.53017,-70.017,3,2,1,2,1,"ME",18.6
"219",513,"FL03.2","ME",2003,10,13,286,16,42.92783,-70.70683,88,48,40,56,32,"ME",8.64
"220",513,"FL03.20","ME",2003,10,20,293,15,43.499,-70.10783,24,12,12,14,10,"ME",10.8
"221",513,"FL03.21","ME",2003,10,21,294,16,43.64133,-70.16817,124,63,61,71,53,"ME",8.96
"222",513,"FL03.22","ME",2003,10,22,295,20,43.54817,-69.96483,1,1,0,1,0,"ME",15.8
"223",513,"FL03.23","ME",2003,10,22,295,16,43.59117,-69.85233,3,2,1,3,0,"ME",9.92
"224",513,"FL03.24","ME",2003,10,22,295,20,43.61083,-69.86183,6,1,5,4,2,"ME",15.8
"225",513,"FL03.25","ME",2003,10,22,295,16,43.70833,-69.94633,319,167,152,161,158,"ME",8
"226",513,"FL03.26","ME",2003,10,23,296,16,43.72917,-69.64933,180,97,83,119,61,"ME",8.32
"227",513,"FL03.27","ME",2003,10,23,296,20,43.71967,-69.79383,54,24,30,31,23,"ME",14.2
"228",513,"FL03.28","ME",2003,10,23,296,20,43.7155,-69.69233,341,163,178,184,157,"ME",16.2
"229",513,"FL03.29","ME",2003,10,24,297,20,43.681,-69.514,2,1,1,1,1,"ME",15.8
"230",513,"FL03.3","ME",2003,10,13,286,20,42.92167,-70.54317,5,1,4,5,0,"ME",14.4
"231",513,"FL03.31","ME",2003,10,24,297,20,43.83717,-69.485,188,94,94,105,83,"ME",15
"232",512,"FL03.32","ME",2003,10,30,303,15,44.1595,-69.01917,5,3,2,4,1,"ME",8.7
"233",512,"FL03.33","ME",2003,10,30,303,18,44.13267,-68.96867,9,4,5,9,0,"ME",14.4
"234",512,"FL03.34","ME",2003,10,31,304,20,44.1165,-68.7805,118,43,75,63,55,"ME",13.8
"235",512,"FL03.35","ME",2003,10,31,304,18,44.13817,-68.76567,61,32,29,57,4,"ME",10.98
"236",512,"FL03.36","ME",2003,10,31,304,17,44.161,-68.7895,5,2,3,3,2,"ME",11.22
"237",512,"FL03.37","ME",2003,11,1,305,20,43.62167,-68.9335,1,1,0,1,0,"ME",14.8
"238",512,"FL03.39","ME",2003,11,2,306,20,43.91783,-68.75467,205,93,112,201,4,"ME",15.4
"239",513,"FL03.4","ME",2003,10,13,286,20,42.95517,-70.47967,2,0,2,2,0,"ME",15.8
"240",512,"FL03.40","ME",2003,11,2,306,20,43.77683,-68.64133,12,9,3,11,1,"ME",16.2
"241",512,"FL03.41","ME",2003,11,2,306,20,43.8975,-68.66867,41,25,16,36,5,"ME",15.4
"242",512,"FL03.42","ME",2003,11,2,306,20,43.90567,-68.63133,40,22,18,40,0,"ME",14.6
"243",512,"FL03.43","ME",2003,11,2,306,20,43.91517,-68.643,52,37,15,52,0,"ME",14.8
"244",512,"FL03.44","ME",2003,11,3,307,16,44.16417,-68.5345,40,11,29,31,9,"ME",9.12
"245",512,"FL03.45","ME",2003,11,3,307,15,44.015,-68.5435,137,69,68,131,6,"ME",8.85
"246",512,"FL03.46","ME",2003,11,3,307,20,43.91467,-68.5225,18,12,6,18,0,"ME",10.8
"247",512,"FL03.47","ME",2003,11,3,307,20,43.92783,-68.5765,21,11,10,21,0,"ME",15.2
"248",512,"FL03.48","ME",2003,11,4,308,24,43.9725,-68.31,15,11,4,15,0,"ME",24
"249",512,"FL03.49","ME",2003,11,5,309,20,44.285,-68.51033,7,0,7,7,0,"ME",15.2
"250",512,"FL03.51","ME",2003,11,5,309,20,44.38583,-68.49217,1,0,1,1,0,"ME",15.4
"251",512,"FL03.52","ME",2003,11,5,309,16,44.2075,-68.435,112,50,62,101,11,"ME",10.08
"252",512,"FL03.53","ME",2003,11,6,310,15,44.2135,-68.06767,153,88,65,135,18,"ME",10.05
"253",512,"FL03.54","ME",2003,11,6,310,20,44.23017,-68.132,318,164,154,237,81,"ME",14.6
"254",512,"FL03.55","ME",2003,11,6,310,20,44.0585,-68.055,11,8,3,11,0,"ME",15
"255",512,"FL03.56","ME",2003,11,6,310,20,44.124,-67.91767,4,2,2,4,0,"ME",15.4
"256",512,"FL03.57","ME",2003,11,6,310,16,44.1605,-67.95617,14,8,6,14,0,"ME",9.92
"257",512,"FL03.58","ME",2003,11,7,311,20,44.27,-68.12967,285,133,152,261,24,"ME",15.6
"258",512,"FL03.59","ME",2003,11,7,311,20,44.2925,-68.072,309,154,155,275,34,"ME",15.4
"259",513,"FL03.6","ME",2003,10,13,286,20,42.93717,-70.48167,1,0,1,1,0,"ME",14.6
"260",512,"FL03.60","ME",2003,11,7,311,20,44.31617,-68.08667,234,105,129,185,49,"ME",14
"261",512,"FL03.61","ME",2003,11,7,311,18,44.28417,-68.20117,373,165,208,257,116,"ME",12.78
"262",512,"FL03.62","ME",2003,11,10,314,19,44.225,-67.94767,37,20,17,30,7,"ME",12.35
"263",511,"FL03.63","ME",2003,11,10,314,20,44.20483,-67.72867,1,1,0,1,0,"ME",16.4
"264",511,"FL03.64","ME",2003,11,11,315,17,44.42217,-67.7835,102,34,68,76,26,"ME",10.37
"265",511,"FL03.65","ME",2003,11,11,315,20,44.37233,-67.673,105,57,48,88,17,"ME",14.4
"266",511,"FL03.66","ME",2003,11,11,315,17,44.41367,-67.5735,191,95,96,118,73,"ME",11.73
"267",511,"FL03.67","ME",2003,11,12,316,20,44.30083,-67.65933,33,19,14,33,0,"ME",14.8
"268",511,"FL03.68","ME",2003,11,12,316,20,44.29983,-67.49567,11,8,3,11,0,"ME",15.4
"269",511,"FL03.70","ME",2003,11,12,316,20,44.3345,-67.284,1,1,0,1,0,"ME",14.8
"270",467,"FL03.71","ME",2003,11,17,321,20,44.71033,-66.95533,26,11,15,24,2,"ME",15.8
"271",467,"FL03.72","ME",2003,11,17,321,20,44.69817,-66.99517,46,25,21,33,13,"ME",17.2
"272",467,"FL03.73","ME",2003,11,17,321,20,44.68517,-66.99717,33,11,22,28,5,"ME",19.2
"273",511,"FL03.74","ME",2003,11,17,321,18,44.66433,-67.13067,121,59,62,92,29,"ME",12.42
"274",511,"FL03.75","ME",2003,11,18,322,18,44.58667,-67.29417,85,41,44,64,21,"ME",11.88
"275",511,"FL03.76","ME",2003,11,18,322,20,44.63833,-67.31767,28,12,16,21,7,"ME",15.4
"276",511,"FL03.78","ME",2003,11,18,322,20,44.515,-67.521,34,17,17,23,11,"ME",14.8
"277",513,"FL03.9","ME",2003,10,14,287,20,43.089,-70.40683,4,0,4,4,0,"ME",14.2
"278",513,"FL04.1","ME",2004,10,11,285,20,42.927,-70.75267,169,87,82,131,38,"ME",14.6
"279",513,"FL04.10","ME",2004,10,14,288,15,43.16967,-70.442,48,15,33,36,12,"ME",8.55
"280",513,"FL04.11","ME",2004,10,14,288,20,43.14717,-70.39,28,15,13,26,2,"ME",15.8
"281",513,"FL04.13","ME",2004,10,14,288,20,43.243,-70.21867,1,1,0,1,0,"ME",15.6
"282",513,"FL04.15","ME",2004,10,14,288,20,43.40262,-70.13118,1,0,1,1,0,"ME",15.2
"283",513,"FL04.16","ME",2004,10,17,291,20,43.50167,-70.35433,25,14,11,11,14,"ME",15.6
"284",513,"FL04.17","ME",2004,10,17,291,20,43.49033,-70.33217,63,24,39,47,16,"ME",14.6
"285",513,"FL04.18","ME",2004,10,17,291,20,43.42182,-70.29172,76,35,41,48,28,"ME",14.8
"286",513,"FL04.19","ME",2004,10,18,292,20,43.51988,-70.028,2,1,1,2,0,"ME",15.4
"287",513,"FL04.2","ME",2004,10,11,285,20,42.87917,-70.7145,7,5,2,6,1,"ME",15.4
"288",513,"FL04.23","ME",2004,10,18,292,20,43.5449,-69.95835,1,1,0,1,0,"ME",14.4
"289",513,"FL04.24","ME",2004,10,19,293,20,43.61143,-69.86293,5,3,2,4,1,"ME",16.2
"290",513,"FL04.25","ME",2004,10,19,293,20,43.6337,-69.9248,115,57,58,59,56,"ME",13.8
"291",513,"FL04.26","ME",2004,10,19,293,15,43.63588,-70.17158,100,57,43,51,49,"ME",8.85
"292",513,"FL04.27","ME",2004,10,19,293,18,43.72258,-70.16277,59,29,30,38,21,"ME",12.42
"293",513,"FL04.29","ME",2004,10,20,294,20,43.64657,-69.80952,5,2,3,5,0,"ME",15.4
"294",513,"FL04.3","ME",2004,10,11,285,20,42.89383,-70.60717,3,0,3,3,0,"ME",15.8
"295",513,"FL04.30","ME",2004,10,20,294,20,43.6672,-69.7499,88,56,32,87,1,"ME",15.2
"296",513,"FL04.31","ME",2004,10,20,294,20,43.70808,-69.76828,65,33,32,52,13,"ME",14.6
"297",513,"FL04.32","ME",2004,10,21,295,18,43.75682,-69.64957,110,59,51,84,26,"ME",14.76
"298",513,"FL04.33","ME",2004,10,21,295,20,43.63442,-69.59697,3,1,2,1,2,"ME",13.4
"299",513,"FL04.35","ME",2004,10,21,295,20,43.7622,-69.4662,18,10,8,17,1,"ME",15
"300",513,"FL04.36","ME",2004,10,22,296,18,43.85442,-69.52857,431,197,234,130,301,"ME",11.7
"301",513,"FL04.37","ME",2004,10,25,299,20,43.8276,-69.48813,360,186,174,222,138,"ME",15.8
"302",513,"FL04.38","ME",2004,10,25,299,20,43.81173,-69.43755,97,50,47,75,22,"ME",16.2
"303",512,"FL04.39","ME",2004,10,25,299,20,43.77688,-69.22838,141,77,64,95,46,"ME",16
"304",513,"FL04.4","ME",2004,10,11,285,20,42.9145,-70.571,6,2,4,6,0,"ME",16.4
"305",512,"FL04.40","ME",2004,10,25,299,20,43.79548,-69.07907,92,47,45,90,2,"ME",15.6
"306",512,"FL04.41","ME",2004,10,26,300,20,43.86378,-69.08217,529,276,253,435,94,"ME",15.6
"307",512,"FL04.42","ME",2004,10,26,300,20,43.85075,-69.10968,430,223,207,286,144,"ME",16
"308",512,"FL04.43","ME",2004,10,26,300,20,43.9443,-68.97332,565,268,297,443,122,"ME",15.4
"309",512,"FL04.44","ME",2004,10,27,301,20,44.14675,-69.00692,1,1,0,1,0,"ME",18
"310",512,"FL04.45","ME",2004,10,27,301,19,44.29005,-68.8872,2,2,0,2,0,"ME",15.2
"311",512,"FL04.46","ME",2004,10,27,301,13,44.29948,-68.79215,1,1,0,1,0,"ME",6.37
"312",512,"FL04.48","ME",2004,10,27,301,20,44.17292,-68.79983,5,1,4,4,1,"ME",17.8
"313",512,"FL04.49","ME",2004,10,28,302,20,43.62013,-68.9362,1,1,0,1,0,"ME",14.8
"314",513,"FL04.5","ME",2004,10,13,287,19,43.01883,-70.54583,31,10,21,31,0,"ME",15.01
"315",513,"FL04.50","ME",2004,10,28,302,20,43.52048,-69.07363,1,1,0,1,0,"ME",16.4
"316",512,"FL04.51","ME",2004,10,29,303,20,43.9349,-68.78628,99,57,42,96,3,"ME",14.2
"317",512,"FL04.52","ME",2004,10,29,303,20,43.91517,-68.75595,198,84,114,180,18,"ME",15.6
"318",512,"FL04.53","ME",2004,10,29,303,20,43.91578,-68.62403,23,14,9,23,0,"ME",16.6
"319",512,"FL04.54","ME",2004,10,29,303,20,43.77853,-68.63973,6,5,1,6,0,"ME",16
"320",512,"FL04.55","ME",2004,11,1,306,17,44.16347,-68.53517,65,26,39,57,8,"ME",11.73
"321",512,"FL04.56","ME",2004,11,1,306,19,44.01135,-68.55138,92,54,38,77,15,"ME",13.49
"322",512,"FL04.57","ME",2004,11,1,306,20,43.95128,-68.54927,25,16,9,24,1,"ME",15.8
"323",512,"FL04.58","ME",2004,11,1,306,20,43.90068,-68.52995,16,12,4,16,0,"ME",15.4
"324",512,"FL04.59","ME",2004,11,2,307,20,43.91133,-68.28658,1,1,0,1,0,"ME",14.6
"325",513,"FL04.6","ME",2004,10,13,287,20,42.957,-70.46,2,0,2,2,0,"ME",14.2
"326",512,"FL04.60","ME",2004,11,2,307,20,43.96713,-68.32312,15,9,6,15,0,"ME",15.2
"327",512,"FL04.61","ME",2004,11,2,307,20,44.04588,-68.2154,17,14,3,17,0,"ME",16
"328",512,"FL04.62","ME",2004,11,2,307,15,44.05122,-68.26127,19,12,7,17,2,"ME",8.7
"329",512,"FL04.64","ME",2004,11,4,309,15,44.2154,-68.06603,194,97,97,151,43,"ME",9
"330",512,"FL04.65","ME",2004,11,4,309,20,44.28553,-68.1304,363,172,191,300,63,"ME",15.4
"331",512,"FL04.66","ME",2004,11,4,309,15,44.05887,-68.05227,1,1,0,1,0,"ME",8.85
"332",512,"FL04.67","ME",2004,11,7,312,17,44.36408,-68.11352,97,44,53,64,33,"ME",12.07
"333",512,"FL04.68","ME",2004,11,7,312,18,44.43225,-68.18553,4,2,2,4,0,"ME",12.24
"334",512,"FL04.69","ME",2004,11,7,312,20,44.4514,-68.18627,6,3,3,5,1,"ME",17
"335",513,"FL04.7","ME",2004,10,13,287,20,43.04967,-70.457,9,0,9,9,0,"ME",16.2
"336",512,"FL04.70","ME",2004,11,7,312,21,44.46335,-68.20535,6,2,4,6,0,"ME",17.01
"337",512,"FL04.71","ME",2004,11,7,312,17,44.31283,-68.17205,71,33,38,48,23,"ME",12.24
"338",511,"FL04.72","ME",2004,11,8,313,20,44.2464,-67.81443,25,14,11,24,1,"ME",16.6
"339",511,"FL04.73","ME",2004,11,8,313,20,44.27062,-67.75165,11,8,3,9,2,"ME",17
"340",511,"FL04.74","ME",2004,11,8,313,20,44.30027,-67.67692,18,12,6,18,0,"ME",16.6
"341",511,"FL04.75","ME",2004,11,9,314,15,44.51733,-67.7628,5,2,3,4,1,"ME",10.2
"342",511,"FL04.76","ME",2004,11,9,314,20,44.35353,-67.7465,22,12,10,22,0,"ME",18
"343",511,"FL04.77","ME",2004,11,9,314,16,44.3639,-67.7012,31,23,8,30,1,"ME",11.2
"344",511,"FL04.78","ME",2004,11,10,315,20,44.29663,-67.50212,1,1,0,1,0,"ME",16
"345",511,"FL04.80","ME",2004,11,10,315,20,44.34488,-67.28628,1,1,0,1,0,"ME",16
"346",467,"FL04.81","ME",2004,11,18,323,20,44.71478,-66.95352,23,8,15,21,2,"ME",19.4
"347",511,"FL04.82","ME",2004,11,18,323,20,44.7652,-67.00532,276,136,140,153,123,"ME",17.6
"348",511,"FL04.83","ME",2004,11,18,323,20,44.6668,-67.03148,74,41,33,48,26,"ME",18.6
"349",511,"FL04.84","ME",2004,11,18,323,20,44.61315,-67.1905,33,16,17,30,3,"ME",16.4
"350",511,"FL04.85","ME",2004,11,19,324,20,44.65277,-67.3407,4,2,2,2,2,"ME",19.4
"351",511,"FL04.86","ME",2004,11,19,324,16,44.59207,-67.295,52,23,29,51,1,"ME",10.72
"352",511,"FL04.87","ME",2004,11,19,324,20,44.49153,-67.28293,74,34,40,64,10,"ME",18.2
"353",513,"FL04.9","ME",2004,10,13,287,20,43.119,-70.36583,2,1,1,2,0,"ME",14.6
"354",513,"FL05.1","ME",2005,10,10,283,20,42.93633,-70.74667,88,41,47,60,28,"ME",16.32
"355",513,"FL05.11","ME",2005,10,17,290,12,43.5,-70.3335,245,117,128,134,111,"ME",5.688
"356",513,"FL05.12","ME",2005,10,17,290,20,43.511,-70.192,426,183,243,237,189,"ME",16.72
"357",513,"FL05.13","ME",2005,10,18,291,16,43.65383,-70.0905,694,394,300,273,421,"ME",9.632
"358",513,"FL05.14","ME",2005,10,19,292,20,43.54633,-70.00417,45,25,20,36,9,"ME",16.24
"359",513,"FL05.15","ME",2005,10,19,292,20,43.60217,-69.87167,17,12,5,10,7,"ME",15.82
"360",513,"FL05.16","ME",2005,10,19,292,20,43.5185,-69.81133,1,1,0,0,1,"ME",16.1
"361",513,"FL05.18","ME",2005,10,19,292,20,43.617,-69.71167,8,2,6,8,0,"ME",16.08
"362",513,"FL05.19","ME",2005,10,20,293,20,43.66217,-69.7485,126,68,58,113,13,"ME",16.18
"363",513,"FL05.2","ME",2005,10,10,283,20,42.89683,-70.68517,12,4,8,11,1,"ME",16.6
"364",513,"FL05.20","ME",2005,10,20,293,15,43.75233,-69.64933,348,180,168,212,136,"ME",8.685
"365",513,"FL05.21","ME",2005,10,21,294,20,43.6985,-69.51133,1,1,0,1,0,"ME",16.42
"366",513,"FL05.23","ME",2005,10,22,295,16,43.8515,-69.52783,613,310,303,198,415,"ME",10.56
"367",513,"FL05.24","ME",2005,10,22,295,20,43.8275,-69.4885,319,180,139,136,183,"ME",16.9
"368",513,"FL05.25","ME",2005,10,22,295,20,43.8275,-69.42367,486,264,222,319,167,"ME",16.36
"369",513,"FL05.26","ME",2005,10,22,295,20,43.82267,-69.34633,181,98,83,78,103,"ME",16.7
"370",512,"FL05.27","ME",2005,10,27,300,15,43.74867,-69.212,30,16,14,23,7,"ME",8.865
"371",513,"FL05.28","ME",2005,10,27,300,20,43.54567,-69.07017,2,2,0,2,0,"ME",16.12
"372",512,"FL05.29","ME",2005,10,27,300,20,43.60583,-68.94417,6,6,0,6,0,"ME",16.92
"373",513,"FL05.3","ME",2005,10,10,283,20,42.87433,-70.6715,20,7,13,17,3,"ME",16.12
"374",513,"FL05.30","ME",2005,10,27,300,20,43.5865,-69.07133,2,2,0,2,0,"ME",15.84
"375",512,"FL05.31","ME",2005,10,29,302,20,44.12033,-68.98,56,24,32,53,3,"ME",16.18
"376",512,"FL05.32","ME",2005,10,29,302,21,44.17917,-69.00583,57,24,33,54,3,"ME",18.942
"377",512,"FL05.33","ME",2005,10,29,302,20,44.24533,-68.90883,15,4,11,11,4,"ME",16.96
"378",512,"FL05.34","ME",2005,10,29,302,20,44.27933,-68.855,2,0,2,2,0,"ME",15.82
"379",512,"FL05.35","ME",2005,10,30,303,19,44.0028,-68.8591,1243,602,641,708,535,"ME",15.352
"380",512,"FL05.36","ME",2005,10,31,304,20,43.76448,-68.78677,21,16,5,17,4,"ME",17.16
"381",512,"FL05.37","ME",2005,10,31,304,15,43.78733,-68.69733,10,9,1,10,0,"ME",8.865
"382",512,"FL05.38","ME",2005,11,1,305,20,43.90313,-68.75843,241,128,113,214,27,"ME",16.5
"383",512,"FL05.39","ME",2005,11,1,305,19,43.89252,-68.67513,34,23,11,28,6,"ME",15.314
"384",513,"FL05.4","ME",2005,10,11,284,19,42.99,-70.64717,59,37,22,45,14,"ME",15.162
"385",512,"FL05.40","ME",2005,11,1,305,20,43.86255,-68.4587,7,5,2,7,0,"ME",16.18
"386",512,"FL05.41","ME",2005,11,1,305,19,43.9537,-68.47797,28,16,12,26,2,"ME",15.523
"387",512,"FL05.42","ME",2005,11,2,306,15,44.15717,-68.54033,165,70,95,118,47,"ME",10.05
"388",512,"FL05.43","ME",2005,11,2,306,20,44.2445,-68.4305,135,52,83,101,34,"ME",16.26
"389",512,"FL05.44","ME",2005,11,2,306,18,44.27967,-68.5165,5,2,3,4,1,"ME",12.87
"390",512,"FL05.46","ME",2005,11,3,307,20,43.93217,-68.25967,7,7,0,6,1,"ME",16.26
"391",512,"FL05.47","ME",2005,11,3,307,20,44.03033,-68.22563,37,25,12,37,0,"ME",17.04
"392",512,"FL05.48","ME",2005,11,3,307,18,44.0535,-68.0615,6,3,3,6,0,"ME",12.312
"393",512,"FL05.49","ME",2005,11,4,308,15,44.38417,-68.11733,418,178,240,119,299,"ME",8.745
"394",513,"FL05.5","ME",2005,10,11,284,20,42.9195,-70.39983,2,1,1,0,2,"ME",16.42
"395",512,"FL05.50","ME",2005,11,4,308,20,44.3525,-68.16867,369,161,208,316,53,"ME",15.56
"396",512,"FL05.51","ME",2005,11,4,308,16,44.29853,-68.12838,538,263,275,467,71,"ME",10.496
"397",511,"FL05.52","ME",2005,11,11,315,20,44.59767,-67.43833,16,8,8,8,8,"ME",16.28
"398",511,"FL05.53","ME",2005,11,11,315,20,44.58967,-67.29283,127,72,55,105,22,"ME",18.36
"399",511,"FL05.54","ME",2005,11,11,315,20,44.6355,-67.3435,86,36,50,37,49,"ME",16.82
"400",513,"FL05.7","ME",2005,10,11,284,20,43.0515,-70.44067,7,3,4,7,0,"ME",16.08
"401",513,"FL05.8","ME",2005,10,16,289,17,43.42583,-70.28533,180,90,90,88,92,"ME",10.659
"402",513,"FL05.9","ME",2005,10,17,290,20,43.39467,-70.24717,60,19,41,48,12,"ME",15.96
"403",513,"FL06.1","ME",2006,10,2,275,15,42.93277,-70.74138,199,116,83,129,70,"ME",9.06
"404",513,"FL06.10","ME",2006,10,4,277,11,43.07607,-70.53258,36,21,15,15,21,"ME",4.752
"405",513,"FL06.11","ME",2006,10,4,277,20,43.09043,-70.48505,81,32,49,49,32,"ME",17.04
"406",513,"FL06.12","ME",2006,10,4,277,20,43.12407,-70.37425,29,11,18,25,4,"ME",16.7
"407",513,"FL06.13","ME",2006,10,4,277,20,43.15392,-70.3773,24,10,14,16,8,"ME",16.52
"408",513,"FL06.14","ME",2006,10,4,277,15,43.20573,-70.54943,137,69,68,61,76,"ME",9.255
"409",513,"FL06.15","ME",2006,10,5,278,20,43.24865,-70.50012,300,140,160,152,148,"ME",16.06
"410",513,"FL06.16","ME",2006,10,5,278,20,43.32015,-70.2488,35,10,25,29,6,"ME",15.58
"411",513,"FL06.17","ME",2006,10,5,278,20,43.25937,-70.19992,3,1,2,3,0,"ME",16.82
"412",513,"FL06.18","ME",2006,10,5,278,20,43.32837,-70.12405,7,1,6,7,0,"ME",16.48
"413",513,"FL06.19","ME",2006,10,6,279,20,43.3947,-70.12092,5,2,3,5,0,"ME",15.8
"414",513,"FL06.2","ME",2006,10,2,275,18,42.91315,-70.79832,35,15,20,15,20,"ME",13.32
"415",513,"FL06.20","ME",2006,10,6,279,18,43.42282,-70.28968,94,41,53,46,48,"ME",12.708
"416",513,"FL06.21","ME",2006,10,6,279,20,43.51132,-70.34738,28,18,10,20,8,"ME",16.54
"417",513,"FL06.22","ME",2006,10,6,279,20,43.5165,-70.2509,248,117,131,62,186,"ME",13.3
"418",513,"FL06.23","ME",2006,10,9,282,20,43.60282,-69.87457,18,6,12,5,13,"ME",16.44
"419",513,"FL06.24","ME",2006,10,9,282,20,43.5629,-69.94607,19,9,10,15,4,"ME",15.44
"420",513,"FL06.25","ME",2006,10,9,282,20,43.54937,-69.96498,7,5,2,5,2,"ME",16.18
"421",513,"FL06.26","ME",2006,10,9,282,20,43.54847,-70.004,42,20,22,21,21,"ME",16.7
"422",513,"FL06.27","ME",2006,10,10,283,15,43.66942,-70.15087,331,161,170,144,187,"ME",9.405
"423",513,"FL06.28","ME",2006,10,10,283,15,43.61017,-70.20375,69,37,32,41,28,"ME",9.09
"424",513,"FL06.29","ME",2006,10,10,283,9,43.68707,-69.82817,127,58,69,55,72,"ME",3.213
"425",513,"FL06.3","ME",2006,10,2,275,20,42.88485,-70.68722,18,8,10,9,9,"ME",15.66
"426",513,"FL06.30","ME",2006,10,10,283,20,43.71242,-69.79973,75,33,42,24,51,"ME",15.5
"427",513,"FL06.31","ME",2006,10,11,284,20,43.51917,-69.7023,2,1,1,1,1,"ME",17.04
"428",513,"FL06.33","ME",2006,10,11,284,20,43.5944,-69.71272,11,7,4,9,2,"ME",15.3
"429",513,"FL06.34","ME",2006,10,13,286,18,43.701,-69.70307,152,85,67,70,82,"ME",13.086
"430",513,"FL06.35","ME",2006,10,13,286,17,43.70607,-69.69203,136,60,76,102,34,"ME",11.645
"431",513,"FL06.36","ME",2006,10,13,286,15,43.75958,-69.6573,133,69,64,69,64,"ME",8.895
"432",513,"FL06.37","ME",2006,10,14,287,20,43.69727,-69.51138,4,3,1,3,1,"ME",15.7
"433",513,"FL06.38","ME",2006,10,14,287,20,43.76393,-69.43693,12,4,8,9,3,"ME",15.88
"434",513,"FL06.39","ME",2006,10,14,287,20,43.80085,-69.41548,68,42,26,35,33,"ME",15.98
"435",513,"FL06.4","ME",2006,10,3,276,20,42.8885,-70.61432,16,6,10,16,0,"ME",16.3
"436",513,"FL06.40","ME",2006,10,14,287,20,43.82935,-69.48717,282,161,121,140,142,"ME",14.04
"437",512,"FL06.41","ME",2006,10,16,289,20,43.76348,-69.21845,98,55,43,72,26,"ME",16.68
"438",512,"FL06.42","ME",2006,10,16,289,20,43.88372,-69.2332,920,497,423,523,397,"ME",16.8
"439",512,"FL06.43","ME",2006,10,17,290,20,43.93783,-69.19478,853,408,445,247,606,"ME",15.94
"440",512,"FL06.44","ME",2006,10,17,290,18,43.96623,-69.14095,519,221,298,129,390,"ME",12.114
"441",512,"FL06.45","ME",2006,10,17,290,20,43.8493,-69.10793,438,230,208,136,302,"ME",16.32
"442",512,"FL06.46","ME",2006,10,17,290,20,43.72272,-69.09417,6,3,3,5,1,"ME",15.48
"443",512,"FL06.47","ME",2006,10,17,290,20,43.7464,-69.15218,16,10,6,16,0,"ME",16.4
"444",512,"FL06.48","ME",2006,10,17,290,20,43.788,-69.08405,129,66,63,110,19,"ME",16.92
"445",512,"FL06.49","ME",2006,10,18,291,20,44.12002,-69.04317,147,55,92,90,57,"ME",15.16
"446",513,"FL06.5","ME",2006,10,3,276,20,42.94353,-70.51412,20,9,11,20,0,"ME",16.36
"447",512,"FL06.50","ME",2006,10,18,291,15,44.26543,-68.99613,33,12,21,19,14,"ME",8.865
"448",512,"FL06.51","ME",2006,10,18,291,19,44.18425,-68.9969,25,17,8,20,5,"ME",13.946
"449",512,"FL06.52","ME",2006,10,18,291,20,44.17522,-68.93082,16,9,7,16,0,"ME",16.32
"450",512,"FL06.54","ME",2006,10,19,292,20,43.78502,-68.70427,9,7,2,8,1,"ME",16.36
"451",512,"FL06.55","ME",2006,10,19,292,20,43.79303,-68.56697,2,2,0,2,0,"ME",16.18
"452",512,"FL06.57","ME",2006,10,19,292,15,43.83327,-68.73665,72,44,28,56,16,"ME",7.935
"453",512,"FL06.58","ME",2006,10,19,292,20,43.91728,-68.75377,196,95,101,170,26,"ME",15.1
"454",512,"FL06.59","ME",2006,10,20,293,18,44.11557,-68.76995,141,74,67,84,57,"ME",13.176
"455",512,"FL06.60","ME",2006,10,20,293,20,44.14615,-68.75988,158,62,96,112,46,"ME",16.16
"456",512,"FL06.61","ME",2006,10,20,293,20,44.173,-68.79445,44,17,27,31,13,"ME",15.78
"457",512,"FL06.62","ME",2006,10,23,296,17,44.16455,-68.53267,228,102,126,155,73,"ME",11.084
"458",512,"FL06.63","ME",2006,10,23,296,20,43.95148,-68.55,41,17,24,38,3,"ME",15.4
"459",512,"FL06.64","ME",2006,10,23,296,20,43.90908,-68.52335,7,5,2,7,0,"ME",15.42
"460",512,"FL06.65","ME",2006,10,24,297,16,43.99697,-68.45117,63,38,25,57,6,"ME",9.776
"461",512,"FL06.66","ME",2006,10,24,297,20,43.90895,-68.41747,7,6,1,7,0,"ME",15.1
"462",512,"FL06.67","ME",2006,10,24,297,20,43.91182,-68.2865,8,5,3,8,0,"ME",12.78
"463",512,"FL06.68","ME",2006,10,24,297,20,44.06232,-68.40142,599,305,294,382,217,"ME",15.04
"464",512,"FL06.69","ME",2006,10,25,298,20,44.23807,-68.45542,89,48,41,70,19,"ME",16.5
"465",512,"FL06.70","ME",2006,10,25,298,20,44.30712,-68.55147,4,2,2,3,1,"ME",15.7
"466",512,"FL06.71","ME",2006,10,25,298,20,44.29987,-68.48088,13,7,6,11,2,"ME",16.14
"467",512,"FL06.72","ME",2006,10,26,299,20,44.01493,-68.23925,12,11,1,11,1,"ME",16.76
"468",512,"FL06.73","ME",2006,10,26,299,16,44.05965,-68.22607,42,27,15,35,7,"ME",9.248
"469",512,"FL06.74","ME",2006,10,26,299,20,44.04537,-68.30708,74,42,32,66,8,"ME",16.04
"470",512,"FL06.75","ME",2006,10,26,299,20,44.00233,-68.09447,21,16,5,19,2,"ME",16.28
"471",512,"FL06.76","ME",2006,10,27,300,20,44.37242,-68.1749,272,97,175,163,109,"ME",15.44
"472",512,"FL06.77","ME",2006,10,27,300,20,44.28452,-68.13347,511,267,244,375,136,"ME",15.82
"473",511,"FL06.78","ME",2006,11,7,311,16,44.48683,-67.77868,185,79,106,97,88,"ME",10.832
"474",511,"FL06.79","ME",2006,11,7,311,20,44.4779,-67.84865,2,0,2,1,1,"ME",17.18
"475",513,"FL06.8","ME",2006,10,3,276,20,43.01577,-70.38842,1,0,1,1,0,"ME",15.86
"476",511,"FL06.80","ME",2006,11,7,311,20,44.50102,-67.7,434,158,276,185,249,"ME",14.78
"477",511,"FL06.81","ME",2006,11,8,312,20,44.29372,-67.51335,6,4,2,6,0,"ME",16.36
"478",511,"FL06.82","ME",2006,11,8,312,20,44.278,-67.5663,13,9,4,13,0,"ME",16.36
"479",511,"FL06.83","ME",2006,11,8,312,20,44.28785,-67.64158,6,3,3,6,0,"ME",11
"480",511,"FL06.84","ME",2006,11,11,315,20,44.52163,-67.45043,101,53,48,80,21,"ME",17.44
"481",511,"FL06.85","ME",2006,11,11,315,11,44.533,-67.35018,74,39,35,37,37,"ME",4.345
"482",513,"FL06.9","ME",2006,10,3,276,17,43.02482,-70.56252,81,29,52,61,20,"ME",10.336
"483",513,"FL07.1","ME",2007,10,1,274,13,42.96392,-70.71927,159,74,85,66,93,"ME",7.072
"484",513,"FL07.10","ME",2007,10,3,276,20,43.15293,-70.3804,18,8,10,13,5,"ME",16.14
"485",513,"FL07.11","ME",2007,10,3,276,20,43.15472,-70.26917,3,0,3,3,0,"ME",15.96
"486",513,"FL07.12","ME",2007,10,3,276,20,43.25418,-70.33358,21,11,10,14,7,"ME",15.6
"487",513,"FL07.13","ME",2007,10,3,276,16,43.2963,-70.51163,233,120,113,58,175,"ME",10.032
"488",513,"FL07.14","ME",2007,10,4,277,20,43.32462,-70.10482,2,0,2,1,1,"ME",15.4
"489",513,"FL07.15","ME",2007,10,4,277,17,43.37473,-70.06215,1,1,0,1,0,"ME",11.951
"490",513,"FL07.16","ME",2007,10,4,277,20,43.39557,-70.12265,7,4,3,7,0,"ME",15.72
"491",513,"FL07.17","ME",2007,10,4,277,19,43.42645,-70.20578,38,16,22,32,6,"ME",17.271
"492",513,"FL07.18","ME",2007,10,4,277,20,43.47295,-70.19617,54,26,28,35,19,"ME",16.4
"493",513,"FL07.19","ME",2007,10,5,278,20,43.43305,-70.28068,174,77,97,98,76,"ME",17.8
"494",513,"FL07.2","ME",2007,10,1,274,20,42.93992,-70.7379,253,131,122,142,111,"ME",16.84
"495",513,"FL07.20","ME",2007,10,5,278,20,43.47957,-70.21797,169,79,90,111,58,"ME",16.34
"496",513,"FL07.21","ME",2007,10,5,278,21,43.52492,-70.27298,339,169,170,134,205,"ME",17.661
"497",513,"FL07.22","ME",2007,10,8,281,20,43.77795,-70.06028,269,126,143,112,157,"ME",16.56
"498",513,"FL07.23","ME",2007,10,8,281,19,43.6568,-70.08857,406,209,197,99,307,"ME",15.314
"499",513,"FL07.24","ME",2007,10,8,281,19,43.57703,-69.96453,8,3,5,5,3,"ME",14.611
"500",513,"FL07.28","ME",2007,10,9,282,20,43.61958,-69.74637,11,7,4,7,4,"ME",16.06
"501",513,"FL07.29","ME",2007,10,9,282,20,43.6413,-69.70525,2,1,1,2,0,"ME",16.58
"502",513,"FL07.3","ME",2007,10,1,274,20,42.85248,-70.75485,32,19,13,23,9,"ME",16.1
"503",513,"FL07.30","ME",2007,10,10,283,20,43.63628,-69.7542,59,29,30,45,14,"ME",16.02
"504",513,"FL07.31","ME",2007,10,10,283,20,43.60085,-69.86952,6,2,4,6,0,"ME",16.08
"505",513,"FL07.32","ME",2007,10,10,283,20,43.63392,-69.85542,90,45,45,54,36,"ME",16.12
"506",513,"FL07.33","ME",2007,10,10,283,15,43.68682,-69.792,242,127,115,180,62,"ME",9.96
"507",513,"FL07.34","ME",2007,10,10,283,20,43.72168,-69.78953,177,79,98,132,45,"ME",15.78
"508",513,"FL07.37","ME",2007,10,11,284,20,43.77993,-69.44453,52,19,33,36,16,"ME",16.56
"509",513,"FL07.38","ME",2007,10,11,284,20,43.83707,-69.48557,193,95,98,78,115,"ME",16.56
"510",512,"FL07.39","ME",2007,10,15,288,13,43.82507,-69.30932,389,209,180,163,226,"ME",6.864
"511",513,"FL07.4","ME",2007,10,1,274,16,42.9348666,-70.6590333,9,3,6,7,2,"ME",10.32
"512",512,"FL07.40","ME",2007,10,15,288,20,43.9633,-69.15377,435,184,251,232,203,"ME",16.44
"513",512,"FL07.41","ME",2007,10,15,288,20,43.8649,-69.08243,486,241,245,195,291,"ME",15.84
"514",512,"FL07.42","ME",2007,10,16,289,15,43.71662,-69.10048,6,3,3,6,0,"ME",9.735
"515",513,"FL07.43","ME",2007,10,16,289,20,43.63957,-69.13958,1,1,0,1,0,"ME",15.76
"516",512,"FL07.46","ME",2007,10,16,289,20,43.61867,-68.93727,1,1,0,1,0,"ME",15.86
"517",512,"FL07.47","ME",2007,10,17,290,16,44.09483,-69.00647,143,54,89,136,7,"ME",10.64
"518",512,"FL07.48","ME",2007,10,17,290,13,44.16955,-69.01648,52,28,24,40,12,"ME",7.059
"519",512,"FL07.49","ME",2007,10,18,291,19,43.77047,-68.78382,28,13,15,27,1,"ME",14.839
"520",513,"FL07.5","ME",2007,10,2,275,18,42.8940833,-70.54275,2,1,1,2,0,"ME",13.536
"521",512,"FL07.50","ME",2007,10,18,291,20,43.85347,-68.62492,5,1,4,5,0,"ME",16.2
"522",512,"FL07.51","ME",2007,10,18,291,20,43.90498,-68.59893,17,9,8,16,1,"ME",16.46
"523",512,"FL07.52","ME",2007,10,18,291,20,43.94707,-68.60172,83,35,48,69,14,"ME",15.8
"524",512,"FL07.53","ME",2007,10,18,291,20,43.90395,-68.75818,156,78,78,136,20,"ME",16.06
"525",512,"FL07.54","ME",2007,10,19,292,13,44.21033,-68.85875,7,6,1,5,2,"ME",7.176
"526",512,"FL07.55","ME",2007,10,19,292,20,44.32597,-68.84528,6,3,3,5,1,"ME",16.72
"527",512,"FL07.56","ME",2007,10,19,292,20,44.24352,-68.7183,7,3,4,7,0,"ME",15.28
"528",512,"FL07.57","ME",2007,10,19,292,13,44.15413,-68.79092,19,6,13,15,4,"ME",6.747
"529",512,"FL07.58","ME",2007,10,22,295,16,44.01633,-68.54388,195,106,89,130,65,"ME",10.64
"530",512,"FL07.59","ME",2007,10,22,295,18,44.00947,-68.40458,105,53,52,77,28,"ME",12.78
"531",512,"FL07.60","ME",2007,10,22,295,20,43.98107,-68.32378,26,19,7,25,1,"ME",16.68
"532",512,"FL07.61","ME",2007,10,22,295,20,43.93835,-68.42687,10,5,5,10,0,"ME",16.26
"533",512,"FL07.62","ME",2007,10,23,296,20,44.30088,-68.49808,21,9,12,18,3,"ME",16.74
"534",512,"FL07.63","ME",2007,10,23,296,17,44.32527,-68.54698,5,2,3,4,1,"ME",11.543
"535",512,"FL07.64","ME",2007,10,23,296,18,44.28285,-68.46753,35,14,21,30,5,"ME",13.77
"536",512,"FL07.66","ME",2007,10,24,297,18,43.92447,-68.26067,1,0,1,1,0,"ME",13.446
"537",512,"FL07.67","ME",2007,10,24,297,20,44.00592,-68.24162,12,4,8,12,0,"ME",16.88
"538",512,"FL07.68","ME",2007,10,25,298,18,44.21792,-68.07218,167,78,89,122,45,"ME",12.402
"539",512,"FL07.69","ME",2007,10,25,298,20,44.24065,-68.13213,286,138,148,145,141,"ME",16.08
"540",513,"FL07.7","ME",2007,10,2,275,20,43.03685,-70.41252,3,2,1,3,0,"ME",15.88
"541",512,"FL07.70","ME",2007,10,25,298,20,44.29997,-68.13112,296,150,146,219,77,"ME",16.62
"542",512,"FL07.71","ME",2007,10,25,298,18,44.28525,-68.20263,228,104,124,144,84,"ME",13.014
"543",512,"FL07.72","ME",2007,10,26,299,20,44.05567,-68.05497,4,3,1,4,0,"ME",16.12
"544",512,"FL07.74","ME",2007,10,26,299,20,44.10315,-67.88087,2,0,2,2,0,"ME",16.8
"545",512,"FL07.75","ME",2007,10,26,299,20,44.1628,-67.89048,1,1,0,1,0,"ME",16.8
"546",512,"FL07.76","ME",2007,10,29,302,20,44.24582,-67.91978,69,37,32,41,28,"ME",17.34
"547",512,"FL07.77","ME",2007,10,29,302,20,44.21873,-67.88205,60,31,29,51,9,"ME",16.34
"548",511,"FL07.78","ME",2007,10,29,302,20,44.25547,-67.8197,45,28,17,42,3,"ME",16.52
"549",512,"FL07.79","ME",2007,10,29,302,12,44.34998,-67.99373,171,116,55,123,48,"ME",6.108
"550",513,"FL07.8","ME",2007,10,2,275,20,42.96312,-70.50385,12,2,10,11,1,"ME",16.24
"551",511,"FL07.80","ME",2007,10,30,303,17,44.4683,-67.83085,6,3,3,4,2,"ME",13.056
"552",511,"FL07.84","ME",2007,10,31,304,20,44.31628,-67.52985,2,1,1,2,0,"ME",16.36
"553",511,"FL07.85","ME",2007,11,5,309,14,44.4275,-67.44237,44,30,14,43,1,"ME",8.022
"554",511,"FL07.86","ME",2007,11,5,309,17,44.5854,-67.3033,84,37,47,57,27,"ME",11.407
"555",511,"FL07.87","ME",2007,11,7,311,17,44.62545,-67.17223,70,38,32,51,19,"ME",11.679
"556",513,"FL07.9","ME",2007,10,2,275,20,42.99843,-70.49197,7,2,5,6,1,"ME",15.72
"557",513,"FL08.1","ME",2008,9,30,274,20,42.91122,-70.54472,19,7,12,18,1,"ME",17.36
"558",513,"FL08.10","ME",2008,10,2,276,18,43.17568,-70.43718,83,35,48,55,28,"ME",13.428
"559",513,"FL08.11","ME",2008,10,2,276,20,43.14127,-70.39387,32,16,16,26,6,"ME",16.44
"560",513,"FL08.12","ME",2008,10,2,276,20,43.16223,-70.28128,2,0,2,2,0,"ME",15.88
"561",513,"FL08.13","ME",2008,10,3,277,20,43.3931,-70.12047,1,1,0,1,0,"ME",16.16
"562",513,"FL08.14","ME",2008,10,4,278,20,43.41978,-70.29168,171,88,83,103,68,"ME",16.9
"563",513,"FL08.15","ME",2008,10,4,278,20,43.50288,-70.35162,138,52,86,92,46,"ME",17.22
"564",513,"FL08.16","ME",2008,10,4,278,13,43.55147,-70.28497,247,112,135,61,186,"ME",6.968
"565",513,"FL08.17","ME",2008,10,4,278,20,43.5023,-70.20673,185,84,101,130,55,"ME",16.78
"566",513,"FL08.18","ME",2008,10,6,280,14,43.77398,-70.03913,980,443,537,320,660,"ME",7.994
"567",513,"FL08.19","ME",2008,10,6,280,17,43.66093,-69.96473,284,162,122,115,169,"ME",11.458
"568",513,"FL08.2","ME",2008,9,30,274,20,42.87352,-70.5598,5,2,3,5,0,"ME",16.24
"569",513,"FL08.20","ME",2008,10,6,280,15,43.69512,-69.8969,106,57,49,86,20,"ME",8.265
"570",513,"FL08.24","ME",2008,10,7,281,20,43.54888,-69.90073,2,1,1,2,0,"ME",16.12
"571",513,"FL08.25","ME",2008,10,7,281,20,43.6017,-69.87338,18,8,10,11,7,"ME",16.02
"572",513,"FL08.26","ME",2008,10,8,282,20,43.6948,-69.74783,137,75,62,109,28,"ME",16.42
"573",513,"FL08.27","ME",2008,10,8,282,20,43.65918,-69.74447,90,46,44,65,25,"ME",16.18
"574",513,"FL08.29","ME",2008,10,8,282,15,43.74725,-69.69592,439,214,225,201,238,"ME",9.45
"575",513,"FL08.3","ME",2008,9,30,274,20,42.93712,-70.74353,272,143,129,164,108,"ME",16.18
"576",513,"FL08.30","ME",2008,10,9,283,20,43.68315,-69.51225,1,1,0,1,0,"ME",17.04
"577",513,"FL08.31","ME",2008,10,9,283,20,43.76767,-69.4853,68,25,43,49,19,"ME",17.12
"578",513,"FL08.32","ME",2008,10,10,284,20,43.8268,-69.48985,309,168,141,122,187,"ME",16.12
"579",513,"FL08.33","ME",2008,10,10,284,20,43.7385,-69.41063,25,12,13,18,7,"ME",16.68
"580",513,"FL08.34","ME",2008,10,10,284,20,43.76533,-69.35542,83,37,46,61,22,"ME",16.74
"581",512,"FL08.35","ME",2008,10,13,287,20,43.7538,-69.20933,77,32,45,50,27,"ME",16.58
"582",512,"FL08.36","ME",2008,10,13,287,20,43.77648,-69.18233,150,80,70,72,78,"ME",16.46
"583",512,"FL08.37","ME",2008,10,13,287,20,43.96653,-69.13987,825,371,454,304,521,"ME",15.62
"584",512,"FL08.38","ME",2008,10,14,288,19,44.29745,-68.96707,327,162,165,210,117,"ME",15.504
"585",512,"FL08.39","ME",2008,10,14,288,19,44.25812,-69.00072,122,48,74,58,64,"ME",15.162
"586",513,"FL08.4","ME",2008,9,30,274,20,42.98288,-70.65973,127,68,59,70,57,"ME",17
"587",512,"FL08.40","ME",2008,10,14,288,20,44.13732,-68.96527,68,30,38,59,9,"ME",15.98
"588",512,"FL08.41","ME",2008,10,15,289,20,43.8249,-69.04438,237,118,119,141,96,"ME",16.5
"589",512,"FL08.44","ME",2008,10,15,289,20,43.61313,-68.94018,1,1,0,1,0,"ME",16.7
"590",512,"FL08.45","ME",2008,10,16,290,20,43.85387,-68.62478,4,2,2,4,0,"ME",16.04
"591",512,"FL08.46","ME",2008,10,16,290,16,43.76847,-68.72287,8,7,1,7,1,"ME",10.8
"592",512,"FL08.47","ME",2008,10,16,290,20,43.77428,-68.78533,17,7,10,15,2,"ME",16.06
"593",512,"FL08.48","ME",2008,10,10,284,13,43.8908,-68.79355,135,65,70,76,59,"ME",6.305
"594",512,"FL08.49","ME",2008,10,16,290,20,43.91338,-68.75448,119,58,61,79,40,"ME",15.94
"595",513,"FL08.5","ME",2008,10,1,275,20,42.89238,-70.43755,1,0,1,1,0,"ME",17.3
"596",512,"FL08.50","ME",2008,10,17,291,20,44.10618,-68.77242,666,307,359,366,300,"ME",16.84
"597",512,"FL08.51","ME",2008,10,17,291,15,44.15278,-68.78873,51,20,31,32,19,"ME",8.955
"598",512,"FL08.52","ME",2008,10,17,291,15,44.18762,-68.76087,130,56,74,88,42,"ME",9.18
"599",512,"FL08.53","ME",2008,10,20,294,19,44.30055,-68.49762,33,13,20,25,8,"ME",14.573
"600",512,"FL08.54","ME",2008,10,21,295,15,43.97462,-68.54847,223,132,91,180,43,"ME",9.075
"601",512,"FL08.55","ME",2008,10,21,295,20,43.94295,-68.57763,82,39,43,70,12,"ME",15.56
"602",512,"FL08.56","ME",2008,10,21,295,20,43.93165,-68.44923,18,12,6,18,0,"ME",16.14
"603",512,"FL08.57","ME",2008,10,21,295,20,44.00142,-68.38892,146,79,67,116,30,"ME",18.24
"604",512,"FL08.58","ME",2008,10,23,297,20,44.06388,-68.12458,41,31,10,37,4,"ME",16.8
"605",512,"FL08.59","ME",2008,10,23,297,20,44.05798,-68.05455,5,4,1,5,0,"ME",15.94
"606",512,"FL08.61","ME",2008,10,23,297,19,44.00607,-68.30143,46,25,21,41,5,"ME",13.699
"607",512,"FL08.62","ME",2008,10,24,298,20,44.43975,-68.2328,56,15,41,46,10,"ME",16.28
"608",512,"FL08.63","ME",2008,10,24,298,20,44.4574,-68.22713,21,11,10,19,2,"ME",15.98
"609",512,"FL08.64","ME",2008,10,24,298,20,44.44145,-68.16387,146,62,84,114,32,"ME",16.4
"610",512,"FL08.65","ME",2008,10,24,298,20,44.37253,-68.1696,257,107,150,145,112,"ME",16.72
"611",512,"FL08.66","ME",2008,10,24,298,12,44.2848,-68.13032,352,176,176,214,138,"ME",6.024
"612",512,"FL08.67","ME",2008,10,25,299,20,44.25737,-68.13282,652,344,308,407,245,"ME",16.22
"613",511,"FL08.68","ME",2008,10,28,302,20,44.16365,-67.81662,5,1,4,3,2,"ME",15.74
"614",513,"FL08.7","ME",2008,10,1,275,20,43.02943,-70.4451,4,2,2,4,0,"ME",16.34
"615",511,"FL08.70","ME",2008,10,28,302,20,44.21552,-67.7593,8,5,3,8,0,"ME",16.74
"616",511,"FL08.71","ME",2008,10,30,304,18,44.47222,-67.8338,120,56,64,39,81,"ME",12.258
"617",511,"FL08.72","ME",2008,10,31,305,19,44.2643,-67.80602,58,35,23,55,3,"ME",15.257
"618",511,"FL08.73","ME",2008,10,31,305,20,44.30433,-67.68377,38,21,17,38,0,"ME",15.46
"619",511,"FL08.74","ME",2008,10,31,305,20,44.28775,-67.62388,33,21,12,31,2,"ME",16.1
"620",511,"FL08.75","ME",2008,11,1,306,8,44.5837,-67.45293,51,27,24,16,35,"ME",2.728
"621",511,"FL08.76","ME",2008,11,1,306,20,44.59938,-67.43645,72,34,38,18,54,"ME",16.1
"622",511,"FL08.77","ME",2008,11,1,306,20,44.58925,-67.2961,95,57,38,57,38,"ME",18.52
"623",511,"FL08.78","ME",2008,11,2,307,20,44.51248,-67.45008,355,172,183,272,83,"ME",15.48
"624",511,"FL08.79","ME",2008,11,2,307,20,44.49432,-67.4348,262,135,127,208,54,"ME",16.62
"625",513,"FL08.8","ME",2008,10,1,275,20,43.08273,-70.45283,27,17,10,24,3,"ME",17.02
"626",513,"FL08.9","ME",2008,10,1,275,20,43.07835,-70.52085,121,60,61,76,45,"ME",16.8
"627",513,"FL09.1","ME",2009,10,5,278,20,42.95242,-70.64688,120,49,71,64,56,"ME",17.74
"628",513,"FL09.10","ME",2009,10,6,279,20,43.16943,-70.4413,156,74,82,107,49,"ME",16.94
"629",513,"FL09.11","ME",2009,10,7,280,20,43.16312,-70.3108,1,1,0,0,1,"ME",17.62
"630",513,"FL09.15","ME",2009,10,8,281,15,43.55187,-70.28275,6,1,5,4,2,"ME",8.64
"631",513,"FL09.16","ME",2009,10,8,281,20,43.50108,-70.34808,29,15,14,19,10,"ME",16.06
"632",513,"FL09.17","ME",2009,10,8,281,16,43.42303,-70.28948,186,91,95,85,101,"ME",9.36
"633",513,"FL09.18","ME",2009,10,8,281,20,43.39547,-70.25067,88,29,59,61,27,"ME",15.92
"634",513,"FL09.19","ME",2009,10,8,281,20,43.43183,-70.22053,55,26,29,45,10,"ME",16.42
"635",513,"FL09.2","ME",2009,10,5,278,20,42.8912,-70.60727,21,9,12,20,1,"ME",17.3
"636",513,"FL09.20","ME",2009,10,8,281,20,43.49023,-70.21178,352,153,199,198,154,"ME",16.3
"637",513,"FL09.24","ME",2009,10,12,285,20,43.61165,-69.86067,46,29,17,33,13,"ME",16.92
"638",513,"FL09.25","ME",2009,10,12,285,20,43.59137,-69.94907,37,11,26,24,13,"ME",16.34
"639",513,"FL09.26","ME",2009,10,13,286,19,43.70628,-70.17897,320,142,178,151,169,"ME",14.041
"640",513,"FL09.27","ME",2009,10,13,286,20,43.76333,-70.08225,384,172,212,187,197,"ME",17.76
"641",513,"FL09.28","ME",2009,10,13,286,20,43.70175,-69.86883,122,58,64,92,30,"ME",15.44
"642",513,"FL09.29","ME",2009,10,13,286,10,43.66742,-69.84795,27,15,12,17,10,"ME",3.71
"643",513,"FL09.3","ME",2009,10,5,278,20,42.89978,-70.68687,58,19,39,38,20,"ME",16.88
"644",513,"FL09.30","ME",2009,10,14,287,20,43.74505,-69.74116,119,53,66,61,58,"ME",16.42
"645",513,"FL09.31","ME",2009,10,14,287,15,43.7649,-69.69803,476,254,222,197,279,"ME",9.015
"646",513,"FL09.32","ME",2009,10,14,287,20,43.737,-69.66373,289,135,154,98,191,"ME",16.04
"647",513,"FL09.33","ME",2009,10,14,287,20,43.68517,-69.65658,360,163,197,202,158,"ME",16.7
"648",513,"FL09.34","ME",2009,10,15,288,20,43.82757,-69.48802,507,252,255,187,320,"ME",16.7
"649",513,"FL09.35","ME",2009,10,15,288,20,43.76298,-69.50522,40,16,24,30,10,"ME",16.32
"650",513,"FL09.36","ME",2009,10,15,288,20,43.7505,-69.432,63,34,29,53,10,"ME",15.84
"651",513,"FL09.37","ME",2009,10,15,288,13,43.69507,-69.51135,1,1,0,1,0,"ME",6.63
"652",513,"FL09.39","ME",2009,10,15,288,20,43.57193,-69.63093,2,2,0,2,0,"ME",16.3
"653",513,"FL09.4","ME",2009,10,5,278,20,42.93647,-70.74683,110,66,44,52,58,"ME",16.66
"654",512,"FL09.40","ME",2009,10,20,293,20,43.77322,-69.18077,381,184,197,178,203,"ME",16.04
"655",512,"FL09.41","ME",2009,10,20,293,20,43.77143,-69.11715,217,105,112,178,39,"ME",17.2
"656",512,"FL09.42","ME",2009,10,20,293,20,43.79877,-69.07487,358,189,169,268,90,"ME",16.64
"657",512,"FL09.43","ME",2009,10,20,293,19,43.88365,-69.23037,1830,916,912,935,895,"ME",14.896
"658",512,"FL09.44","ME",2009,10,21,294,20,44.28097,-68.85493,11,4,7,10,1,"ME",16.02
"659",512,"FL09.45","ME",2009,10,21,294,15,44.25558,-68.90297,23,7,16,19,4,"ME",8.16
"660",512,"FL09.46","ME",2009,10,21,294,16,44.13242,-68.94602,332,139,193,182,150,"ME",10.416
"661",512,"FL09.47","ME",2009,10,21,294,16,44.15128,-69.01705,166,75,91,119,47,"ME",10.624
"662",512,"FL09.48","ME",2009,10,21,294,20,44.23647,-68.97873,144,52,92,76,68,"ME",15.26
"663",512,"FL09.49","ME",2009,10,21,294,20,44.11992,-69.0525,117,46,71,55,62,"ME",14.56
"664",513,"FL09.5","ME",2009,10,5,278,20,42.98135,-70.66407,485,259,226,186,299,"ME",15.78
"665",512,"FL09.50","ME",2009,10,22,295,20,43.77767,-68.7155,38,19,19,35,3,"ME",16.48
"666",512,"FL09.51","ME",2009,10,22,295,20,43.7813,-68.637,15,9,6,15,0,"ME",16.36
"667",512,"FL09.52","ME",2009,10,22,295,20,43.74165,-68.63407,3,3,0,3,0,"ME",14.5
"668",512,"FL09.53","ME",2009,10,22,295,20,43.78463,-68.66343,19,14,5,19,0,"ME",15.54
"669",512,"FL09.54","ME",2009,10,23,296,20,43.93502,-68.77335,225,113,112,176,49,"ME",16.22
"670",512,"FL09.55","ME",2009,10,23,296,15,43.91453,-68.75512,293,129,164,230,63,"ME",8.535
"671",512,"FL09.56","ME",2009,10,23,296,19,44.10335,-68.77237,181,67,114,121,60,"ME",15.01
"672",512,"FL09.57","ME",2009,10,23,296,20,44.14093,-68.7614,403,173,230,347,56,"ME",15.46
"673",512,"FL09.58","ME",2009,10,26,299,20,43.9222,-68.58328,138,67,71,129,9,"ME",15.5
"674",512,"FL09.59","ME",2009,10,26,299,20,43.88298,-68.4619,12,10,2,11,1,"ME",15.82
"675",513,"FL09.6","ME",2009,10,6,279,20,42.98918,-70.49757,9,3,6,9,0,"ME",16.52
"676",512,"FL09.60","ME",2009,10,26,299,20,43.91987,-68.40627,18,9,9,17,1,"ME",15.9
"677",512,"FL09.61","ME",2009,10,26,299,20,44.15348,-68.54553,157,72,85,108,49,"ME",15.98
"678",512,"FL09.62","ME",2009,10,27,300,19,44.01963,-68.39332,232,107,125,188,44,"ME",14.63
"679",512,"FL09.63","ME",2009,10,27,300,20,43.99182,-68.31085,73,41,32,73,0,"ME",16.74
"680",512,"FL09.64","ME",2009,10,27,300,20,43.9426,-68.28512,32,17,15,32,0,"ME",16.84
"681",512,"FL09.65","ME",2009,10,27,300,20,44.01528,-68.2478,53,28,25,53,0,"ME",16.24
"682",512,"FL09.66","ME",2009,10,27,300,16,44.04202,-68.26622,143,68,75,133,10,"ME",10.864
"683",512,"FL09.67","ME",2009,10,28,301,16,44.27697,-68.4672,100,44,56,69,31,"ME",10.256
"684",512,"FL09.68","ME",2009,10,28,301,20,44.30812,-68.46977,75,24,51,60,15,"ME",16.46
"685",512,"FL09.69","ME",2009,10,28,301,20,44.24088,-68.45495,272,109,163,198,74,"ME",15.82
"686",513,"FL09.7","ME",2009,10,6,279,20,42.95278,-70.36683,1,0,1,1,0,"ME",16.22
"687",512,"FL09.70","ME",2009,10,29,302,20,44.35643,-68.16862,701,324,376,258,443,"ME",16.04
"688",512,"FL09.71","ME",2009,10,29,302,19,44.41905,-68.1892,461,221,240,361,100,"ME",13.946
"689",512,"FL09.72","ME",2009,10,29,302,20,44.43518,-68.15637,147,55,92,85,62,"ME",15.7
"690",512,"FL09.73","ME",2009,10,29,302,20,44.3819,-68.11633,760,352,408,287,473,"ME",16.46
"691",512,"FL09.74","ME",2009,10,29,302,20,44.31628,-68.1318,630,270,359,233,397,"ME",16.74
"692",512,"FL09.75","ME",2009,10,29,302,20,44.28657,-68.13127,736,352,384,361,375,"ME",16.7
"693",512,"FL09.76","ME",2009,10,30,303,15,44.05778,-68.0536,41,26,15,41,0,"ME",9
"694",512,"FL09.77","ME",2009,10,30,303,20,44.10947,-68.00042,80,46,34,80,0,"ME",18.12
"695",512,"FL09.78","ME",2009,10,30,303,18,44.19183,-67.96925,152,71,81,138,14,"ME",13.968
"696",512,"FL09.79","ME",2009,11,2,306,20,44.24632,-67.918,181,109,72,125,56,"ME",16.62
"697",513,"FL09.8","ME",2009,10,6,279,20,43.0653,-70.41388,5,0,5,4,1,"ME",16.8
"698",511,"FL09.80","ME",2009,11,2,306,18,44.29095,-67.79897,69,42,27,58,11,"ME",13.212
"699",511,"FL09.81","ME",2009,11,2,306,20,44.16653,-67.8088,3,1,2,3,0,"ME",16.02
"700",511,"FL09.82","ME",2009,11,2,306,20,44.20438,-67.77248,44,35,9,44,0,"ME",16.46
"701",511,"FL09.83","ME",2009,11,3,307,15,44.31762,-67.5935,94,53,41,89,5,"ME",8.28
"702",511,"FL09.84","ME",2009,11,3,307,20,44.25672,-67.66623,22,13,9,22,0,"ME",15.6
"703",511,"FL09.85","ME",2009,11,3,307,20,44.29198,-67.51308,9,6,3,9,0,"ME",13.82
"704",511,"FL09.86","ME",2009,11,3,307,20,44.31402,-67.52567,8,5,3,8,0,"ME",17.22
"705",511,"FL09.87","ME",2009,11,4,308,15,44.48912,-67.78183,154,70,84,52,102,"ME",9.585
"706",511,"FL09.88","ME",2009,11,4,308,20,44.47003,-67.83148,4,3,1,1,3,"ME",16.28
"707",511,"FL09.89","ME",2009,11,4,308,15,44.50262,-67.69963,14,4,10,10,4,"ME",9.225
"708",513,"FL09.9","ME",2009,10,6,279,20,43.15372,-70.37805,32,12,20,25,7,"ME",16.84
"709",511,"FL09.90","ME",2009,11,5,309,16,44.52045,-67.44755,184,91,93,145,39,"ME",11.296
"710",511,"FL09.91","ME",2009,11,5,309,20,44.58625,-67.30272,211,111,100,136,75,"ME",17.84
"711",511,"FL09.92","ME",2009,11,5,309,12,44.41667,-67.45858,62,36,26,61,1,"ME",6.264
"712",513,"FL10.1","ME",2010,10,4,277,20,42.93792,-70.74328,295,156,139,161,134,"ME",16.47
"713",513,"FL10.10","ME",2010,10,8,281,20,43.1972,-70.51543,173,83,90,107,66,"ME",16.552
"714",513,"FL10.11","ME",2010,10,8,281,20,43.22188,-70.57015,376,192,184,154,222,"ME",17.08
"715",513,"FL10.12","ME",2010,10,8,281,15,43.30297,-70.4956,374,191,183,109,265,"ME",8.7795
"716",513,"FL10.13","ME",2010,10,8,281,20,43.25292,-70.14643,4,1,3,0,4,"ME",15.94
"717",513,"FL10.14","ME",2010,10,8,281,20,43.35583,-70.08582,1,1,0,1,0,"ME",17.216
"718",513,"FL10.15","ME",2010,10,8,281,20,43.40633,-70.09068,1,1,0,1,0,"ME",16.628
"719",513,"FL10.16","ME",2010,10,9,282,20,43.48968,-70.19118,307,141,166,201,106,"ME",16.4
"720",513,"FL10.17","ME",2010,10,9,282,18,43.43158,-70.27873,338,168,170,175,163,"ME",12.4992
"721",513,"FL10.18","ME",2010,10,11,284,20,43.48108,-69.96477,1,1,0,1,0,"ME",17.004
"722",513,"FL10.2","ME",2010,10,5,278,20,42.86988,-70.74083,106,50,56,66,40,"ME",17.34
"723",513,"FL10.20","ME",2010,10,11,284,20,43.55208,-69.91668,5,5,0,5,0,"ME",16.268
"724",513,"FL10.21","ME",2010,10,11,284,20,43.61168,-69.86073,78,46,32,53,25,"ME",13.258
"725",513,"FL10.22","ME",2010,10,12,285,20,43.76318,-70.08045,175,90,85,109,66,"ME",16.59
"726",513,"FL10.23","ME",2010,10,12,285,20,43.66185,-70.08118,1060,542,518,263,797,"ME",15.234
"727",513,"FL10.24","ME",2010,10,12,285,16,43.6497,-70.00947,241,138,103,62,179,"ME",9.6128
"728",513,"FL10.25","ME",2010,10,12,285,20,43.65933,-69.95233,469,246,223,102,367,"ME",16.54
"729",513,"FL10.26","ME",2010,10,12,285,20,43.70092,-69.93762,612,315,297,176,436,"ME",15.956
"730",513,"FL10.27","ME",2010,10,13,286,19,43.79283,-69.69658,704,332,372,236,468,"ME",13.7199
"731",513,"FL10.28","ME",2010,10,13,286,10,43.76625,-69.69932,132,48,84,25,107,"ME",3.829
"732",513,"FL10.29","ME",2010,10,13,286,20,43.71122,-69.82012,136,57,79,60,76,"ME",16.24
"733",513,"FL10.3","ME",2010,10,5,278,20,42.90707,-70.67815,80,46,34,44,36,"ME",16.804
"734",513,"FL10.30","ME",2010,10,13,286,20,43.69983,-69.74627,157,80,77,113,44,"ME",16.128
"735",513,"FL10.31","ME",2010,10,13,286,20,43.63447,-69.7509,223,119,104,160,63,"ME",16.85
"736",513,"FL10.32","ME",2010,10,13,286,20,43.62713,-69.71253,87,44,43,75,12,"ME",17.224
"737",513,"FL10.33","ME",2010,10,14,287,20,43.76557,-69.48083,203,106,97,142,61,"ME",16.944
"738",513,"FL10.34","ME",2010,10,14,287,20,43.73708,-69.4978,42,26,16,27,15,"ME",17.498
"739",513,"FL10.35","ME",2010,10,14,287,20,43.68217,-69.5134,7,3,4,6,1,"ME",16.612
"740",513,"FL10.36","ME",2010,10,14,287,20,43.63057,-69.47657,1,1,0,0,1,"ME",17.454
"741",513,"FL10.37","ME",2010,10,14,287,20,43.61538,-69.55132,1,1,0,1,0,"ME",15.906
"742",512,"FL10.39","ME",2010,10,18,291,15,43.77217,-69.18107,304,148,156,130,174,"ME",8.7
"743",513,"FL10.4","ME",2010,10,5,278,20,42.87993,-70.6057,19,9,10,16,3,"ME",16.278
"744",512,"FL10.40","ME",2010,10,18,291,20,43.8115,-69.07092,337,166,171,231,106,"ME",16.4
"745",512,"FL10.41","ME",2010,10,18,291,20,43.80008,-69.04603,633,291,342,367,266,"ME",16.2
"746",512,"FL10.42","ME",2010,10,19,292,20,44.2263,-68.8568,33,8,25,27,6,"ME",16.4229
"747",512,"FL10.43","ME",2010,10,19,292,16,44.3005,-68.79297,4,4,0,4,0,"ME",10.117552
"748",512,"FL10.44","ME",2010,10,19,292,12,44.31012,-68.87815,1,0,1,1,0,"ME",6.171324
"749",512,"FL10.45","ME",2010,10,19,292,20,44.20485,-68.9925,188,80,108,122,66,"ME",16.08688
"750",512,"FL10.46","ME",2010,10,19,292,20,44.25167,-69.00467,367,152,215,161,206,"ME",17.20398
"751",512,"FL10.47","ME",2010,10,19,292,20,44.13117,-69.04048,728,286,442,295,433,"ME",16.32118
"752",513,"FL10.48","ME",2010,10,20,293,20,43.64547,-69.13292,7,7,0,6,1,"ME",16.9747
"753",513,"FL10.49","ME",2010,10,20,293,20,43.55845,-69.13947,1,1,0,1,0,"ME",16.54282
"754",513,"FL10.5","ME",2010,10,5,278,20,42.91868,-70.56038,37,13,24,35,2,"ME",16.128
"755",513,"FL10.50","ME",2010,10,20,293,20,43.60605,-69.06427,5,5,0,5,0,"ME",17.7491
"756",513,"FL10.51","ME",2010,10,20,293,20,43.6063,-69.94735,10,9,1,10,0,"ME",18.13
"757",512,"FL10.52","ME",2010,10,21,294,20,43.90505,-68.75692,523,258,265,261,262,"ME",16.18716
"758",512,"FL10.53","ME",2010,10,21,294,20,43.76885,-68.65353,30,22,8,28,2,"ME",16.15398
"759",512,"FL10.54","ME",2010,10,21,294,20,43.7391,-68.63143,28,20,8,28,0,"ME",16.38052
"760",512,"FL10.55","ME",2010,10,21,294,20,43.91682,-68.77573,577,261,316,291,286,"ME",15.26596
"761",512,"FL10.56","ME",2010,10,22,295,20,44.13382,-68.7561,1230,515,715,932,298,"ME",16.00742
"762",512,"FL10.57","ME",2010,10,22,295,16,44.1869,-68.73755,447,169,278,350,97,"ME",10.18736
"763",512,"FL10.58","ME",2010,10,25,298,20,43.83287,-68.51662,25,19,6,25,0,"ME",16.954
"764",512,"FL10.59","ME",2010,10,25,298,20,43.87583,-68.39948,35,24,11,34,1,"ME",16.644
"765",513,"FL10.6","ME",2010,10,7,280,20,42.98858,-70.50262,36,16,20,28,8,"ME",15.47
"766",512,"FL10.60","ME",2010,10,25,298,20,43.91342,-68.41885,26,22,4,26,0,"ME",16.184
"767",512,"FL10.61","ME",2010,10,25,298,10,43.98835,-68.44193,76,28,48,58,18,"ME",4.166
"768",512,"FL10.62","ME",2010,10,26,299,20,44.36033,-68.53443,42,17,25,39,3,"ME",15.54
"769",512,"FL10.63","ME",2010,10,26,299,20,44.38855,-68.52867,18,7,11,17,1,"ME",16.248
"770",512,"FL10.64","ME",2010,10,26,299,17,44.25763,-68.4407,1456,604,852,747,709,"ME",11.5328
"771",512,"FL10.65","ME",2010,10,27,300,14,44.01608,-68.20225,43,32,11,41,2,"ME",6.8096
"772",512,"FL10.66","ME",2010,10,27,300,15,44.0617,-68.0498,28,17,11,26,2,"ME",6.8505
"773",512,"FL10.67","ME",2010,10,28,301,20,44.13347,-68.13308,398,207,191,174,224,"ME",17.11
"774",512,"FL10.68","ME",2010,10,29,302,20,44.44855,-68.24193,178,71,107,114,64,"ME",16.568
"775",512,"FL10.69","ME",2010,10,29,302,20,44.44592,-68.16915,237,114,123,110,127,"ME",16.268
"776",513,"FL10.7","ME",2010,10,7,280,20,43.01922,-70.45457,10,6,4,10,0,"ME",16.426
"777",512,"FL10.70","ME",2010,10,29,302,20,44.36018,-68.16292,840,390,450,146,694,"ME",16.988
"778",512,"FL10.71","ME",2010,10,29,302,20,44.28473,-68.13232,768,336,432,226,542,"ME",18.198
"779",512,"FL10.72","ME",2010,10,29,302,20,44.22277,-68.13298,865,427,438,191,674,"ME",16.018
"780",511,"FL10.73","ME",2010,11,1,305,20,44.19732,-67.80188,17,13,4,17,0,"ME",16.906
"781",511,"FL10.74","ME",2010,11,1,305,20,44.16655,-67.76738,3,1,2,3,0,"ME",15.37
"782",511,"FL10.75","ME",2010,11,1,305,20,44.46427,-67.85473,6,3,3,2,4,"ME",17.07
"783",511,"FL10.76","ME",2010,11,2,306,16,44.33365,-67.61787,162,90,72,151,11,"ME",10.1648
"784",511,"FL10.77","ME",2010,11,2,306,16,44.29905,-67.69938,91,46,45,84,7,"ME",11.6272
"785",511,"FL10.78","ME",2010,11,2,306,15,44.3476,-67.71618,199,97,101,152,47,"ME",9.48
"786",511,"FL10.79","ME",2010,11,3,307,20,44.3134,-67.52632,32,24,8,31,1,"ME",16.088
"787",511,"FL10.80","ME",2010,11,3,307,20,44.30027,-67.49773,19,15,4,19,0,"ME",17.41
"788",511,"FL10.81","ME",2010,11,3,307,20,44.2461,-67.48428,2,2,0,2,0,"ME",14.296
"789",511,"FL10.82","ME",2010,11,3,307,20,44.28927,-67.62123,35,22,13,34,1,"ME",16.472
"790",511,"FL10.83","ME",2010,11,3,307,20,44.28828,-67.66387,48,31,17,48,0,"ME",16.194
"791",511,"FL10.84","ME",2010,11,4,308,16,44.64035,-67.3202,52,24,28,34,18,"ME",10.7264
"792",511,"FL10.85","ME",2010,11,4,308,20,44.59745,-67.43785,3,1,2,2,1,"ME",17.132
"793",513,"FL10.9","ME",2010,10,7,280,20,42.95255,-70.49747,13,4,9,10,3,"ME",16.726
"794",513,"FL11.1","ME",2011,10,4,277,16,42.96282,-70.64532,271,145,126,129,142,"ME",9.28
"795",513,"FL11.10","ME",2011,10,6,279,16,43.197,-70.51407,174,99,75,73,101,"ME",9.92
"796",513,"FL11.11","ME",2011,10,6,279,20,43.1851,-70.53993,434,240,194,143,291,"ME",16.2
"797",513,"FL11.12","ME",2011,10,6,279,20,43.26965,-70.56955,572,250,322,410,162,"ME",15.8
"798",513,"FL11.13","ME",2011,10,7,280,15,43.29988,-70.24782,40,19,21,27,13,"ME",8.85
"799",513,"FL11.14","ME",2011,10,7,280,20,43.28772,-70.10752,2,1,1,2,0,"ME",16.8
"800",513,"FL11.16","ME",2011,10,7,280,20,43.4008,-70.1262,5,1,4,5,0,"ME",16
"801",513,"FL11.17","ME",2011,10,7,280,20,43.44603,-70.10098,26,9,17,18,8,"ME",15.6
"802",513,"FL11.18","ME",2011,10,8,281,20,43.4488,-70.19183,107,56,51,71,36,"ME",16.4
"803",513,"FL11.19","ME",2011,10,8,281,20,43.37027,-70.20753,25,7,18,20,5,"ME",16.2
"804",513,"FL11.2","ME",2011,10,4,277,16,42.9507,-70.66868,212,100,112,89,123,"ME",10.4
"805",513,"FL11.20","ME",2011,10,8,281,15,43.42472,-70.28778,175,79,96,90,85,"ME",8.4
"806",513,"FL11.21","ME",2011,10,8,281,20,43.50273,-70.34932,84,32,52,66,18,"ME",15.4
"807",513,"FL11.22","ME",2011,10,8,281,20,43.5275,-70.28117,864,416,448,326,538,"ME",16.6
"808",513,"FL11.23","ME",2011,10,10,283,20,43.45938,-70.04595,6,5,1,6,0,"ME",16.48
"809",513,"FL11.24","ME",2011,10,10,283,20,43.51873,-70.02862,22,13,9,18,4,"ME",16
"810",513,"FL11.25","ME",2011,10,10,283,20,43.56452,-69.92347,28,16,12,27,1,"ME",16
"811",513,"FL11.26","ME",2011,10,10,283,12,43.65655,-70.08943,276,176,100,123,153,"ME",5.64
"812",513,"FL11.27","ME",2011,10,10,283,18,43.66567,-70.1459,364,179,185,186,178,"ME",11.34
"813",513,"FL11.28","ME",2011,10,11,284,20,43.60178,-69.87282,71,36,35,49,22,"ME",17.4
"814",513,"FL11.29","ME",2011,10,11,284,20,43.71258,-69.80025,247,104,143,135,112,"ME",16.4
"815",513,"FL11.3","ME",2011,10,4,277,20,42.87798,-70.6787,95,45,50,48,47,"ME",16.8
"816",513,"FL11.30","ME",2011,10,11,284,15,43.73212,-69.72747,449,245,204,227,222,"ME",8.7
"817",513,"FL11.32","ME",2011,10,12,285,17,43.56278,-69.78192,11,5,6,9,2,"ME",10.71
"818",513,"FL11.33","ME",2011,10,12,285,17,43.71037,-69.74382,274,126,148,148,126,"ME",11.56
"819",513,"FL11.34","ME",2011,10,13,286,20,43.58185,-69.6237,10,9,1,10,0,"ME",16.4
"820",513,"FL11.35","ME",2011,10,13,286,18,43.61207,-69.54957,1,1,0,1,0,"ME",12.6
"821",513,"FL11.36","ME",2011,10,13,286,15,43.63243,-69.54413,4,1,3,4,0,"ME",8.25
"822",513,"FL11.37","ME",2011,10,14,287,15,43.83168,-69.4869,260,128,132,93,167,"ME",8.4
"823",512,"FL11.38","ME",2011,10,18,291,20,43.79855,-69.07292,507,273,234,309,198,"ME",15.6
"824",512,"FL11.39","ME",2011,10,18,291,20,43.83097,-69.06648,560,270,290,233,327,"ME",16.2
"825",513,"FL11.4","ME",2011,10,4,277,15,42.9289,-70.75225,276,134,142,155,121,"ME",9.15
"826",512,"FL11.40","ME",2011,10,18,291,15,43.96622,-69.14387,782,382,400,165,617,"ME",8.55
"827",512,"FL11.41","ME",2011,10,19,292,15,44.10995,-69.01815,1088,457,631,844,244,"ME",8.7
"828",512,"FL11.42","ME",2011,10,19,292,15,44.15398,-69.04863,535,229,306,125,410,"ME",9.45
"829",512,"FL11.43","ME",2011,10,19,292,20,44.23503,-68.98295,349,143,206,213,136,"ME",15.8
"830",512,"FL11.44","ME",2011,10,19,292,16,44.21682,-69.03928,203,59,144,135,68,"ME",9.92
"831",512,"FL11.45","ME",2011,10,19,292,15,44.17458,-69.01588,235,93,142,167,68,"ME",8.85
"832",512,"FL11.46","ME",2011,10,22,295,15,43.92358,-68.785283,573,287,286,281,292,"ME",8.85
"833",512,"FL11.47","ME",2011,10,22,295,15,43.91218,-68.75462,522,231,291,267,255,"ME",9.15
"834",512,"FL11.48","ME",2011,10,22,295,10,43.77268,-68.72297,53,23,30,41,12,"ME",3.6
"835",512,"FL11.49","ME",2011,10,22,295,20,43.77082,-68.65028,27,16,11,25,2,"ME",17.4
"836",513,"FL11.5","ME",2011,10,5,278,20,43.07917,-70.41403,69,31,38,51,18,"ME",15.8
"837",512,"FL11.50","ME",2011,10,22,295,15,43.79918,-68.62673,37,22,15,35,2,"ME",8.85
"838",512,"FL11.51","ME",2011,10,24,297,10,43.93817,-68.58767,140,66,74,109,31,"ME",3.7
"839",512,"FL11.52","ME",2011,10,24,297,20,43.90822,-68.57045,277,141,136,237,40,"ME",15.8
"840",512,"FL11.53","ME",2011,10,24,297,20,43.9365,-68.55352,232,121,111,196,36,"ME",15
"841",512,"FL11.54","ME",2011,10,24,297,16,43.99027,-68.44163,201,113,88,148,53,"ME",10.56
"842",512,"FL11.55","ME",2011,10,25,298,20,44.3531,-68.45698,3,1,2,3,0,"ME",17
"843",512,"FL11.57","ME",2011,10,25,298,15,44.32498,-68.46983,105,42,63,85,20,"ME",8.7
"844",512,"FL11.58","ME",2011,10,25,298,18,44.29273,-68.47807,95,42,53,73,22,"ME",13.14
"845",512,"FL11.59","ME",2011,10,26,299,20,43.95497,-68.34603,66,47,19,64,2,"ME",16.6
"846",513,"FL11.6","ME",2011,10,5,278,20,43.12137,-70.27128,3,2,1,3,0,"ME",16.4
"847",512,"FL11.60","ME",2011,10,26,299,20,43.9557,-68.2355,35,20,15,35,0,"ME",15.4
"848",512,"FL11.61","ME",2011,10,26,299,15,44.00632,-68.20607,43,22,21,41,2,"ME",8.7
"849",512,"FL11.62","ME",2011,10,26,299,20,44.22993,-68.1336,978,493,485,252,726,"ME",16.4
"850",512,"FL11.63","ME",2011,10,27,300,20,44.28717,-68.1306,785,368,417,338,447,"ME",17
"851",512,"FL11.64","ME",2011,10,27,300,18,44.46628,-68.24382,129,62,67,56,73,"ME",12.78
"852",512,"FL11.65","ME",2011,10,27,300,15,44.442,-68.16428,282,140,142,146,136,"ME",8.25
"853",512,"FL11.66","ME",2011,10,27,300,17,44.39163,-68.1164,1511,753,757,619,892,"ME",11.39
"854",512,"FL11.67","ME",2011,10,27,300,20,44.32705,-68.13275,1114,507,607,300,814,"ME",16.6
"855",512,"FL11.68","ME",2011,10,28,301,15,44.05613,-68.05728,57,40,17,54,3,"ME",8.85
"856",511,"FL11.69","ME",2011,11,1,305,20,44.26097,-67.8158,103,50,53,87,16,"ME",15.8
"857",513,"FL11.7","ME",2011,10,5,278,20,42.94153,-70.36463,1,1,0,1,0,"ME",17.6
"858",511,"FL11.70","ME",2011,11,1,305,20,44.16805,-67.74363,13,8,5,13,0,"ME",16.2
"859",511,"FL11.71","ME",2011,11,1,305,20,44.23302,-67.73733,18,11,7,18,0,"ME",15.4
"860",511,"FL11.72","ME",2011,11,1,305,20,44.297,-67.76342,123,63,60,91,32,"ME",16
"861",511,"FL11.73","ME",2011,11,2,306,17,44.49125,-67.78498,34,14,20,23,11,"ME",9.86
"862",511,"FL11.74","ME",2011,11,2,306,20,44.46337,-67.85492,9,4,5,2,7,"ME",15.8
"863",511,"FL11.75","ME",2011,11,2,306,20,44.35762,-67.71898,309,153,156,197,112,"ME",16
"864",511,"FL11.76","ME",2011,11,2,306,20,44.37025,-67.66912,436,191,245,258,178,"ME",16.2
"865",511,"FL11.77","ME",2011,11,2,306,16,44.41085,-67.58755,194,97,97,55,139,"ME",10.24
"866",511,"FL11.78","ME",2011,11,3,307,16,44.32395,-67.49908,86,47,39,83,3,"ME",8.8
"867",511,"FL11.79","ME",2011,11,3,307,20,44.29942,-67.49613,38,26,12,38,0,"ME",14.8
"868",513,"FL11.8","ME",2011,10,6,279,20,43.15128,-70.3825,86,42,44,58,28,"ME",16.6
"869",511,"FL11.80","ME",2011,11,3,307,18,44.24852,-67.4807,3,2,1,3,0,"ME",14.22
"870",511,"FL11.81","ME",2011,11,3,307,20,44.29997,-67.40297,2,1,1,2,0,"ME",14.2
"871",511,"FL11.82","ME",2011,11,4,308,20,44.58788,-67.29183,285,130,155,189,96,"ME",17
"872",511,"FL11.83","ME",2011,11,4,308,20,44.51545,-67.45562,266,135,131,150,116,"ME",15.4
"873",511,"FL11.84","ME",2011,11,4,308,20,44.5188,-67.396,184,73,111,103,81,"ME",15.6
"874",513,"FL11.9","ME",2011,10,6,279,19,43.19208,-70.41248,101,42,59,69,32,"ME",14.82
"875",513,"FL12.1","ME",2012,9,24,268,20,42.93247,-70.70838,287,163,124,82,205,"ME",16.65
"876",513,"FL12.10","ME",2012,9,26,270,20,43.02588,-70.39057,10,2,8,9,1,"ME",16.16
"877",513,"FL12.11","ME",2012,9,26,270,20,43.00573,-70.34373,1,1,0,1,0,"ME",16.59
"878",513,"FL12.12","ME",2012,9,26,270,20,43.04543,-70.35823,5,0,5,5,0,"ME",17.148
"879",513,"FL12.13","ME",2012,9,26,270,20,43.1645,-70.28008,4,1,3,4,0,"ME",16.286
"880",513,"FL12.14","ME",2012,9,26,270,18,43.20112,-70.29562,14,8,6,11,3,"ME",14.0328
"881",513,"FL12.15","ME",2012,9,27,271,18,43.15455,-70.37883,130,53,77,82,48,"ME",12.5442
"882",513,"FL12.16","ME",2012,9,27,271,16,43.26135,-70.34547,46,20,26,24,22,"ME",10.2416
"883",513,"FL12.17","ME",2012,9,27,271,19,43.23535,-70.51803,222,101,121,118,104,"ME",13.9631
"884",513,"FL12.18","ME",2012,9,27,271,20,43.28962,-70.51318,152,59,93,74,78,"ME",16.424
"885",513,"FL12.19","ME",2012,9,27,271,20,43.32013,-70.51962,553,277,276,206,347,"ME",16.178
"886",513,"FL12.2","ME",2012,9,24,268,16,42.91283,-70.79753,9,5,4,1,8,"ME",9.6928
"887",513,"FL12.20","ME",2012,9,28,272,20,43.3925,-70.12087,3,1,2,3,0,"ME",15.934
"888",513,"FL12.21","ME",2012,9,28,272,20,43.4535,-70.18432,133,69,64,90,43,"ME",16.58
"889",513,"FL12.22","ME",2012,9,28,272,16,43.40652,-70.23827,151,78,73,100,51,"ME",10.0032
"890",513,"FL12.23","ME",2012,9,28,272,20,43.52028,-70.30702,760,357,403,291,469,"ME",16.144
"891",513,"FL12.24","ME",2012,10,1,275,21,43.48018,-69.9488,2,1,1,1,1,"ME",18.5346
"892",513,"FL12.25","ME",2012,10,1,275,15,43.53682,-69.9134,13,6,7,8,5,"ME",8.814
"893",513,"FL12.26","ME",2012,10,1,275,16,43.63815,-70.17063,287,145,142,131,156,"ME",10.1648
"894",513,"FL12.27","ME",2012,10,2,276,12,43.64968,-70.00857,140,80,60,48,92,"ME",5.6328
"895",513,"FL12.28","ME",2012,10,2,276,15,43.70102,-69.93893,267,128,139,136,131,"ME",9.9525
"896",513,"FL12.29","ME",2012,10,2,276,20,43.66097,-69.86653,175,92,83,118,57,"ME",15.308
"897",513,"FL12.3","ME",2012,9,24,268,20,42.93652,-70.74752,299,146,153,151,148,"ME",16.164
"898",513,"FL12.30","ME",2012,10,2,276,20,43.61198,-69.86087,63,28,35,28,35,"ME",16.482
"899",513,"FL12.31","ME",2012,10,2,276,20,43.55915,-69.78773,2,2,0,2,0,"ME",16.11
"900",513,"FL12.32","ME",2012,10,2,276,18,43.62593,-69.71113,55,21,34,44,11,"ME",12.0564
"901",513,"FL12.33","ME",2012,10,3,277,20,43.79467,-69.70008,282,129,153,75,207,"ME",15.64
"902",513,"FL12.34","ME",2012,10,3,277,18,43.7007,-69.74785,499,252,247,321,178,"ME",12.8052
"903",513,"FL12.35","ME",2012,10,3,277,20,43.70783,-69.6921,202,105,97,98,104,"ME",15.54
"904",513,"FL12.36","ME",2012,10,3,277,13,43.78253,-69.64105,335,173,162,74,261,"ME",6.5104
"905",513,"FL12.38","ME",2012,10,4,278,15,43.60955,-69.5482,2,0,2,2,0,"ME",8.808
"906",513,"FL12.39","ME",2012,10,4,278,20,43.69257,-69.51182,19,12,7,14,5,"ME",16.012
"907",513,"FL12.4","ME",2012,9,24,268,20,42.98478,-70.6536,281,124,157,177,104,"ME",15.744
"908",513,"FL12.40","ME",2012,10,4,278,20,43.66565,-69.4439,3,2,1,1,2,"ME",17.154
"909",513,"FL12.41","ME",2012,10,4,278,15,43.74763,-69.40723,104,52,52,58,46,"ME",9.939
"910",513,"FL12.42","ME",2012,10,5,279,14,43.82058,-69.48985,229,118,111,84,145,"ME",7.6118
"911",513,"FL12.43","ME",2012,10,5,279,20,43.7641,-69.50187,170,86,84,93,77,"ME",16.962
"912",512,"FL12.44","ME",2012,10,8,282,20,43.75562,-69.21,253,126,127,113,140,"ME",16.342
"913",512,"FL12.45","ME",2012,10,8,282,17,43.77638,-69.14708,159,73,86,75,84,"ME",12.0649
"914",512,"FL12.46","ME",2012,10,8,282,16,43.8178,-69.10727,317,180,137,116,201,"ME",9.6976
"915",512,"FL12.47","ME",2012,10,8,282,20,43.85738,-69.08283,781,355,426,172,609,"ME",16.236
"916",512,"FL12.48","ME",2012,10,8,282,7,43.8759,-69.03818,161,67,94,56,105,"ME",2.0286
"917",512,"FL12.49","ME",2012,10,9,283,20,44.18055,-68.92865,430,166,264,301,129,"ME",16.696
"918",513,"FL12.5","ME",2012,9,25,269,20,43.04877,-70.46863,103,38,65,75,28,"ME",17.09
"919",512,"FL12.50","ME",2012,10,9,283,20,44.22575,-68.8584,133,53,80,81,52,"ME",15.496
"920",512,"FL12.51","ME",2012,10,9,283,15,44.2655,-68.78855,4,1,3,3,1,"ME",8.985
"921",512,"FL12.52","ME",2012,10,9,283,16,44.29267,-68.7892,4,1,3,3,1,"ME",11.2
"922",512,"FL12.53","ME",2012,10,9,283,20,44.19147,-69.0299,528,233,295,363,165,"ME",16.394
"923",512,"FL12.54","ME",2012,10,9,283,16,43.72227,-69.09505,90,42,48,73,17,"ME",11.3088
"924",513,"FL12.55","ME",2012,10,9,283,20,43.60883,-69.06023,10,7,3,9,1,"ME",15.654
"925",513,"FL12.56","ME",2012,10,9,283,20,43.55857,-69.05077,4,4,0,4,0,"ME",16.054
"926",512,"FL12.57","ME",2012,10,10,284,20,43.61055,-68.93892,9,5,4,9,0,"ME",17.008
"927",512,"FL12.58","ME",2012,10,11,285,15,43.93397,-68.7859,411,209,202,137,274,"ME",8.9085
"928",512,"FL12.59","ME",2012,10,12,286,16,44.10413,-68.7731,415,183,232,212,203,"ME",9.648
"929",513,"FL12.6","ME",2012,9,25,269,20,42.98882,-70.45473,18,6,12,15,3,"ME",15.992
"930",512,"FL12.60","ME",2012,10,12,286,20,44.1347,-68.75695,707,335,372,525,182,"ME",15.258
"931",512,"FL12.61","ME",2012,10,12,286,12,44.18003,-68.76837,276,131,145,202,74,"ME",5.6304
"932",512,"FL12.62","ME",2012,10,16,290,12,44.20958,-68.43847,319,139,180,188,131,"ME",6.0024
"933",512,"FL12.63","ME",2012,10,16,290,17,44.30453,-68.47023,116,47,69,100,16,"ME",10.4856
"934",512,"FL12.65","ME",2012,10,16,290,20,44.38902,-68.44858,20,6,14,20,0,"ME",16.206
"935",512,"FL12.66","ME",2012,10,16,290,18,44.3908,-68.49703,8,3,5,8,0,"ME",13.7682
"936",512,"FL12.67","ME",2012,10,17,291,20,43.93772,-68.36318,39,23,16,38,1,"ME",17.744
"937",512,"FL12.68","ME",2012,10,17,291,20,43.90258,-68.28787,10,8,2,10,0,"ME",16.018
"938",512,"FL12.69","ME",2012,10,17,291,20,43.96273,-68.2316,20,9,11,20,0,"ME",16.5
"939",513,"FL12.7","ME",2012,9,25,269,20,42.8874,-70.54012,14,3,11,13,1,"ME",16.212
"940",512,"FL12.70","ME",2012,10,17,291,15,44.03008,-68.30152,141,73,68,110,31,"ME",9.072
"941",512,"FL12.71","ME",2012,10,17,291,20,44.04043,-68.26428,153,81,72,104,49,"ME",16.604
"942",512,"FL12.72","ME",2012,10,17,291,15,44.03813,-68.21985,69,46,23,46,23,"ME",9.258
"943",512,"FL12.73","ME",2012,10,18,292,20,44.1809,-68.02067,198,93,105,129,69,"ME",16.028
"944",512,"FL12.74","ME",2012,10,18,292,20,44.0771,-68.04052,41,27,14,38,3,"ME",17.432
"945",512,"FL12.75","ME",2012,10,18,292,15,44.05413,-68.05973,17,9,8,17,0,"ME",8.8995
"946",512,"FL12.76","ME",2012,10,18,292,17,44.12078,-68.12453,193,109,84,82,111,"ME",10.931
"947",512,"FL12.77","ME",2012,10,18,292,20,44.14565,-68.1125,308,155,153,105,203,"ME",14.362
"948",512,"FL12.78","ME",2012,10,19,293,20,44.29877,-68.13035,1016,478,538,301,715,"ME",16.55
"949",512,"FL12.79","ME",2012,10,19,293,20,44.36043,-68.16342,679,300,379,185,494,"ME",16.548
"950",513,"FL12.8","ME",2012,9,25,269,13,42.94557,-70.6082,118,59,59,65,53,"ME",6.8315
"951",512,"FL12.80","ME",2012,10,19,293,20,44.43968,-68.2219,149,73,76,107,42,"ME",15.942
"952",512,"FL12.81","ME",2012,10,19,293,18,44.45893,-68.20748,26,9,17,21,5,"ME",12.4308
"953",512,"FL12.82","ME",2012,10,19,293,15,44.43455,-68.17208,255,110,145,154,101,"ME",8.1795
"954",511,"FL12.83","ME",2012,10,22,296,20,44.27013,-67.87585,210,117,93,125,85,"ME",17.072
"955",511,"FL12.84","ME",2012,10,22,296,15,44.49985,-67.70197,83,38,45,30,53,"ME",9.597
"956",511,"FL12.85","ME",2012,10,23,297,20,44.27263,-67.57628,7,2,5,7,0,"ME",17.826
"957",511,"FL12.86","ME",2012,10,23,297,15,44.19192,-67.71975,18,14,4,17,1,"ME",8.085
"958",511,"FL12.87","ME",2012,10,23,297,20,44.1649,-67.74083,10,7,3,10,0,"ME",14.804
"959",511,"FL12.88","ME",2012,10,23,297,20,44.2313,-67.78455,133,82,51,130,3,"ME",16.544
"960",511,"FL12.89","ME",2012,10,24,298,20,44.29382,-67.51047,12,10,2,12,0,"ME",15.268
"961",513,"FL12.9","ME",2012,9,25,269,17,42.91007,-70.64555,108,56,52,70,38,"ME",12.4083
"962",511,"FL12.90","ME",2012,10,24,298,20,44.29033,-67.4152,2,1,1,2,0,"ME",15.612
"963",511,"FL12.91","ME",2012,10,24,298,17,44.39757,-67.52565,186,101,85,157,29,"ME",11.9493
"964",511,"FL12.92","ME",2012,10,24,298,15,44.42492,-67.5626,240,142,98,183,57,"ME",8.934
"965",511,"FL12.93","ME",2012,10,25,299,16,44.5146,-67.27357,56,33,23,39,17,"ME",9.9072
"966",511,"FL12.94","ME",2012,10,25,299,15,44.52998,-67.29402,234,135,99,141,93,"ME",10.203
"967",511,"FL12.95","ME",2012,10,25,299,19,44.58803,-67.30303,188,96,92,159,29,"ME",14.6984
"968",511,"FL12.96","ME",2012,10,25,299,20,44.5921,-67.45183,15,6,9,12,3,"ME",16.68
"969",511,"FL12.97","ME",2012,10,25,299,15,44.59088,-67.36718,725,373,352,515,210,"ME",9.354
"970",467,"FL12.98","ME",2012,10,26,300,13,44.6972,-66.99487,218,94,124,161,57,"ME",6.7301
"971",467,"FL12.99","ME",2012,10,26,300,18,44.76717,-66.9747,22,10,12,20,2,"ME",14.4018
"972",513,"FL13.1","ME",2013,9,23,266,20,42.94033,-70.66058,360,170,190,191,169,"ME",15.154
"973",513,"FL13.10","ME",2013,9,25,268,20,43.28837,-70.53223,344,169,175,159,185,"ME",15.234
"974",513,"FL13.11","ME",2013,9,25,268,20,43.2021,-70.4091,81,31,50,33,48,"ME",16.634
"975",513,"FL13.12","ME",2013,9,25,268,15,43.15408,-70.37957,96,34,62,56,40,"ME",8.814
"976",513,"FL13.13","ME",2013,9,25,268,20,43.06317,-70.46053,51,23,28,46,5,"ME",16.834
"977",513,"FL13.15","ME",2013,9,26,269,20,43.1644,-70.27735,2,0,2,2,0,"ME",16.004
"978",513,"FL13.16","ME",2013,9,26,269,20,43.23438,-70.2124,4,0,4,4,0,"ME",16.756
"979",513,"FL13.17","ME",2013,9,26,269,20,43.39757,-70.12318,3,1,2,3,0,"ME",15.628
"980",513,"FL13.19","ME",2013,9,27,270,20,43.51285,-70.19217,221,98,123,109,112,"ME",16.206
"981",513,"FL13.2","ME",2013,9,23,266,20,42.91317,-70.64128,116,59,57,59,57,"ME",16.974
"982",513,"FL13.20","ME",2013,9,27,270,20,43.42255,-70.22857,87,38,49,58,29,"ME",16.35
"983",513,"FL13.21","ME",2013,9,27,270,20,43.50377,-70.35195,230,102,128,161,69,"ME",16.746
"984",513,"FL13.22","ME",2013,9,27,270,18,43.53208,-70.26377,491,253,238,255,236,"ME",13.4064
"985",513,"FL13.23","ME",2013,9,27,270,20,43.51743,-70.24075,170,91,79,72,98,"ME",15.848
"986",513,"FL13.24","ME",2013,9,30,273,20,43.54908,-69.96438,6,3,3,5,1,"ME",16.062
"987",513,"FL13.25","ME",2013,9,30,273,20,43.50907,-70.11703,144,66,78,36,108,"ME",16.19
"988",513,"FL13.27","ME",2013,10,1,274,20,43.54098,-69.8728,12,6,6,12,0,"ME",16.484
"989",513,"FL13.28","ME",2013,10,1,274,19,43.5607666,-69.7845,5,2,3,5,0,"ME",15.2589
"990",513,"FL13.29","ME",2013,10,1,274,20,43.58042,-69.84628,49,30,19,46,3,"ME",16.302
"991",513,"FL13.3","ME",2013,9,23,266,20,42.93513,-70.74645,345,191,154,160,185,"ME",16.032
"992",513,"FL13.30","ME",2013,10,1,274,20,43.60097,-69.87247,74,35,39,50,24,"ME",16.146
"993",513,"FL13.31","ME",2013,10,1,274,20,43.66615,-69.90788,545,320,224,252,293,"ME",16.532
"994",513,"FL13.32","ME",2013,10,2,275,20,43.71185,-69.69232,218,108,110,112,106,"ME",16.548
"995",513,"FL13.33","ME",2013,10,2,275,20,43.73783,-69.73825,829,390,439,599,230,"ME",15.654
"996",513,"FL13.34","ME",2013,10,2,275,13,43.6978,-69.74838,317,161,156,223,94,"ME",6.9225
"997",513,"FL13.35","ME",2013,10,2,275,20,43.65868,-69.81033,297,147,150,216,81,"ME",16.866
"998",513,"FL13.36","ME",2013,10,2,275,19,43.62512,-69.7144,52,26,26,39,13,"ME",15.0765
"999",513,"FL13.37","ME",2013,10,2,275,15,43.78685,-69.64738,256,133,123,70,186,"ME",9.288
"1000",513,"FL13.38","ME",2013,10,3,276,20,43.6826,-69.51273,5,2,3,2,3,"ME",17.69
"1001",513,"FL13.40","ME",2013,10,3,276,20,43.61983,-69.40638,2,0,2,1,1,"ME",16.388
"1002",513,"FL13.41","ME",2013,10,3,276,19,43.75453,-69.36032,150,73,77,107,43,"ME",15.7434
"1003",513,"FL13.42","ME",2013,10,3,276,20,43.71873,-69.45335,8,4,4,6,2,"ME",16.966
"1004",513,"FL13.43","ME",2013,10,4,277,15,43.81897,-69.52815,354,182,172,120,234,"ME",9.069
"1005",513,"FL13.44","ME",2013,10,4,277,20,43.83782,-69.48415,248,118,130,67,181,"ME",15.622
"1006",513,"FL13.45","ME",2013,10,4,277,19,43.82043,-69.34965,191,97,94,37,154,"ME",14.1626
"1007",512,"FL13.46","ME",2013,10,7,280,20,43.76212,-69.21283,180,87,93,75,105,"ME",16.186
"1008",512,"FL13.47","ME",2013,10,7,280,17,43.74548,-69.17042,143,67,76,98,45,"ME",12.1414
"1009",512,"FL13.48","ME",2013,10,7,280,16,43.77472,-69.15308,119,54,65,64,55,"ME",10.8384
"1010",512,"FL13.49","ME",2013,10,7,280,16,43.88638,-69.22805,645,333,312,265,380,"ME",10.3248
"1011",513,"FL13.5","ME",2013,9,24,267,20,42.9416,-70.45175,3,1,2,3,0,"ME",15.51
"1012",512,"FL13.50","ME",2013,10,8,281,20,44.18182,-69.02042,516,225,291,318,198,"ME",17.028
"1013",512,"FL13.51","ME",2013,10,8,281,20,44.25717,-68.78738,15,5,10,13,2,"ME",17.714
"1014",512,"FL13.52","ME",2013,10,8,281,15,44.24422,-68.71963,54,18,36,43,11,"ME",9.7905
"1015",512,"FL13.53","ME",2013,10,8,281,20,44.29395,-68.75408,3,3,0,2,1,"ME",16.954
"1016",512,"FL13.54","ME",2013,10,8,281,17,44.29543,-68.96822,289,139,150,200,89,"ME",11.1503
"1017",512,"FL13.55","ME",2013,10,9,282,20,43.85258,-69.06005,427,219,208,128,299,"ME",16.908
"1018",513,"FL13.56","ME",2013,10,9,282,20,43.58167,-69.0826,3,3,0,1,2,"ME",16.212
"1019",512,"FL13.57","ME",2013,10,9,282,20,43.60972,-68.94223,13,3,10,11,2,"ME",17.288
"1020",512,"FL13.58","ME",2013,10,9,282,20,43.61478,-68.85023,10,6,4,10,0,"ME",16.116
"1021",512,"FL13.59","ME",2013,10,9,282,18,43.67957,-68.85778,46,27,19,43,3,"ME",13.2966
"1022",513,"FL13.6","ME",2013,9,24,267,20,42.92557,-70.50698,10,2,8,10,0,"ME",16.35
"1023",512,"FL13.60","ME",2013,10,10,283,20,43.90747,-68.75755,315,152,163,175,140,"ME",16.946
"1024",512,"FL13.61","ME",2013,10,10,283,20,43.89535,-68.6722,210,100,110,115,95,"ME",17.094
"1025",512,"FL13.62","ME",2013,10,10,283,11,43.85228,-68.62605,49,30,19,40,9,"ME",4.7443
"1026",512,"FL13.63","ME",2013,10,10,283,16,43.78513,-68.65913,31,12,19,31,0,"ME",10.4736
"1027",512,"FL13.64","ME",2013,10,10,283,12,43.85313,-68.73875,184,108,76,83,101,"ME",5.3844
"1028",512,"FL13.65","ME",2013,10,11,284,13,44.14697,-68.75983,284,121,163,184,100,"ME",7.0044
"1029",512,"FL13.66","ME",2013,10,11,284,20,44.1543,-68.78627,82,26,56,63,19,"ME",15.858
"1030",512,"FL13.67","ME",2013,10,14,287,20,43.90375,-68.36913,54,37,17,53,1,"ME",16.51
"1031",512,"FL13.68","ME",2013,10,14,287,18,44.05573,-68.39327,618,322,296,211,407,"ME",12.843
"1032",512,"FL13.69","ME",2013,10,14,287,20,44.01262,-68.39428,633,345,288,450,183,"ME",16.81
"1033",513,"FL13.7","ME",2013,9,24,267,20,42.97825,-70.516,120,49,71,67,53,"ME",15.828
"1034",512,"FL13.70","ME",2013,10,15,288,18,44.34588,-68.53927,55,17,38,38,17,"ME",12.789
"1035",512,"FL13.71","ME",2013,10,15,288,20,44.39073,-68.49515,20,7,13,17,3,"ME",16.634
"1036",512,"FL13.72","ME",2013,10,15,288,22,44.36988,-68.44577,18,10,8,15,3,"ME",19.6086
"1037",512,"FL13.73","ME",2013,10,16,289,20,44.04055,-68.26532,211,103,108,170,41,"ME",16.294
"1038",512,"FL13.74","ME",2013,10,16,289,17,43.9983,-68.09865,61,39,22,40,21,"ME",10.9038
"1039",512,"FL13.75","ME",2013,10,16,289,20,43.99458,-68.05595,19,10,9,19,0,"ME",17.21
"1040",512,"FL13.76","ME",2013,10,16,289,20,44.02223,-67.99077,3,3,0,3,0,"ME",16.702
"1041",512,"FL13.77","ME",2013,10,17,290,20,44.22805,-68.13298,712,342,370,200,512,"ME",17.63
"1042",512,"FL13.78","ME",2013,10,17,290,15,44.12893,-68.0071,105,56,49,88,17,"ME",7.8975
"1043",512,"FL13.79","ME",2013,10,17,290,20,44.15075,-67.90928,207,100,107,189,18,"ME",17.59
"1044",513,"FL13.8","ME",2013,9,25,268,18,43.19713,-70.54535,327,170,157,208,119,"ME",12.3696
"1045",512,"FL13.80","ME",2013,10,17,290,20,44.18815,-68.02987,187,94,93,129,58,"ME",15.138
"1046",512,"FL13.81","ME",2013,10,17,290,20,44.26607,-68.0254,490,242,248,196,294,"ME",16.438
"1047",512,"FL13.82","ME",2013,10,18,291,20,44.28517,-68.13085,545,274,271,238,307,"ME",17.178
"1048",512,"FL13.83","ME",2013,10,18,291,17,44.44842,-68.15785,126,58,68,72,54,"ME",11.6773
"1049",512,"FL13.84","ME",2013,10,18,291,20,44.43828,-68.24313,116,48,68,87,29,"ME",15.558
"1050",512,"FL13.85","ME",2013,10,18,291,20,44.36757,-68.16723,265,123,142,91,174,"ME",16.874
"1051",512,"FL13.86","ME",2013,10,21,294,20,44.24707,-67.91765,193,100,93,120,73,"ME",17.262
"1052",511,"FL13.87","ME",2013,10,21,294,20,44.19792,-67.76477,8,6,2,7,1,"ME",16.272
"1053",511,"FL13.88","ME",2013,10,22,295,11,44.36998,-67.6704,225,114,111,167,58,"ME",5.4098
"1054",511,"FL13.89","ME",2013,10,22,295,20,44.34367,-67.7535,296,146,150,200,96,"ME",17.716
"1055",513,"FL13.9","ME",2013,9,25,268,16,43.26973,-70.57185,359,147,212,214,145,"ME",10.5472
"1056",511,"FL13.90","ME",2013,10,22,295,20,44.46157,-67.85507,9,4,5,3,6,"ME",15.368
"1057",511,"FL13.92","ME",2013,10,23,296,13,44.34795,-67.50877,132,72,60,120,12,"ME",6.8627
"1058",511,"FL13.93","ME",2013,10,23,296,20,44.27687,-67.50478,25,21,4,25,0,"ME",16.172
"1059",511,"FL13.94","ME",2013,10,23,296,20,44.28,-67.56985,35,28,7,35,0,"ME",17.196
"1060",511,"FL13.95","ME",2013,10,24,297,16,44.4257,-67.15408,31,18,13,31,0,"ME",11.7904
"1061",511,"FL13.96","ME",2013,10,25,298,20,44.59352,-67.45217,2,2,0,1,1,"ME",16.082
"1062",513,"FL14.1","ME",2014,9,29,272,20,42.93445,-70.52753,41,11,30,37,4,"ME",16.774
"1063",513,"FL14.10","ME",2014,10,1,274,19,43.18572,-70.58178,91,46,45,66,25,"ME",14.1018
"1064",513,"FL14.11","ME",2014,10,1,274,20,43.23973,-70.5749,339,151,188,277,62,"ME",16.55
"1065",513,"FL14.12","ME",2014,10,1,274,20,43.30755,-70.49438,379,173,206,220,159,"ME",15.586
"1066",513,"FL14.13","ME",2014,10,1,274,20,43.23635,-70.51707,317,164,153,180,137,"ME",15.662
"1067",513,"FL14.14","ME",2014,10,1,274,19,43.21373,-70.40165,144,64,80,83,61,"ME",14.7345
"1068",513,"FL14.15","ME",2014,10,2,275,20,43.15673,-70.26588,1,1,0,1,0,"ME",16.822
"1069",513,"FL14.16","ME",2014,10,2,275,20,43.19123,-70.22215,1,0,1,1,0,"ME",15.924
"1070",513,"FL14.18","ME",2014,10,2,275,20,43.39658,-70.08043,3,1,2,3,0,"ME",17.382
"1071",513,"FL14.19","ME",2014,10,3,276,20,43.44932,-70.18278,107,41,66,93,14,"ME",17.004
"1072",513,"FL14.2","ME",2014,9,29,272,20,42.88882,-70.61062,26,9,17,25,1,"ME",15.742
"1073",513,"FL14.20","ME",2014,10,3,276,20,43.41193,-70.23197,145,69,76,118,27,"ME",15.594
"1074",513,"FL14.21","ME",2014,10,3,276,14,43.42172,-70.27438,124,58,66,73,51,"ME",8.008
"1075",513,"FL14.22","ME",2014,10,3,276,20,43.5033,-70.3646,17,5,12,3,14,"ME",15.918
"1076",513,"FL14.23","ME",2014,10,6,279,18,43.71043,-70.17545,388,163,225,201,187,"ME",13.7412
"1077",513,"FL14.24","ME",2014,10,6,279,20,43.67605,-70.14388,707,370,337,323,384,"ME",16.614
"1078",513,"FL14.25","ME",2014,10,6,279,16,43.65115,-70.00655,190,103,87,77,113,"ME",9.8112
"1079",513,"FL14.26","ME",2014,10,6,279,20,43.65785,-69.9113,656,402,254,361,295,"ME",15.352
"1080",513,"FL14.27","ME",2014,10,6,279,16,43.7825,-70.02205,54,22,32,35,19,"ME",10.0304
"1081",513,"FL14.28","ME",2014,10,7,280,20,43.56968,-69.95832,71,40,31,46,25,"ME",16.676
"1082",513,"FL14.29","ME",2014,10,7,280,20,43.50555,-70.00193,7,1,6,7,0,"ME",16.158
"1083",513,"FL14.3","ME",2014,9,29,272,20,42.8843,-70.6754,126,62,64,90,36,"ME",15.936
"1084",513,"FL14.30","ME",2014,10,7,280,20,43.51065,-69.92933,2,2,0,2,0,"ME",16.22
"1085",513,"FL14.31","ME",2014,10,7,280,20,43.50665,-69.88067,1,0,1,1,0,"ME",16.296
"1086",513,"FL14.32","ME",2014,10,7,280,15,43.57308,-69.80845,17,10,7,16,1,"ME",9.2385
"1087",513,"FL14.33","ME",2014,10,8,281,20,43.68965,-69.65628,220,107,113,98,122,"ME",16.654
"1088",513,"FL14.34","ME",2014,10,9,282,15,43.62523,-69.5984,35,14,21,33,2,"ME",9.033
"1089",513,"FL14.35","ME",2014,10,9,282,20,43.61745,-69.40783,1,1,0,1,0,"ME",15.948
"1090",513,"FL14.36","ME",2014,10,9,282,16,43.66357,-69.44737,6,4,2,5,1,"ME",11.056
"1091",513,"FL14.37","ME",2014,10,9,282,20,43.72545,-69.51032,43,19,24,30,13,"ME",16.476
"1092",513,"FL14.38","ME",2014,10,9,282,20,43.78653,-69.49222,244,108,136,100,144,"ME",16.378
"1093",513,"FL14.39","ME",2014,10,10,283,16,43.76857,-69.38855,223,122,101,133,90,"ME",10.0128
"1094",513,"FL14.4","ME",2014,9,29,272,16,42.94207,-70.72045,168,95,73,73,95,"ME",9.888
"1095",512,"FL14.40","ME",2014,10,10,283,20,43.8537,-69.28163,1297,688,609,548,749,"ME",16.106
"1096",512,"FL14.41","ME",2014,10,13,286,19,43.75317,-69.14545,82,47,35,66,16,"ME",13.6154
"1097",512,"FL14.42","ME",2014,10,13,286,18,43.73325,-69.0766,220,96,124,171,49,"ME",13.9194
"1098",512,"FL14.43","ME",2014,10,13,286,19,43.76972,-69.17785,499,262,237,209,290,"ME",13.9422
"1099",512,"FL14.44","ME",2014,10,13,286,20,43.84935,-69.28467,1495,735,760,524,971,"ME",15.424
"1100",512,"FL14.45","ME",2014,10,14,287,19,44.21328,-69.008,442,174,268,311,131,"ME",14.9872
"1101",512,"FL14.46","ME",2014,10,14,287,20,44.2972,-68.76967,12,5,7,12,0,"ME",16.21
"1102",512,"FL14.47","ME",2014,10,14,287,18,44.3233,-68.86567,23,5,18,21,2,"ME",13.9824
"1103",512,"FL14.48","ME",2014,10,14,287,20,44.25737,-68.89453,94,48,46,76,18,"ME",17.76
"1104",512,"FL14.49","ME",2014,10,14,287,20,44.21685,-68.90352,139,44,95,128,11,"ME",17.56
"1105",513,"FL14.5","ME",2014,9,29,272,11,42.9827,-70.66328,74,35,39,54,20,"ME",4.6794
"1106",512,"FL14.50","ME",2014,10,15,288,19,43.80672,-69.04357,542,280,262,284,258,"ME",15.4166
"1107",513,"FL14.51","ME",2014,10,15,288,20,43.63797,-69.14127,6,4,2,5,1,"ME",17.122
"1108",513,"FL14.52","ME",2014,10,15,288,20,43.57697,-69.03762,4,3,1,4,0,"ME",15.868
"1109",512,"FL14.53","ME",2014,10,15,288,20,43.53742,-68.96237,17,10,7,14,3,"ME",16.33
"1110",512,"FL14.54","ME",2014,10,15,288,18,43.61465,-68.85008,13,5,8,13,0,"ME",12.8916
"1111",512,"FL14.55","ME",2014,10,16,289,17,43.93313,-68.77757,671,357,314,340,331,"ME",11.3373
"1112",512,"FL14.56","ME",2014,10,16,289,20,43.88612,-68.68482,247,127,120,143,104,"ME",16.216
"1113",512,"FL14.57","ME",2014,10,16,289,20,43.83702,-68.54832,25,14,11,23,2,"ME",15.818
"1114",512,"FL14.58","ME",2014,10,16,289,20,43.74257,-68.63588,23,10,13,23,0,"ME",17.232
"1115",512,"FL14.59","ME",2014,10,16,289,20,43.76603,-68.72355,139,62,77,105,34,"ME",16.43
"1116",513,"FL14.6","ME",2014,9,30,273,20,42.97575,-70.40602,1,1,0,1,0,"ME",16.044
"1117",512,"FL14.60","ME",2014,10,17,290,20,43.98737,-68.74915,437,226,211,196,241,"ME",16.306
"1118",512,"FL14.61","ME",2014,10,17,290,20,44.1027,-68.77302,272,131,141,162,110,"ME",15.82
"1119",512,"FL14.62","ME",2014,10,17,290,18,44.16995,-68.79645,27,8,19,22,5,"ME",13.329
"1120",512,"FL14.63","ME",2014,10,20,293,20,43.87818,-68.3911,24,16,8,24,0,"ME",16.978
"1121",512,"FL14.64","ME",2014,10,20,293,15,43.895,-68.29753,7,6,1,7,0,"ME",8.169
"1122",512,"FL14.65","ME",2014,10,20,293,20,43.9503,-68.23943,48,31,17,48,0,"ME",16.816
"1123",512,"FL14.66","ME",2014,10,21,294,20,44.07055,-68.12573,195,112,83,148,47,"ME",15.778
"1124",512,"FL14.67","ME",2014,10,21,294,15,44.0503,-68.25238,271,168,103,210,61,"ME",8.8185
"1125",512,"FL14.68","ME",2014,10,22,295,20,44.35365,-68.53742,30,10,20,21,9,"ME",15.614
"1126",512,"FL14.69","ME",2014,10,21,294,20,44.38875,-68.51905,9,0,9,9,0,"ME",16.078
"1127",513,"FL14.7","ME",2014,9,30,273,20,43.03773,-70.41093,13,6,7,10,3,"ME",16.01
"1128",512,"FL14.70","ME",2014,10,22,295,20,44.3649,-68.46827,1,1,0,1,0,"ME",15.74
"1129",512,"FL14.71","ME",2014,10,24,297,21,44.28197,-68.13098,521,261,260,283,238,"ME",18.3876
"1130",512,"FL14.72","ME",2014,10,24,297,20,44.22703,-68.13382,515,273,242,241,274,"ME",16.334
"1131",512,"FL14.73","ME",2014,10,24,297,15,44.18622,-67.97252,210,110,100,153,57,"ME",9.501
"1132",512,"FL14.74","ME",2014,10,25,298,14,44.43638,-68.21335,50,24,26,37,13,"ME",7.1568
"1133",512,"FL14.75","ME",2014,10,25,298,20,44.40303,-68.2136,12,3,9,8,4,"ME",16.568
"1134",512,"FL14.76","ME",2014,10,25,298,20,44.35895,-68.16695,667,279,388,296,371,"ME",15.628
"1135",511,"FL14.77","ME",2014,10,27,300,20,44.15735,-67.79963,38,21,17,38,0,"ME",16.924
"1136",511,"FL14.78","ME",2014,10,27,300,20,44.1841,-67.8274,9,9,0,9,0,"ME",16.698
"1137",512,"FL14.79","ME",2014,10,27,300,20,44.22897,-67.89993,307,181,126,226,81,"ME",15.936
"1138",513,"FL14.8","ME",2014,9,30,273,20,43.12172,-70.3508,8,1,7,8,0,"ME",17.036
"1139",511,"FL14.80","ME",2014,10,28,301,15,44.39397,-67.6926,355,193,162,167,188,"ME",9.603
"1140",511,"FL14.81","ME",2014,10,28,301,20,44.3306,-67.67132,569,273,296,479,90,"ME",17.196
"1141",511,"FL14.82","ME",2014,10,28,301,20,44.32005,-67.53107,60,37,23,60,0,"ME",17.758
"1142",511,"FL14.83","ME",2014,10,28,301,20,44.2808,-67.63638,88,49,39,83,5,"ME",17.26
"1143",511,"FL14.84","ME",2014,10,28,301,20,44.26243,-67.67807,45,28,17,45,0,"ME",17.166
"1144",511,"FL14.85","ME",2014,10,29,302,20,44.48723,-67.65023,142,70,72,75,67,"ME",16.188
"1145",511,"FL14.86","ME",2014,10,29,302,18,44.50185,-67.70052,51,22,29,28,23,"ME",12.9528
"1146",511,"FL14.87","ME",2014,10,29,302,19,44.4992,-67.77682,48,12,36,30,18,"ME",14.8523
"1147",511,"FL14.88","ME",2014,10,30,303,13,44.51723,-67.52088,116,56,60,42,74,"ME",7.0525
"1148",511,"FL14.89","ME",2014,10,30,303,17,44.48342,-67.50658,425,221,204,136,289,"ME",11.2353
"1149",513,"FL14.9","ME",2014,9,30,273,17,43.09528,-70.47635,2,0,2,2,0,"ME",11.9102
"1150",511,"FL14.90","ME",2014,10,30,303,20,44.4989,-67.42132,208,101,107,121,87,"ME",16.266
"1151",511,"FL14.91","ME",2014,10,30,303,20,44.52385,-67.31242,205,113,92,95,110,"ME",16.416
"1152",511,"FL14.92","ME",2014,10,30,303,13,44.5416,-67.19362,98,54,44,64,34,"ME",7.7103
"1153",511,"FL14.93","ME",2014,10,31,304,20,44.37637,-67.14113,30,23,7,30,0,"ME",16.148
"1154",511,"FL14.94","ME",2014,10,31,304,20,44.38915,-67.09485,24,19,5,24,0,"ME",15.77
"1155",513,"FL15.1","ME",2015,9,28,271,20,42.95777,-70.46697,10,3,7,9,1,"ME",16.176
"1156",513,"FL15.12","ME",2015,9,30,273,12,43.16457,-70.44707,64,38,26,39,25,"ME",5.9928
"1157",513,"FL15.13","ME",2015,10,1,274,19,43.2652,-70.25262,6,3,3,5,1,"ME",14.877
"1158",513,"FL15.14","ME",2015,10,1,274,20,43.26653,-70.18188,1,0,1,1,0,"ME",16.48
"1159",513,"FL15.15","ME",2015,10,1,274,20,43.32493,-70.19433,22,10,12,15,7,"ME",16.584
"1160",513,"FL15.16","ME",2015,10,1,274,20,43.46863,-70.07708,18,6,12,14,4,"ME",17.108
"1161",513,"FL15.17","ME",2015,10,2,275,13,43.51513,-70.2222313,392,198,194,208,184,"ME",6.8133
"1162",513,"FL15.18","ME",2015,10,2,275,20,43.53237,-70.26228,1099,531,568,581,518,"ME",16.09
"1163",513,"FL15.19","ME",2015,10,2,275,18,43.55288,-70.28105,298,126,172,134,164,"ME",12.8772
"1164",513,"FL15.2","ME",2015,9,28,271,20,42.93598,-70.52715,31,15,16,29,2,"ME",16.27
"1165",513,"FL15.20","ME",2015,10,5,278,20,43.6921,-70.214,27,9,18,19,8,"ME",16.454
"1166",513,"FL15.21","ME",2015,10,6,279,15,43.5411,-70.0113,91,49,42,50,41,"ME",9.315
"1167",513,"FL15.22","ME",2015,10,6,279,20,43.45792,-69.91638,2,2,0,0,2,"ME",16.706
"1168",513,"FL15.23","ME",2015,10,6,279,20,43.5012,-69.92627,1,0,1,1,0,"ME",16.666
"1169",513,"FL15.24","ME",2015,10,6,279,16,43.59737,-69.8426,102,53,49,85,17,"ME",10.0528
"1170",513,"FL15.25","ME",2015,10,7,280,14,43.72273,-69.5511,241,121,120,114,127,"ME",7.9002
"1171",513,"FL15.26","ME",2015,10,7,280,20,43.61318,-69.41572,1,1,0,1,0,"ME",17.13
"1172",513,"FL15.29","ME",2015,10,8,281,19,43.7881,-69.6183,547,286,261,116,431,"ME",15.1202
"1173",513,"FL15.3","ME",2015,9,28,271,18,42.90777,-70.6421,160,78,81,107,53,"ME",13.689
"1174",513,"FL15.30","ME",2015,10,8,281,15,43.71432,-69.73897,769,391,378,482,287,"ME",9.126
"1175",513,"FL15.31","ME",2015,10,8,281,20,43.7471,-69.73915,501,228,273,259,242,"ME",15.936
"1176",513,"FL15.32","ME",2015,10,8,281,19,43.69937,-69.68463,322,165,157,187,135,"ME",14.7573
"1177",513,"FL15.33","ME",2015,10,8,281,20,43.73298,-69.69993,427,231,195,174,253,"ME",16.964
"1178",513,"FL15.34","ME",2015,10,9,282,20,43.80708,-69.49535,522,274,248,157,365,"ME",16.762
"1179",513,"FL15.35","ME",2015,10,9,282,20,43.74015,-69.34357,329,176,153,176,153,"ME",15.856
"1180",512,"FL15.36","ME",2015,10,12,285,20,43.7692,-69.21598,518,259,259,229,289,"ME",16.622
"1181",512,"FL15.37","ME",2015,10,12,285,20,43.80813,-69.11517,872,437,435,376,496,"ME",16.534
"1182",512,"FL15.38","ME",2015,10,12,285,20,43.81598,-69.06687,778,397,381,398,380,"ME",16.304
"1183",512,"FL15.39","ME",2015,10,12,285,20,43.8726,-69.07715,1325,656,669,430,895,"ME",16.402
"1184",513,"FL15.4","ME",2015,9,28,271,20,42.93183,-70.74577,554,302,252,301,253,"ME",16.544
"1185",512,"FL15.40","ME",2015,10,12,285,20,43.93213,-69.128,968,456,512,407,561,"ME",16.96
"1186",512,"FL15.41","ME",2015,10,13,286,20,44.1768,-68.93932,439,195,244,290,149,"ME",17.178
"1187",512,"FL15.42","ME",2015,10,13,286,20,44.26823,-68.85942,46,19,27,41,5,"ME",16.62
"1188",512,"FL15.43","ME",2015,10,13,286,15,44.31595,-68.92048,172,62,110,128,44,"ME",9.3075
"1189",512,"FL15.44","ME",2015,10,13,286,15,44.2263,-69.03887,563,220,343,418,145,"ME",8.5725
"1190",512,"FL15.45","ME",2015,10,13,286,18,44.12993,-69.05502,446,208,238,177,269,"ME",13.077
"1191",513,"FL15.46","ME",2015,10,14,287,20,43.58218,-69.0424,5,3,2,3,2,"ME",16.666
"1192",513,"FL15.47","ME",2015,10,14,287,20,43.5497,-69.07025,1,0,1,0,1,"ME",16.846
"1193",513,"FL15.48","ME",2015,10,14,287,20,43.60442,-69.06742,4,3,1,4,0,"ME",16.242
"1194",512,"FL15.49","ME",2015,10,15,288,20,43.93615,-68.77343,917,460,457,512,405,"ME",15.704
"1195",513,"FL15.5","ME",2015,9,28,271,18,42.9867,-70.67583,355,162,193,146,209,"ME",12.789
"1196",512,"FL15.50","ME",2015,10,15,288,15,43.76653,-68.7835,286,145,141,226,60,"ME",8.994
"1197",512,"FL15.51","ME",2015,10,15,288,20,43.91283,-68.75557,559,278,281,283,276,"ME",16.958
"1198",512,"FL15.52","ME",2015,10,16,289,15,43.98758,-68.75225,832,437,395,313,519,"ME",9.663
"1199",512,"FL15.53","ME",2015,10,16,289,13,44.16527,-68.76067,456,207,247,256,200,"ME",7.3931
"1200",512,"FL15.54","ME",2015,10,16,289,20,44.15997,-68.79008,87,29,58,56,31,"ME",16.496
"1201",512,"FL15.55","ME",2015,10,19,292,20,43.86558,-68.49002,52,32,20,50,2,"ME",16.374
"1202",512,"FL15.56","ME",2015,10,19,292,20,43.85985,-68.41665,24,16,8,24,0,"ME",15.89
"1203",512,"FL15.57","ME",2015,10,19,292,20,43.90125,-68.41797,79,52,27,79,0,"ME",16.508
"1204",512,"FL15.58","ME",2015,10,20,293,20,44.37607,-68.53143,9,4,5,6,3,"ME",16.584
"1205",512,"FL15.59","ME",2015,10,20,293,20,44.3571,-68.45653,25,3,22,24,1,"ME",16.714
"1206",513,"FL15.6","ME",2015,9,29,272,18,43.025,-70.57028,154,69,85,83,71,"ME",13.1238
"1207",512,"FL15.60","ME",2015,10,20,293,20,44.38297,-68.41975,5,3,2,4,1,"ME",16.21
"1208",512,"FL15.61","ME",2015,10,21,294,20,44.01885,-68.03863,37,22,15,37,0,"ME",17.148
"1209",512,"FL15.62","ME",2015,10,21,294,20,44.06005,-68.12505,261,152,109,194,67,"ME",16.976
"1210",512,"FL15.63","ME",2015,10,22,295,20,44.17703,-68.04043,436,225,211,226,210,"ME",16.676
"1211",512,"FL15.64","ME",2015,10,22,295,20,44.17253,-68.00598,485,266,219,334,151,"ME",15.906
"1212",512,"FL15.65","ME",2015,10,22,295,11,44.18487,-67.91895,144,67,77,98,46,"ME",4.2207
"1213",512,"FL15.66","ME",2015,10,23,296,20,44.27085,-68.13278,741,375,366,422,319,"ME",15.268
"1214",512,"FL15.67","ME",2015,10,23,296,20,44.30212,-68.0702,670,332,338,348,322,"ME",16.562
"1215",512,"FL15.68","ME",2015,10,23,296,20,44.26948,-68.0238,730,384,346,330,400,"ME",16.754
"1216",512,"FL15.69","ME",2015,10,23,296,20,44.33487,-68.11618,760,369,391,329,431,"ME",16.376
"1217",513,"FL15.7","ME",2015,9,29,272,16,43.08215,-70.45065,82,36,46,69,13,"ME",10.2096
"1218",512,"FL15.70","ME",2015,10,26,299,20,44.22,-67.91622,437,237,199,280,157,"ME",17.216
"1219",511,"FL15.71","ME",2015,10,26,299,16,44.46923,-67.79635,460,208,252,217,243,"ME",10.816
"1220",511,"FL15.72","ME",2015,10,26,299,15,44.50125,-67.70075,45,16,29,23,22,"ME",9.357
"1221",511,"FL15.73","ME",2015,10,27,300,13,44.33673,-67.70512,445,239,206,377,68,"ME",6.929
"1222",511,"FL15.74","ME",2015,10,27,300,20,44.25113,-67.69343,55,31,24,54,1,"ME",14.746
"1223",511,"FL15.75","ME",2015,10,27,300,21,44.20088,-67.74083,36,24,12,36,0,"ME",18.333
"1224",511,"FL15.76","ME",2015,10,27,300,20,44.22733,-67.75467,63,38,25,62,1,"ME",14.434
"1225",511,"FL15.77","ME",2015,10,28,301,17,44.37913,-67.56573,350,194,156,208,142,"ME",12.0887
"1226",511,"FL15.78","ME",2015,10,28,301,15,44.32805,-67.56002,144,81,63,119,25,"ME",8.7045
"1227",511,"FL15.79","ME",2015,10,28,301,15,44.33345,-67.62823,338,159,179,268,70,"ME",8.9175
"1228",513,"FL15.8","ME",2015,9,29,272,20,43.06782,-70.42472,119,47,72,104,15,"ME",16.444
"1229",511,"FL15.80","ME",2015,10,28,301,11,44.41215,-67.58145,259,135,124,112,147,"ME",4.7454
"1230",513,"FL15.9","ME",2015,9,29,272,20,43.08562,-70.35065,16,2,13,14,2,"ME",16.832
"1231",513,"FL16.1","ME",2016,9,26,270,20,42.94133,-70.45422,6,2,4,6,0,"ME",NA
"1232",513,"FL16.10","ME",2016,9,27,271,20,43.11835,-70.24262,1,1,0,0,1,"ME",NA
"1233",513,"FL16.11","ME",2016,9,27,271,20,43.04023,-70.3628,1,0,1,1,0,"ME",NA
"1234",513,"FL16.12","ME",2016,9,28,272,15,43.18115,-70.38855,131,59,72,95,36,"ME",NA
"1235",513,"FL16.15","ME",2016,9,29,273,12,43.4614,-70.08118,10,3,7,4,6,"ME",NA
"1236",513,"FL16.16","ME",2016,9,30,274,20,43.4813,-70.19845,325,172,153,212,113,"ME",NA
"1237",513,"FL16.17","ME",2016,9,30,274,20,43.43952,-70.1944,122,60,62,95,27,"ME",NA
"1238",513,"FL16.18","ME",2016,9,30,274,18,43.41768,-70.236,146,63,83,116,30,"ME",NA
"1239",513,"FL16.19","ME",2016,9,30,274,20,43.46838,-70.27188,383,223,160,188,195,"ME",NA
"1240",513,"FL16.2","ME",2016,9,26,270,20,42.94457,-70.66145,253,146,107,123,130,"ME",NA
"1241",513,"FL16.20","ME",2016,9,30,274,20,43.52737,-70.27683,624,305,319,280,344,"ME",NA
"1242",513,"FL16.21","ME",2016,10,3,277,17,43.5552,-69.9977,117,62,55,63,54,"ME",NA
"1243",513,"FL16.22","ME",2016,10,3,277,20,43.50925,-70.0129,25,12,13,24,1,"ME",NA
"1244",513,"FL16.23","ME",2016,10,3,277,20,43.48437,-69.7536,1,1,0,1,0,"ME",NA
"1245",513,"FL16.25","ME",2016,10,3,277,20,43.4934,-69.93542,1,1,0,1,0,"ME",NA
"1246",513,"FL16.26","ME",2016,10,4,278,18,43.77607,-70.064,218,99,119,142,76,"ME",NA
"1247",513,"FL16.27","ME",2016,10,4,278,17,43.68872,-69.85838,178,79,99,113,65,"ME",NA
"1248",513,"FL16.28","ME",2016,10,4,278,20,43.7644,-69.69967,348,160,188,101,247,"ME",NA
"1249",513,"FL16.29","ME",2016,10,5,279,20,43.8038,-69.64665,389,206,182,101,288,"ME",NA
"1250",513,"FL16.3","ME",2016,9,26,270,19,42.93753,-70.74307,265,141,124,124,141,"ME",NA
"1251",513,"FL16.30","ME",2016,10,5,279,16,43.74388,-69.7403,375,164,211,221,154,"ME",NA
"1252",513,"FL16.31","ME",2016,10,5,279,20,43.7179,-69.69392,269,143,126,145,124,"ME",NA
"1253",513,"FL16.32","ME",2016,10,5,279,15,43.62907,-69.7137,115,59,56,93,22,"ME",NA
"1254",513,"FL16.33","ME",2016,10,5,279,20,43.6941,-69.6545,239,134,105,126,113,"ME",NA
"1255",513,"FL16.34","ME",2016,10,6,280,15,43.63683,-69.54557,13,10,3,12,1,"ME",NA
"1256",513,"FL16.35","ME",2016,10,6,280,20,43.65675,-69.4558,6,4,2,4,2,"ME",NA
"1257",513,"FL16.36","ME",2016,10,6,280,20,43.7194,-69.45382,76,29,47,60,16,"ME",NA
"1258",513,"FL16.37","ME",2016,10,6,280,20,43.73932,-69.49973,41,21,20,20,21,"ME",NA
"1259",513,"FL16.38","ME",2016,10,7,281,12,43.80968,-69.43665,229,116,113,90,139,"ME",NA
"1260",512,"FL16.39","ME",2016,10,11,285,18,43.77425,-69.2214,461,242,218,197,264,"ME",NA
"1261",513,"FL16.4","ME",2016,9,26,270,20,42.97477,-70.66297,321,163,158,178,143,"ME",NA
"1262",512,"FL16.40","ME",2016,10,11,285,20,43.75498,-69.07012,519,263,256,324,195,"ME",NA
"1263",512,"FL16.41","ME",2016,10,11,285,20,43.85013,-69.10908,633,323,310,148,485,"ME",NA
"1264",512,"FL16.42","ME",2016,10,11,285,10,43.8891,-69.22453,777,388,387,309,468,"ME",NA
"1265",512,"FL16.43","ME",2016,10,12,286,20,44.11522,-68.97543,778,348,430,451,327,"ME",NA
"1266",512,"FL16.44","ME",2016,10,12,286,20,44.25302,-68.80655,49,12,37,46,3,"ME",NA
"1267",512,"FL16.45","ME",2016,10,12,286,20,44.29697,-68.80015,14,3,11,14,0,"ME",NA
"1268",512,"FL16.46","ME",2016,10,12,286,16,44.15123,-69.07248,267,106,161,90,177,"ME",NA
"1269",512,"FL16.47","ME",2016,10,12,286,20,44.14298,-69.00793,298,130,168,156,142,"ME",NA
"1270",513,"FL16.48","ME",2016,10,13,287,20,43.60998,-69.04263,49,29,20,46,3,"ME",NA
"1271",513,"FL16.49","ME",2016,10,13,287,20,43.5628,-69.05653,8,7,1,8,0,"ME",NA
"1272",513,"FL16.5","ME",2016,9,26,270,17,42.988,-70.67762,469,242,227,145,324,"ME",NA
"1273",512,"FL16.50","ME",2016,10,13,287,20,43.65043,-68.90577,69,43,26,64,5,"ME",NA
"1274",512,"FL16.51","ME",2016,10,14,288,20,43.77478,-68.78615,309,161,148,217,92,"ME",NA
"1275",512,"FL16.52","ME",2016,10,14,288,18,43.7903,-68.7054,219,101,118,167,52,"ME",NA
"1276",512,"FL16.53","ME",2016,10,14,288,16,43.88777,-68.68267,325,153,172,156,169,"ME",NA
"1277",512,"FL16.54","ME",2016,10,14,288,17,43.9157,-68.65555,466,251,215,285,181,"ME",NA
"1278",512,"FL16.55","ME",2016,10,15,289,17,43.97563,-68.77745,1041,548,493,428,613,"ME",NA
"1279",512,"FL16.56","ME",2016,10,15,289,17,44.15352,-68.78753,101,33,68,86,15,"ME",NA
"1280",512,"FL16.57","ME",2016,10,17,291,20,43.83193,-68.47865,36,22,14,36,0,"ME",NA
"1281",512,"FL16.58","ME",2016,10,17,291,16,43.91598,-68.41692,81,45,36,78,3,"ME",NA
"1282",512,"FL16.59","ME",2016,10,17,291,20,43.99105,-68.44115,495,272,223,347,148,"ME",NA
"1283",513,"FL16.6","ME",2016,9,27,271,20,42.99363,-70.49253,70,28,42,64,6,"ME",NA
"1284",512,"FL16.60","ME",2016,10,18,292,20,44.27902,-68.51802,209,68,141,169,40,"ME",NA
"1285",512,"FL16.61","ME",2016,10,18,292,20,44.36097,-68.48455,10,4,6,8,2,"ME",NA
"1286",512,"FL16.62","ME",2016,10,18,292,16,44.2777,-68.47455,300,114,186,179,121,"ME",NA
"1287",512,"FL16.63","ME",2016,10,19,293,16,44.04577,-68.26232,337,182,155,247,90,"ME",NA
"1288",512,"FL16.64","ME",2016,10,19,293,15,43.97273,-68.33445,172,94,78,136,36,"ME",NA
"1289",512,"FL16.65","ME",2016,10,19,293,20,43.93465,-68.32198,221,124,97,210,11,"ME",NA
"1290",512,"FL16.66","ME",2016,10,19,293,16,43.9437,-68.24888,178,108,70,174,4,"ME",NA
"1291",512,"FL16.67","ME",2016,10,20,294,20,44.14007,-68.11903,541,303,237,223,318,"ME",NA
"1292",512,"FL16.68","ME",2016,10,20,294,13,44.10422,-68.08223,172,107,65,122,50,"ME",NA
"1293",512,"FL16.69","ME",2016,10,20,294,16,44.16895,-68.05303,367,219,146,246,121,"ME",NA
"1294",513,"FL16.7","ME",2016,9,27,271,15,43.07503,-70.49347,171,83,88,107,64,"ME",NA
"1295",512,"FL16.70","ME",2016,10,20,294,20,44.22535,-68.1329,650,356,294,219,431,"ME",NA
"1296",512,"FL16.71","ME",2016,10,21,295,20,44.28428,-68.13077,728,346,381,274,454,"ME",NA
"1297",511,"FL16.72","ME",2016,10,25,299,20,44.17205,-67.74853,28,22,6,28,0,"ME",NA
"1298",511,"FL16.73","ME",2016,10,25,299,20,44.35912,-67.69673,616,317,298,372,244,"ME",NA
"1299",511,"FL16.74","ME",2016,10,26,300,17,44.33612,-67.61357,488,247,241,370,118,"ME",NA
"1300",511,"FL16.75","ME",2016,10,26,300,18,44.31098,-67.67442,377,189,188,334,43,"ME",NA
"1301",511,"FL16.76","ME",2016,10,26,300,20,44.3501,-67.73643,447,199,248,270,177,"ME",NA
"1302",511,"FL16.77","ME",2016,10,26,300,20,44.4633,-67.85448,331,139,192,131,200,"ME",NA
"1303",511,"FL16.78","ME",2016,10,27,301,16,44.28212,-67.49587,58,40,18,58,0,"ME",NA
"1304",511,"FL16.79","ME",2016,10,27,301,20,44.25185,-67.46737,19,15,4,19,0,"ME",NA
"1305",513,"FL16.8","ME",2016,9,27,271,18,43.12037,-70.3893,65,32,33,54,11,"ME",NA
"1306",511,"FL16.80","ME",2016,10,27,301,20,44.38842,-67.5415,393,195,198,230,163,"ME",NA
"1307",511,"FL16.81","ME",2016,10,29,303,15,44.51877,-67.52235,1083,553,530,288,795,"ME",NA
"1308",511,"FL16.82","ME",2016,10,29,303,20,44.51593,-67.42675,194,110,84,96,98,"ME",NA
"1309",511,"FL16.83","ME",2016,10,29,303,19,44.593,-67.44898,222,109,113,165,57,"ME",NA
"1310",513,"FL16.9","ME",2016,9,27,271,20,43.118,-70.3014,1,1,0,0,1,"ME",NA
"1311",513,"SP01.10","ME",2001,4,25,115,17,43.2783,-70.3802,26,10,16,23,3,"ME",10.54
"1312",511,"SP01.100","ME",2001,5,23,143,20,44.4822,-67.3225,17,12,5,11,6,"ME",20.6
"1313",511,"SP01.101","ME",2001,5,23,143,20,44.5894,-67.282,85,50,35,33,52,"ME",17.2
"1314",511,"SP01.102","ME",2001,5,23,143,20,44.6051,-67.3563,38,18,20,31,7,"ME",16.2
"1315",511,"SP01.103","ME",2001,5,23,143,18,44.5423,-67.5018,63,42,21,38,25,"ME",13.5
"1316",511,"SP01.104","ME",2001,5,24,144,20,44.4251,-67.1332,2,1,1,2,0,"ME",15.4
"1317",511,"SP01.106","ME",2001,5,24,144,11,44.6993,-67.0459,8,5,3,6,2,"ME",7.7
"1318",511,"SP01.107","ME",2001,5,24,144,20,44.6618,-67.0857,27,12,15,21,6,"ME",19.2
"1319",467,"SP01.108","ME",2001,5,25,145,20,44.7117,-66.9519,2,2,0,2,0,"ME",18.2
"1320",513,"SP01.11","ME",2001,4,25,115,20,43.2494,-70.3459,40,16,24,38,2,"ME",13.4
"1321",511,"SP01.110","ME",2001,5,25,145,20,44.7137,-67.0976,43,22,21,35,8,"ME",21.2
"1322",511,"SP01.111","ME",2001,5,25,145,20,44.684,-67.1283,34,20,14,28,6,"ME",20.2
"1323",513,"SP01.12","ME",2001,4,26,116,21,43.2607,-70.5398,15,9,6,9,6,"ME",18.27
"1324",513,"SP01.13","ME",2001,4,26,116,20,43.2949,-70.4953,17,3,14,13,4,"ME",14.4
"1325",513,"SP01.14","ME",2001,4,26,116,20,43.4343,-70.3116,3,1,2,3,0,"ME",14.4
"1326",513,"SP01.15","ME",2001,4,26,116,17,43.456,-70.257,17,17,0,13,4,"ME",11.73
"1327",513,"SP01.16","ME",2001,4,27,117,20,43.3997,-70.1286,6,2,4,6,0,"ME",14.4
"1328",513,"SP01.17","ME",2001,4,27,117,20,43.3874,-70.2391,38,23,15,33,5,"ME",13.2
"1329",513,"SP01.18","ME",2001,4,27,117,20,43.4224,-70.2908,74,39,35,51,23,"ME",15.6
"1330",513,"SP01.19","ME",2001,4,27,117,20,43.4634,-70.2536,78,42,36,44,34,"ME",14.6
"1331",513,"SP01.2","ME",2001,4,23,113,20,42.8902,-70.6854,20,12,8,16,4,"ME",14.8
"1332",513,"SP01.20","ME",2001,4,27,117,20,43.5317,-70.2783,1,1,0,0,1,"ME",15
"1333",513,"SP01.21","ME",2001,4,27,117,20,43.5033,-70.2047,123,53,70,77,46,"ME",15.2
"1334",513,"SP01.22","ME",2001,4,30,120,20,43.5279,-70.0179,11,3,8,11,0,"ME",15.4
"1335",513,"SP01.23","ME",2001,4,30,120,20,43.6585,-70.0847,42,25,17,19,23,"ME",16.8
"1336",513,"SP01.24","ME",2001,4,30,120,20,43.7266,-70.1596,6,2,4,4,2,"ME",18.8
"1337",513,"SP01.25","ME",2001,5,1,121,20,43.6669,-69.9737,326,169,157,148,178,"ME",15.6
"1338",513,"SP01.26","ME",2001,5,1,121,17,43.6901,-69.8886,13,5,8,12,1,"ME",11.9
"1339",513,"SP01.27","ME",2001,5,1,121,20,43.6668,-69.9112,208,118,90,106,102,"ME",18.2
"1340",513,"SP01.28","ME",2001,5,1,121,20,43.6025,-69.8713,20,7,13,12,8,"ME",15.2
"1341",513,"SP01.29","ME",2001,5,1,121,20,43.5808,-69.8088,1,1,0,1,0,"ME",15.8
"1342",513,"SP01.3","ME",2001,4,23,113,20,42.932,-70.7506,1,0,1,1,0,"ME",15.6
"1343",513,"SP01.30","ME",2001,5,1,121,20,43.6351,-69.7553,4,3,1,4,0,"ME",19.2
"1344",513,"SP01.31","ME",2001,5,2,122,20,43.6992,-69.7452,49,22,27,43,6,"ME",19
"1345",513,"SP01.32","ME",2001,5,2,122,20,43.6495,-69.8041,11,5,6,11,0,"ME",17.6
"1346",513,"SP01.34","ME",2001,5,2,122,20,43.7545,-69.6477,64,30,34,35,29,"ME",16.8
"1347",513,"SP01.35","ME",2001,5,2,122,21,43.8061,-69.6433,2,2,0,0,2,"ME",17.64
"1348",513,"SP01.36","ME",2001,5,3,123,20,43.9143,-69.447,65,37,28,26,39,"ME",18.2
"1349",513,"SP01.37","ME",2001,5,3,123,20,43.8217,-69.488,41,20,21,20,21,"ME",16.4
"1350",513,"SP01.38","ME",2001,5,3,123,18,43.8176,-69.451,32,17,15,26,6,"ME",13.5
"1351",513,"SP01.39","ME",2001,5,3,123,21,43.7488,-69.4735,3,3,0,1,2,"ME",18.27
"1352",513,"SP01.4","ME",2001,4,23,113,20,42.9899,-70.6442,2,1,1,1,1,"ME",16
"1353",513,"SP01.40","ME",2001,5,3,123,20,43.8579,-69.5279,28,13,15,18,10,"ME",17.2
"1354",513,"SP01.41","ME",2001,5,4,124,20,43.9053,-69.3391,36,23,13,23,13,"ME",16
"1355",513,"SP01.42","ME",2001,5,4,124,20,43.7644,-69.3909,12,6,6,9,3,"ME",17.4
"1356",513,"SP01.43","ME",2001,5,4,124,17,43.6774,-69.3777,1,1,0,1,0,"ME",11.05
"1357",513,"SP01.44","ME",2001,5,4,124,20,43.8005,-69.5445,98,52,46,34,64,"ME",16
"1358",512,"SP01.45","ME",2001,5,7,127,15,43.8856,-69.183,37,19,18,32,5,"ME",9.75
"1359",512,"SP01.46","ME",2001,5,7,127,20,43.9214,-69.1311,373,167,206,288,85,"ME",15.6
"1360",512,"SP01.47","ME",2001,5,7,127,14,43.8619,-69.0843,84,52,32,67,17,"ME",7.28
"1361",512,"SP01.48","ME",2001,5,7,127,14,43.8619,-69.0339,120,56,64,76,44,"ME",7.42
"1362",512,"SP01.49","ME",2001,5,8,128,20,44.1309,-68.967,12,7,5,10,2,"ME",16.4
"1363",513,"SP01.5","ME",2001,4,24,114,20,42.9601,-70.4636,3,2,1,3,0,"ME",15.6
"1364",512,"SP01.51","ME",2001,5,8,128,21,44.2895,-68.8848,1,1,0,1,0,"ME",18.69
"1365",512,"SP01.53","ME",2001,5,8,128,19,44.2329,-68.9854,3,0,3,3,0,"ME",15.77
"1366",512,"SP01.54","ME",2001,5,8,128,20,44.1854,-68.991,2,1,1,2,0,"ME",17.2
"1367",513,"SP01.55","ME",2001,5,9,129,16,43.5817,-69.0914,1,0,1,1,0,"ME",10.4
"1368",512,"SP01.56","ME",2001,5,9,129,20,43.6156,-68.937,1,1,0,1,0,"ME",17.4
"1369",512,"SP01.57","ME",2001,5,10,130,19,43.9325,-68.865,14,6,8,13,1,"ME",15.77
"1370",512,"SP01.58","ME",2001,5,10,130,16,43.9789,-68.71,12,6,6,12,0,"ME",10.4
"1371",512,"SP01.59","ME",2001,5,10,130,20,44.1116,-68.7837,85,45,40,70,15,"ME",15.6
"1372",513,"SP01.6","ME",2001,4,24,114,21,42.9595,-70.5217,20,6,14,18,2,"ME",15.96
"1373",512,"SP01.60","ME",2001,5,10,130,20,44.2554,-68.7942,1,0,1,1,0,"ME",15.4
"1374",512,"SP01.61","ME",2001,5,10,130,20,44.13,-68.7464,297,150,147,236,61,"ME",17.4
"1375",512,"SP01.62","ME",2001,5,11,131,20,43.7727,-68.7237,5,4,1,5,0,"ME",17.8
"1376",512,"SP01.63","ME",2001,5,11,131,20,43.8965,-68.6694,3,2,1,3,0,"ME",16.4
"1377",512,"SP01.64","ME",2001,5,14,134,21,43.9133,-68.7531,13,9,4,11,2,"ME",18.48
"1378",512,"SP01.65","ME",2001,5,14,134,17,43.9104,-68.6221,4,1,3,4,0,"ME",14.11
"1379",512,"SP01.66","ME",2001,5,14,134,16,43.9186,-68.6456,6,5,1,6,0,"ME",13.6
"1380",512,"SP01.67","ME",2001,5,14,134,20,44.001,-68.4697,5,3,2,5,0,"ME",15.8
"1381",512,"SP01.68","ME",2001,5,14,134,16,44.1307,-68.4829,151,63,88,127,24,"ME",9.6
"1382",512,"SP01.69","ME",2001,5,15,135,16,44.1675,-68.5296,198,78,120,159,39,"ME",9.76
"1383",513,"SP01.7","ME",2001,4,25,115,19,43.1839,-70.4241,22,10,12,17,5,"ME",11.97
"1384",512,"SP01.70","ME",2001,5,15,135,20,44.0224,-68.394,4,1,3,4,0,"ME",16
"1385",512,"SP01.71","ME",2001,5,15,135,20,43.9917,-68.4197,1,1,0,1,0,"ME",16.6
"1386",512,"SP01.72","ME",2001,5,15,135,20,44.0078,-68.5558,12,4,8,10,2,"ME",15
"1387",512,"SP01.73","ME",2001,5,15,135,16,43.9549,-68.4123,5,2,3,5,0,"ME",9.6
"1388",512,"SP01.74","ME",2001,5,16,136,20,44.2136,-68.4234,92,39,53,76,16,"ME",15.8
"1389",512,"SP01.75","ME",2001,5,16,136,20,44.143,-68.2632,61,30,31,45,16,"ME",15
"1390",512,"SP01.76","ME",2001,5,16,136,20,44.0419,-68.2636,3,0,3,2,1,"ME",15.2
"1391",512,"SP01.77","ME",2001,5,16,136,20,43.9838,-68.3137,3,2,1,3,0,"ME",15.6
"1392",512,"SP01.78","ME",2001,5,17,137,20,44.4465,-68.305,1,1,0,1,0,"ME",14.8
"1393",512,"SP01.79","ME",2001,5,17,137,20,44.4389,-68.2379,6,4,2,6,0,"ME",15.2
"1394",513,"SP01.8","ME",2001,4,25,115,23,43.1454,-70.3905,34,17,16,31,3,"ME",19.55
"1395",512,"SP01.80","ME",2001,5,17,137,20,44.4078,-68.2302,6,2,4,5,1,"ME",15.8
"1396",512,"SP01.81","ME",2001,5,17,137,19,44.3938,-68.1133,165,85,80,113,52,"ME",15.2
"1397",512,"SP01.82","ME",2001,5,17,137,20,44.2884,-68.1328,29,11,18,25,4,"ME",16.2
"1398",512,"SP01.83","ME",2001,5,17,137,19,44.2133,-68.0673,6,2,4,3,3,"ME",14.25
"1399",512,"SP01.84","ME",2001,5,17,137,21,44.2328,-68.1314,56,25,31,44,12,"ME",18.27
"1400",512,"SP01.86","ME",2001,5,18,138,20,44.1598,-67.9554,4,2,2,3,1,"ME",16.6
"1401",512,"SP01.87","ME",2001,5,18,138,20,44.2477,-67.9992,9,5,4,7,2,"ME",16
"1402",512,"SP01.88","ME",2001,5,18,138,20,44.291,-68.0019,61,26,35,51,10,"ME",15.8
"1403",511,"SP01.89","ME",2001,5,21,141,20,44.3185,-67.8508,74,47,27,63,11,"ME",15.6
"1404",513,"SP01.9","ME",2001,4,25,115,18,43.1896,-70.384,16,7,9,15,1,"ME",11.88
"1405",511,"SP01.90","ME",2001,5,21,141,20,44.3085,-67.872,83,31,52,66,17,"ME",16.8
"1406",511,"SP01.91","ME",2001,5,21,141,20,44.3832,-67.9156,289,148,141,247,42,"ME",16.8
"1407",511,"SP01.92","ME",2001,5,21,141,17,44.4583,-67.7886,146,63,83,112,34,"ME",15.47
"1408",511,"SP01.93","ME",2001,5,22,142,20,44.4517,-67.7265,208,107,101,159,49,"ME",20.2
"1409",511,"SP01.95","ME",2001,5,22,142,20,44.3015,-67.6631,1,1,0,1,0,"ME",16.8
"1410",511,"SP01.98","ME",2001,5,23,143,20,44.4141,-67.5695,60,32,28,45,15,"ME",16.8
"1411",511,"SP01.99","ME",2001,5,23,143,20,44.4259,-67.4499,3,2,1,3,0,"ME",17.4
"1412",513,"SP02.1","ME",2002,5,6,126,20,42.865,-70.7443,14,5,9,13,1,"ME",15.4
"1413",513,"SP02.10","ME",2002,5,8,128,20,43.1678,-70.3204,5,2,3,5,0,"ME",15
"1414",513,"SP02.11","ME",2002,5,8,128,20,43.2943,-70.4965,44,26,18,34,10,"ME",13.8
"1415",513,"SP02.12","ME",2002,5,8,128,20,43.2111,-70.554,3,3,0,2,1,"ME",12.8
"1416",513,"SP02.13","ME",2002,5,9,129,20,43.3955,-70.1981,4,2,2,4,0,"ME",16.6
"1417",513,"SP02.14","ME",2002,5,9,129,20,43.4015,-70.1348,8,6,2,8,0,"ME",15.4
"1418",513,"SP02.15","ME",2002,5,9,129,20,43.4227,-70.2907,207,91,116,127,80,"ME",16.4
"1419",513,"SP02.16","ME",2002,5,9,129,19,43.4998,-70.3337,23,6,17,18,5,"ME",11.78
"1420",513,"SP02.17","ME",2002,5,10,130,20,43.5035,-70.2073,177,86,91,99,78,"ME",15.4
"1421",513,"SP02.18","ME",2002,5,10,130,20,43.4841,-70.2079,68,39,29,35,33,"ME",11.6
"1422",513,"SP02.19","ME",2002,5,10,130,20,43.4723,-70.3229,81,33,48,59,22,"ME",13.2
"1423",513,"SP02.2","ME",2002,5,6,126,23,42.8828,-70.6586,2,0,2,2,0,"ME",19.78
"1424",513,"SP02.20","ME",2002,5,13,133,20,43.5218,-70.0253,1,1,0,0,1,"ME",14.2
"1425",513,"SP02.21","ME",2002,5,13,133,13,43.655,-70.0561,337,156,181,188,149,"ME",6.5
"1426",513,"SP02.22","ME",2002,5,13,133,20,43.6514,-70.0929,61,32,29,28,33,"ME",12.6
"1427",513,"SP02.23","ME",2002,5,15,135,21,43.775,-70.0681,158,70,88,86,72,"ME",15.54
"1428",513,"SP02.24","ME",2002,5,15,135,20,43.6582,-69.9749,254,129,125,61,193,"ME",15
"1429",513,"SP02.25","ME",2002,5,15,135,20,43.5806,-69.9552,13,4,9,9,4,"ME",14.6
"1430",513,"SP02.26","ME",2002,5,15,135,20,43.6029,-69.8716,19,9,10,9,10,"ME",15
"1431",513,"SP02.27","ME",2002,5,15,135,20,43.6592,-69.7917,41,21,20,38,3,"ME",14.4
"1432",513,"SP02.28","ME",2002,5,15,135,20,43.7084,-69.7422,252,117,133,226,26,"ME",14.4
"1433",513,"SP02.29","ME",2002,5,16,136,20,43.6274,-69.757,14,7,7,5,9,"ME",13.8
"1434",513,"SP02.3","ME",2002,5,6,126,20,42.9117,-70.6452,9,2,7,9,0,"ME",16.2
"1435",513,"SP02.30","ME",2002,5,16,136,20,43.6885,-69.6821,82,40,42,61,21,"ME",13.6
"1436",513,"SP02.31","ME",2002,5,16,136,16,43.7061,-69.9497,430,195,235,186,244,"ME",8.16
"1437",513,"SP02.32","ME",2002,5,16,136,20,43.7214,-69.9113,490,266,224,381,109,"ME",15.4
"1438",513,"SP02.33","ME",2002,5,16,136,20,43.8002,-69.6948,462,215,247,142,320,"ME",14
"1439",513,"SP02.34","ME",2002,5,17,137,20,43.7548,-69.6494,289,137,152,147,142,"ME",15.6
"1440",513,"SP02.35","ME",2002,5,17,137,20,43.7499,-69.7386,11,4,7,9,2,"ME",14.4
"1441",513,"SP02.36","ME",2002,5,17,137,20,43.7358,-69.3396,25,10,15,17,8,"ME",15
"1442",513,"SP02.37","ME",2002,5,17,137,20,43.845,-69.4056,186,113,73,130,56,"ME",14.4
"1443",513,"SP02.38","ME",2002,5,17,137,20,43.8368,-69.4845,166,92,74,55,111,"ME",14.8
"1444",512,"SP02.39","ME",2002,5,21,141,20,43.8605,-69.2717,859,400,459,342,517,"ME",14.6
"1445",513,"SP02.4","ME",2002,5,6,126,21,42.9292,-70.7543,22,10,12,22,0,"ME",17.01
"1446",512,"SP02.40","ME",2002,5,21,141,16,43.77133,-69.1104,7,2,5,6,1,"ME",9.28
"1447",512,"SP02.41","ME",2002,5,21,141,18,43.9231,-69.12547,501,226,275,306,195,"ME",10.62
"1448",512,"SP02.42","ME",2002,5,21,141,15,43.9346,-69.12515,393,162,231,211,182,"ME",6.6
"1449",512,"SP02.43","ME",2002,5,22,142,20,44.14593,-69.0327,19,6,13,16,3,"ME",14.8
"1450",512,"SP02.45","ME",2002,5,22,142,20,44.28902,-68.88475,2,1,1,2,0,"ME",15.4
"1451",512,"SP02.47","ME",2002,5,22,142,20,44.33012,-68.83423,2,0,2,2,0,"ME",15.8
"1452",512,"SP02.48","ME",2002,5,22,142,16,44.22883,-68.9862,2,1,1,2,0,"ME",10.56
"1453",512,"SP02.49","ME",2002,5,23,143,20,43.86437,-69.0833,125,69,56,91,34,"ME",15
"1454",513,"SP02.5","ME",2002,5,7,127,20,42.9909,-70.6433,39,20,19,34,5,"ME",15.2
"1455",512,"SP02.50","ME",2002,5,23,143,20,43.8363,-69.11195,196,99,97,91,105,"ME",9.4
"1456",512,"SP02.51","ME",2002,5,23,143,20,43.8887,-68.7906,63,28,35,54,9,"ME",14.6
"1457",512,"SP02.52","ME",2002,5,24,144,18,43.90803,-68.62493,10,7,3,10,0,"ME",9.36
"1458",512,"SP02.53","ME",2002,5,25,145,20,43.90277,-68.75245,14,9,5,13,1,"ME",16.4
"1459",512,"SP02.54","ME",2002,5,25,145,19,43.91812,-68.77043,7,2,5,7,0,"ME",14.25
"1460",512,"SP02.55","ME",2002,5,25,145,15,43.9794,-68.71423,10,4,6,10,0,"ME",6.75
"1461",512,"SP02.56","ME",2002,5,25,145,20,44.1436,-68.75593,11,5,6,7,4,"ME",14.8
"1462",512,"SP02.57","ME",2002,5,25,145,18,44.18628,-68.73725,26,7,19,24,2,"ME",10.08
"1463",512,"SP02.58","ME",2002,5,27,147,20,44.01553,-68.54345,34,18,16,26,8,"ME",15
"1464",512,"SP02.59","ME",2002,5,27,147,14,44.12443,-68.4795,143,64,79,134,9,"ME",7
"1465",513,"SP02.6","ME",2002,5,7,127,20,42.9724,-70.5153,4,3,1,4,0,"ME",14.6
"1466",512,"SP02.60","ME",2002,5,27,147,15,44.15798,-68.5409,96,34,62,67,29,"ME",8.7
"1467",512,"SP02.61","ME",2002,5,28,148,20,43.92093,-68.58272,6,4,2,6,0,"ME",15.6
"1468",512,"SP02.62","ME",2002,5,28,148,20,43.96745,-68.3725,3,2,1,3,0,"ME",17.8
"1469",512,"SP02.63","ME",2002,5,28,148,20,44.00093,-68.46567,10,8,2,10,0,"ME",18
"1470",512,"SP02.64","ME",2002,5,28,148,20,44.04493,-68.30957,11,7,4,10,1,"ME",17
"1471",512,"SP02.66","ME",2002,5,29,149,20,44.3434,-68.47925,1,0,1,1,0,"ME",17.8
"1472",512,"SP02.67","ME",2002,5,29,149,20,44.20723,-68.43603,87,41,46,66,21,"ME",13.4
"1473",512,"SP02.68","ME",2002,5,29,149,16,44.13687,-68.25547,54,38,16,43,11,"ME",8
"1474",512,"SP02.69","ME",2002,5,30,150,20,44.00628,-68.09,6,5,1,5,1,"ME",12.2
"1475",513,"SP02.7","ME",2002,5,7,127,21,43.0012,-70.4813,1,0,1,1,0,"ME",18.06
"1476",512,"SP02.70","ME",2002,5,30,150,20,44.09012,-68.10523,10,3,7,10,0,"ME",15.2
"1477",512,"SP02.71","ME",2002,5,30,150,20,44.18278,-68.04438,9,3,6,6,3,"ME",16.2
"1478",512,"SP02.72","ME",2002,5,31,151,20,44.21277,-68.08103,18,7,11,8,10,"ME",17.4
"1479",512,"SP02.73","ME",2002,5,31,151,21,44.28535,-68.13123,51,16,35,33,18,"ME",19.74
"1480",512,"SP02.74","ME",2002,5,31,151,19,44.38457,-68.11767,244,113,131,140,104,"ME",13.87
"1481",512,"SP02.75","ME",2002,5,31,151,20,44.43242,-68.195,11,5,6,11,0,"ME",15
"1482",511,"SP02.76","ME",2002,6,3,154,10,44.39412,-67.92497,347,163,184,241,106,"ME",3
"1483",511,"SP02.77","ME",2002,6,3,154,20,44.32223,-67.85705,69,33,36,52,17,"ME",10.8
"1484",511,"SP02.78","ME",2002,6,3,154,20,44.23587,-67.79763,5,3,2,5,0,"ME",16.4
"1485",511,"SP02.79","ME",2002,6,3,154,20,44.30163,-67.66167,12,9,3,12,0,"ME",7.6
"1486",513,"SP02.8","ME",2002,5,7,127,20,43.0351,-70.4575,2,2,0,2,0,"ME",17.6
"1487",511,"SP02.80","ME",2002,6,4,155,20,44.46157,-67.72425,213,103,110,133,80,"ME",15
"1488",511,"SP02.81","ME",2002,6,4,155,15,44.45833,-67.65018,112,59,53,90,22,"ME",10.35
"1489",511,"SP02.82","ME",2002,6,4,155,20,44.40232,-67.7299,114,62,52,83,31,"ME",16.4
"1490",511,"SP02.83","ME",2002,6,4,155,20,44.37078,-67.67887,106,56,50,98,8,"ME",15.6
"1491",511,"SP02.84","ME",2002,6,4,155,20,44.435,-67.53027,41,21,20,32,9,"ME",16
"1492",511,"SP02.85","ME",2002,6,5,156,20,44.58763,-67.28667,88,55,33,43,45,"ME",15.8
"1493",511,"SP02.86","ME",2002,6,5,156,18,44.54577,-67.33492,47,28,19,37,10,"ME",13.68
"1494",511,"SP02.87","ME",2002,6,6,157,20,44.69982,-67.04305,27,11,16,19,8,"ME",15.2
"1495",467,"SP02.88","ME",2002,6,6,157,20,44.75112,-66.93453,1,0,1,1,0,"ME",23.8
"1496",467,"SP02.89","ME",2002,6,6,157,20,44.70815,-66.95508,3,1,2,3,0,"ME",22
"1497",513,"SP02.9","ME",2002,5,8,128,20,43.1471,-70.3882,22,8,14,20,2,"ME",15.2
"1498",467,"SP02.90","ME",2002,6,6,157,18,44.71083,-66.9841,8,2,6,6,2,"ME",13.68
"1499",511,"SP02.91","ME",2002,6,6,157,16,44.62145,-67.09818,36,15,21,36,0,"ME",12.64
"1500",511,"SP02.92","ME",2002,6,7,158,20,44.5014,-67.3961,117,68,49,87,30,"ME",16.4
"1501",511,"SP02.93","ME",2002,6,7,158,20,44.42513,-67.13368,2,2,0,2,0,"ME",15
"1502",513,"SP03.1","ME",2003,5,5,125,20,42.93685,-70.74628,10,1,9,9,1,"ME",16.8
"1503",513,"SP03.10","ME",2003,5,7,127,20,43.15272,-70.37645,16,7,9,14,2,"ME",15.2
"1504",467,"SP03.100","ME",2003,6,6,157,21,44.77567,-66.92848,2,0,2,2,0,"ME",17.85
"1505",511,"SP03.101","ME",2003,6,6,157,20,44.68058,-67.00647,41,21,20,36,5,"ME",14.8
"1506",513,"SP03.11","ME",2003,5,7,127,20,43.20315,-70.2646,1,0,1,1,0,"ME",19
"1507",513,"SP03.12","ME",2003,5,7,127,20,43.29133,-70.5084,62,29,33,46,16,"ME",16.8
"1508",513,"SP03.14","ME",2003,5,8,128,19,43.39912,-70.1314,5,3,2,5,0,"ME",13.3
"1509",513,"SP03.15","ME",2003,5,8,128,20,43.3913,-70.2571,37,18,19,26,11,"ME",14.4
"1510",513,"SP03.16","ME",2003,5,8,128,20,43.43333,-70.29,144,61,83,96,48,"ME",13.6
"1511",513,"SP03.17","ME",2003,5,9,129,20,43.46215,-70.1904,28,9,19,25,3,"ME",15.6
"1512",513,"SP03.18","ME",2003,5,9,129,21,43.51167,-70.19598,173,72,101,78,95,"ME",20.37
"1513",513,"SP03.19","ME",2003,5,9,129,20,43.5217,-70.3101,8,5,3,8,0,"ME",15.8
"1514",513,"SP03.2","ME",2003,5,5,125,20,42.876,-70.71207,66,30,36,61,5,"ME",17.6
"1515",513,"SP03.20","ME",2003,5,9,129,20,43.46857,-70.31467,49,23,26,45,4,"ME",14.6
"1516",513,"SP03.21","ME",2003,5,12,132,23,43.52977,-70.0236,2,0,2,2,0,"ME",16.79
"1517",513,"SP03.22","ME",2003,5,12,132,20,43.49443,-70.0527,2,2,0,2,0,"ME",14.2
"1518",513,"SP03.24","ME",2003,5,13,133,20,43.7136,-70.17493,51,22,29,37,14,"ME",14.6
"1519",513,"SP03.25","ME",2003,5,13,133,20,43.69488,-69.97407,189,78,111,97,92,"ME",16.2
"1520",513,"SP03.26","ME",2003,5,13,133,20,43.66567,-69.9416,83,38,45,41,42,"ME",15.2
"1521",513,"SP03.27","ME",2003,5,13,133,20,43.61188,-69.8702,6,3,3,2,4,"ME",17.6
"1522",513,"SP03.28","ME",2003,5,13,133,20,43.65858,-69.80095,47,32,15,45,2,"ME",15
"1523",513,"SP03.29","ME",2003,5,14,134,18,43.71198,-69.74395,141,65,76,130,11,"ME",13.14
"1524",513,"SP03.3","ME",2003,5,5,125,20,42.93208,-70.67022,39,15,24,31,8,"ME",13.4
"1525",513,"SP03.30","ME",2003,5,14,134,20,43.77502,-69.71627,69,28,41,57,12,"ME",16.6
"1526",513,"SP03.31","ME",2003,5,14,134,20,43.72195,-69.69667,207,100,107,113,94,"ME",15.8
"1527",513,"SP03.32","ME",2003,5,14,134,20,43.75298,-69.6501,185,90,95,97,88,"ME",10.6
"1528",513,"SP03.33","ME",2003,5,14,134,20,43.7981,-69.62642,116,57,59,63,53,"ME",15
"1529",512,"SP03.34","ME",2003,5,15,135,10,43.69753,-69.2864,5,4,1,4,1,"ME",4
"1530",513,"SP03.38","ME",2003,5,16,136,20,43.82442,-69.48893,61,27,34,26,35,"ME",15.8
"1531",513,"SP03.39","ME",2003,5,16,136,20,43.75125,-69.43373,7,4,3,6,1,"ME",13.4
"1532",513,"SP03.4","ME",2003,5,5,125,20,42.88578,-70.54807,9,4,5,9,0,"ME",13.8
"1533",513,"SP03.40","ME",2003,5,16,136,20,43.7649,-69.48705,12,6,6,12,0,"ME",14.6
"1534",513,"SP03.41","ME",2003,5,16,136,16,43.86967,-69.53987,24,14,10,16,8,"ME",11.68
"1535",512,"SP03.42","ME",2003,5,19,139,20,43.82117,-69.1126,36,20,16,24,12,"ME",15
"1536",512,"SP03.43","ME",2003,5,19,139,17,43.87163,-69.24447,314,161,153,188,126,"ME",11.05
"1537",512,"SP03.44","ME",2003,5,19,139,20,43.88077,-69.08242,188,80,108,130,58,"ME",19.2
"1538",512,"SP03.45","ME",2003,5,19,139,20,43.925,-69.11937,306,131,175,256,50,"ME",14.6
"1539",512,"SP03.46","ME",2003,5,20,140,20,44.05938,-69.02052,65,22,43,59,6,"ME",15.6
"1540",512,"SP03.47","ME",2003,5,20,140,20,44.13957,-69.01457,1,0,1,1,0,"ME",14.8
"1541",513,"SP03.5","ME",2003,5,6,126,20,42.95167,-70.47573,1,0,1,1,0,"ME",18.2
"1542",512,"SP03.50","ME",2003,5,20,140,20,44.27725,-68.86122,5,2,3,4,1,"ME",17
"1543",512,"SP03.51","ME",2003,5,20,140,15,44.2382,-68.8613,1,1,0,1,0,"ME",8.85
"1544",512,"SP03.52","ME",2003,5,20,140,20,43.6191,-68.93308,3,3,0,3,0,"ME",16.2
"1545",513,"SP03.53","ME",2003,5,20,140,20,43.60002,-69.11002,5,4,1,5,0,"ME",14.6
"1546",512,"SP03.54","ME",2003,5,20,140,20,43.60317,-68.82998,1,1,0,1,0,"ME",15.8
"1547",512,"SP03.55","ME",2003,5,22,142,20,43.9072,-68.62377,14,7,7,13,1,"ME",16.4
"1548",512,"SP03.56","ME",2003,5,22,142,20,43.89482,-68.66767,12,5,7,11,1,"ME",16.8
"1549",512,"SP03.57","ME",2003,5,22,142,20,43.7711,-68.64757,2,2,0,2,0,"ME",16
"1550",512,"SP03.58","ME",2003,5,23,143,20,43.91553,-68.75188,21,12,9,21,0,"ME",16.4
"1551",512,"SP03.59","ME",2003,5,23,143,20,43.9211,-68.75962,21,13,8,17,4,"ME",14
"1552",513,"SP03.6","ME",2003,5,6,126,20,43.00183,-70.33887,1,0,1,1,0,"ME",17.4
"1553",512,"SP03.60","ME",2003,5,23,143,20,43.98175,-68.68027,17,11,6,15,2,"ME",15.6
"1554",512,"SP03.61","ME",2003,5,23,143,20,44.13348,-68.75567,5,1,4,4,1,"ME",17
"1555",512,"SP03.62","ME",2003,5,27,147,21,44.15208,-68.54248,69,31,38,59,10,"ME",14.07
"1556",512,"SP03.63","ME",2003,5,27,147,15,44.12065,-68.47208,134,51,83,115,19,"ME",16.2
"1557",512,"SP03.64","ME",2003,5,27,147,20,44.01563,-68.5431,27,15,12,26,1,"ME",16
"1558",512,"SP03.65","ME",2003,5,27,147,18,43.9421,-68.55028,3,3,0,3,0,"ME",13.32
"1559",512,"SP03.66","ME",2003,5,27,147,20,43.93167,-68.44435,3,2,1,3,0,"ME",15.8
"1560",512,"SP03.67","ME",2003,5,27,147,18,43.95448,-68.3949,8,5,3,8,0,"ME",13.14
"1561",512,"SP03.68","ME",2003,5,28,148,20,43.94213,-68.2897,4,3,1,4,0,"ME",16
"1562",512,"SP03.69","ME",2003,5,28,148,20,44.04173,-68.31683,21,11,10,19,2,"ME",14.4
"1563",512,"SP03.70","ME",2003,5,28,148,20,44.21933,-68.07702,27,17,10,20,7,"ME",16
"1564",512,"SP03.71","ME",2003,5,28,148,20,44.30547,-68.12593,35,15,20,25,10,"ME",16.2
"1565",512,"SP03.72","ME",2003,5,29,149,20,44.20547,-68.4244,147,62,85,124,23,"ME",16
"1566",512,"SP03.73","ME",2003,5,29,149,20,44.28442,-68.472,3,1,2,3,0,"ME",14.4
"1567",512,"SP03.74","ME",2003,5,29,149,20,44.37823,-68.4364,1,1,0,1,0,"ME",17
"1568",512,"SP03.75","ME",2003,5,29,149,20,44.05693,-68.05177,7,6,1,7,0,"ME",14.4
"1569",512,"SP03.76","ME",2003,5,29,149,20,44.02873,-67.99783,3,3,0,3,0,"ME",14.4
"1570",512,"SP03.77","ME",2003,5,30,150,20,44.44047,-68.1608,2,1,1,2,0,"ME",15
"1571",512,"SP03.78","ME",2003,5,30,150,20,44.3709,-68.14848,20,6,14,16,4,"ME",15
"1572",512,"SP03.79","ME",2003,5,30,150,20,44.31097,-68.0736,67,30,37,53,14,"ME",13.6
"1573",513,"SP03.8","ME",2003,5,6,126,20,43.07565,-70.4632,3,2,1,3,0,"ME",15.8
"1574",512,"SP03.80","ME",2003,5,30,150,21,44.27157,-68.00747,41,25,16,30,11,"ME",16.59
"1575",512,"SP03.81","ME",2003,5,30,150,20,44.18723,-68.03017,14,10,4,12,2,"ME",14.8
"1576",511,"SP03.82","ME",2003,6,2,153,20,44.36977,-67.90845,74,36,38,59,15,"ME",14
"1577",511,"SP03.83","ME",2003,6,2,153,20,44.3202,-67.85337,61,40,21,51,10,"ME",13.4
"1578",511,"SP03.84","ME",2003,6,2,153,18,44.28667,-67.80793,16,10,6,9,7,"ME",14.04
"1579",511,"SP03.85","ME",2003,6,2,153,20,44.21503,-67.8017,8,6,2,8,0,"ME",16.8
"1580",511,"SP03.86","ME",2003,6,3,154,18,44.46763,-67.725,224,132,92,168,56,"ME",12.6
"1581",511,"SP03.87","ME",2003,6,3,154,16,44.44158,-67.78813,65,32,33,52,13,"ME",8.48
"1582",511,"SP03.88","ME",2003,6,3,154,20,44.3,-67.68007,6,2,4,5,1,"ME",17.6
"1583",511,"SP03.89","ME",2003,6,3,154,20,44.27447,-67.66023,4,2,2,4,0,"ME",15.2
"1584",513,"SP03.9","ME",2003,5,6,126,17,43.03332,-70.5593,19,9,10,18,1,"ME",10.54
"1585",511,"SP03.90","ME",2003,6,3,154,20,44.26122,-67.58523,3,3,0,3,0,"ME",15
"1586",511,"SP03.91","ME",2003,6,4,155,20,44.30085,-67.49437,6,5,1,6,0,"ME",15.4
"1587",511,"SP03.92","ME",2003,6,4,155,20,44.33582,-67.34772,3,3,0,3,0,"ME",14
"1588",511,"SP03.93","ME",2003,6,4,155,20,44.34478,-67.28427,1,1,0,1,0,"ME",13.8
"1589",511,"SP03.94","ME",2003,6,4,155,20,44.42067,-67.44837,48,23,25,42,6,"ME",16.4
"1590",511,"SP03.95","ME",2003,6,5,156,20,44.4381,-67.52645,64,32,32,49,15,"ME",15.4
"1591",511,"SP03.96","ME",2003,6,5,156,17,44.51737,-67.42603,41,24,17,36,5,"ME",9.69
"1592",511,"SP03.97","ME",2003,6,5,156,20,44.6014,-67.43507,90,46,44,72,18,"ME",18.2
"1593",511,"SP03.98","ME",2003,6,6,157,20,44.59113,-67.27423,111,63,48,52,59,"ME",14.2
"1594",467,"SP03.99","ME",2003,6,6,157,16,44.70425,-66.9535,5,3,2,5,0,"ME",11.04
"1595",513,"SP04.1","ME",2004,5,3,124,20,42.92667,-70.7545,4,3,1,4,0,"ME",16
"1596",513,"SP04.10","ME",2004,5,5,126,20,43.15427,-70.37777,31,15,16,28,3,"ME",13.8
"1597",511,"SP04.100","ME",2004,6,7,159,20,44.566,-67.28417,12,7,5,11,1,"ME",16.4
"1598",511,"SP04.101","ME",2004,6,8,160,20,44.60567,-67.36267,101,49,52,89,12,"ME",15.8
"1599",511,"SP04.102","ME",2004,6,8,160,20,44.69067,-67.12133,104,66,38,99,5,"ME",19.8
"1600",511,"SP04.103","ME",2004,6,8,160,20,44.72883,-67.01917,2,1,1,1,1,"ME",21
"1601",513,"SP04.11","ME",2004,5,5,126,20,43.18178,-70.43545,38,21,17,32,6,"ME",16.2
"1602",513,"SP04.12","ME",2004,5,5,126,14,43.18842,-70.38387,13,6,7,11,2,"ME",6.3
"1603",513,"SP04.13","ME",2004,5,6,127,20,43.26267,-70.537,52,25,27,39,13,"ME",17.6
"1604",513,"SP04.14","ME",2004,5,6,127,20,43.28467,-70.50633,32,14,18,29,3,"ME",17.6
"1605",513,"SP04.15","ME",2004,5,6,127,20,43.30943,-70.2562,29,9,20,26,3,"ME",15
"1606",513,"SP04.16","ME",2004,5,6,127,17,43.27083,-70.171,1,1,0,1,0,"ME",11.9
"1607",513,"SP04.17","ME",2004,5,6,127,20,43.40767,-70.12583,5,3,2,5,0,"ME",18.4
"1608",513,"SP04.18","ME",2004,5,6,127,20,43.40967,-70.08067,1,1,0,1,0,"ME",15
"1609",513,"SP04.19","ME",2004,5,7,128,20,43.421,-70.29067,128,55,73,86,42,"ME",15.4
"1610",513,"SP04.2","ME",2004,5,3,124,18,42.96417,-70.65917,6,2,4,6,0,"ME",12.42
"1611",513,"SP04.20","ME",2004,5,7,128,20,43.50017,-70.33233,5,1,4,4,1,"ME",18.2
"1612",513,"SP04.21","ME",2004,5,7,128,20,43.53033,-70.27917,3,1,2,2,1,"ME",17.2
"1613",513,"SP04.22","ME",2004,5,7,128,20,43.509,-70.19333,43,22,21,26,17,"ME",17.4
"1614",513,"SP04.23","ME",2004,5,10,131,19,43.763,-70.08233,14,7,7,5,9,"ME",14.06
"1615",513,"SP04.24","ME",2004,5,10,131,20,43.79183,-70.01383,13,7,6,10,3,"ME",15
"1616",513,"SP04.25","ME",2004,5,10,131,20,43.646,-70.061,225,114,111,166,59,"ME",16.2
"1617",513,"SP04.26","ME",2004,5,10,131,20,43.65017,-70.00717,127,61,66,89,38,"ME",14.6
"1618",513,"SP04.27","ME",2004,5,11,132,20,43.52783,-70.01733,2,0,2,2,0,"ME",14.4
"1619",513,"SP04.3","ME",2004,5,3,124,20,42.9385,-70.66133,14,10,4,10,4,"ME",16.6
"1620",513,"SP04.31","ME",2004,5,11,132,20,43.54683,-69.69533,3,3,0,2,1,"ME",14.8
"1621",513,"SP04.33","ME",2004,5,12,133,19,43.60933,-69.86383,1,0,1,1,0,"ME",16.91
"1622",513,"SP04.34","ME",2004,5,12,133,20,43.6365,-69.85567,63,23,40,42,21,"ME",15.2
"1623",513,"SP04.35","ME",2004,5,12,133,20,43.65917,-69.792,37,23,14,34,3,"ME",16
"1624",513,"SP04.36","ME",2004,5,12,133,20,43.6786,-69.8682,39,19,20,38,1,"ME",15.6
"1625",513,"SP04.37","ME",2004,5,13,134,20,43.8095,-69.64417,115,52,63,65,50,"ME",13.2
"1626",513,"SP04.38","ME",2004,5,13,134,20,43.7555,-69.64983,83,49,34,42,41,"ME",15.6
"1627",513,"SP04.39","ME",2004,5,13,134,20,43.71383,-69.74233,149,71,78,142,7,"ME",15
"1628",513,"SP04.4","ME",2004,5,3,124,20,42.94945,-70.60273,13,7,6,10,3,"ME",15.4
"1629",513,"SP04.41","ME",2004,5,14,135,20,43.75267,-69.36067,5,3,2,4,1,"ME",15.4
"1630",513,"SP04.42","ME",2004,5,14,135,20,43.7865,-69.38417,12,6,6,8,4,"ME",15.4
"1631",513,"SP04.43","ME",2004,5,14,135,20,43.77267,-69.46317,13,8,5,12,1,"ME",14.8
"1632",513,"SP04.44","ME",2004,5,14,135,20,43.839,-69.48433,41,20,21,24,17,"ME",15.4
"1633",513,"SP04.45","ME",2004,5,14,135,20,43.92467,-69.40067,39,16,23,15,24,"ME",14.6
"1634",512,"SP04.46","ME",2004,5,17,138,20,43.77233,-69.22233,25,11,14,13,12,"ME",16.2
"1635",512,"SP04.47","ME",2004,5,17,138,20,43.87817,-69.08233,199,91,108,132,67,"ME",14.4
"1636",512,"SP04.48","ME",2004,5,17,138,20,43.92717,-69.12667,485,225,259,392,93,"ME",16.2
"1637",512,"SP04.49","ME",2004,5,17,138,20,43.96283,-69.15367,76,23,53,56,20,"ME",15.6
"1638",513,"SP04.5","ME",2004,5,4,125,21,42.863,-70.47133,1,0,1,1,0,"ME",15.12
"1639",512,"SP04.50","ME",2004,5,18,139,20,44.14333,-69.03933,7,4,3,6,1,"ME",15.2
"1640",512,"SP04.51","ME",2004,5,19,140,20,44.17917,-68.93883,2,2,0,2,0,"ME",15.2
"1641",512,"SP04.54","ME",2004,5,19,140,20,44.14317,-68.76083,7,3,4,7,0,"ME",16
"1642",512,"SP04.55","ME",2004,5,19,140,20,44.1775,-68.75417,28,9,19,26,2,"ME",17.2
"1643",512,"SP04.56","ME",2004,5,19,140,20,44.17217,-68.80017,5,0,5,5,0,"ME",15.6
"1644",512,"SP04.57","ME",2004,5,20,141,20,43.78467,-69.085,4,4,0,4,0,"ME",15.8
"1645",512,"SP04.58","ME",2004,5,20,141,20,43.72117,-69.09467,4,3,1,4,0,"ME",15.6
"1646",513,"SP04.59","ME",2004,5,20,141,20,43.562,-69.10983,2,1,1,2,0,"ME",15.6
"1647",513,"SP04.6","ME",2004,5,5,126,20,42.9785,-70.516,6,5,1,6,0,"ME",13.6
"1648",512,"SP04.60","ME",2004,5,20,141,19,43.61583,-68.93733,2,1,1,2,0,"ME",13.68
"1649",512,"SP04.61","ME",2004,5,21,142,20,43.9175,-68.7535,5,3,2,4,1,"ME",15.8
"1650",512,"SP04.62","ME",2004,5,21,142,20,43.91033,-68.63167,7,5,2,7,0,"ME",15.8
"1651",512,"SP04.63","ME",2004,5,21,142,20,43.77167,-68.65283,1,0,1,1,0,"ME",15.8
"1652",512,"SP04.64","ME",2004,5,21,142,17,43.789,-68.695,3,2,1,3,0,"ME",10.88
"1653",512,"SP04.65","ME",2004,5,24,145,20,44.1645,-68.53333,50,26,24,42,8,"ME",15.4
"1654",512,"SP04.66","ME",2004,5,24,145,20,44.00917,-68.55533,21,14,7,21,0,"ME",15.6
"1655",512,"SP04.67","ME",2004,5,24,145,20,43.94433,-68.5625,2,1,1,2,0,"ME",14.8
"1656",512,"SP04.69","ME",2004,5,25,146,20,43.94933,-68.405,2,1,1,2,0,"ME",14.6
"1657",513,"SP04.7","ME",2004,5,5,126,20,42.95707,-70.46027,4,1,3,4,0,"ME",15.2
"1658",512,"SP04.71","ME",2004,5,25,146,20,43.94517,-68.28483,5,5,0,5,0,"ME",14.8
"1659",512,"SP04.73","ME",2004,5,26,147,20,44.27883,-68.43467,11,0,11,9,2,"ME",16.2
"1660",512,"SP04.74","ME",2004,5,26,147,20,44.24333,-68.47367,38,20,18,28,10,"ME",16.8
"1661",512,"SP04.75","ME",2004,5,27,148,20,44.2145,-68.42383,91,41,50,84,7,"ME",15.2
"1662",512,"SP04.76","ME",2004,5,27,148,13,44.14117,-68.25917,51,25,26,43,8,"ME",6.5
"1663",512,"SP04.77","ME",2004,5,27,148,20,44.22283,-68.07517,13,9,4,11,2,"ME",16
"1664",512,"SP04.78","ME",2004,5,27,148,20,44.21217,-67.98567,12,7,5,11,1,"ME",15.8
"1665",512,"SP04.79","ME",2004,5,27,148,20,44.1275,-68.0195,2,1,1,2,0,"ME",15.6
"1666",513,"SP04.8","ME",2004,5,5,126,20,43.06468,-70.45453,2,0,2,2,0,"ME",14.4
"1667",512,"SP04.80","ME",2004,5,27,148,20,44.05217,-68.064,2,1,1,2,0,"ME",16
"1668",512,"SP04.81","ME",2004,5,28,149,20,44.27567,-68.00967,58,23,35,42,16,"ME",15.4
"1669",512,"SP04.82","ME",2004,5,28,149,20,44.31783,-68.10033,93,44,49,85,8,"ME",15
"1670",512,"SP04.83","ME",2004,5,28,149,20,44.29567,-68.12667,29,10,19,23,6,"ME",15.4
"1671",512,"SP04.84","ME",2004,5,28,149,20,44.27767,-68.27433,25,5,20,22,3,"ME",16
"1672",512,"SP04.85","ME",2004,5,31,152,20,44.30367,-67.98833,30,12,18,24,6,"ME",15.6
"1673",511,"SP04.86","ME",2004,5,31,152,16,44.25567,-67.86533,4,4,0,4,0,"ME",9.76
"1674",511,"SP04.87","ME",2004,5,31,152,20,44.38367,-67.91567,149,80,69,127,22,"ME",16.4
"1675",511,"SP04.88","ME",2004,5,31,152,20,44.3305,-67.852,31,14,17,26,5,"ME",15
"1676",511,"SP04.89","ME",2004,6,1,153,20,44.4515,-67.72167,264,140,124,204,60,"ME",16.8
"1677",513,"SP04.9","ME",2004,5,5,126,20,43.08747,-70.30015,1,0,1,1,0,"ME",15.8
"1678",511,"SP04.90","ME",2004,6,1,153,20,44.379,-67.66567,24,12,12,20,4,"ME",15.8
"1679",511,"SP04.91","ME",2004,6,1,153,20,44.33467,-67.63183,6,4,2,6,0,"ME",15
"1680",511,"SP04.92","ME",2004,6,1,153,20,44.2985,-67.68017,6,3,3,6,0,"ME",15
"1681",511,"SP04.93","ME",2004,6,2,154,20,44.344,-67.5055,7,4,3,7,0,"ME",15.4
"1682",511,"SP04.95","ME",2004,6,2,154,20,44.34417,-67.29283,3,2,1,3,0,"ME",15.6
"1683",467,"SP04.96","ME",2004,6,3,155,20,44.69967,-66.96167,10,5,5,9,1,"ME",16.4
"1684",467,"SP04.97","ME",2004,6,3,155,10,44.70067,-66.99033,6,3,3,5,1,"ME",6.1
"1685",511,"SP04.98","ME",2004,6,7,159,20,44.42117,-67.45317,15,7,8,11,4,"ME",15.4
"1686",511,"SP04.99","ME",2004,6,7,159,20,44.58367,-67.31133,11,7,4,11,0,"ME",15.8
"1687",513,"SP05.1","ME",2005,5,2,122,20,42.92733,-70.75217,20,7,13,19,1,"ME",15.52
"1688",513,"SP05.10","ME",2005,5,4,124,20,43.0945,-70.473,15,8,7,13,2,"ME",15.28
"1689",511,"SP05.100","ME",2005,6,9,160,20,44.61717,-67.17917,18,9,9,15,3,"ME",16.5
"1690",511,"SP05.101","ME",2005,6,9,160,19,44.629,-67.2015,45,22,23,37,8,"ME",14.155
"1691",511,"SP05.102","ME",2005,6,10,161,20,44.5855,-67.30167,92,52,40,74,18,"ME",18.52
"1692",511,"SP05.103","ME",2005,6,10,161,20,44.59083,-67.4565,54,31,23,49,5,"ME",16.12
"1693",511,"SP05.104","ME",2005,6,10,161,20,44.51983,-67.45183,165,84,81,125,40,"ME",15.38
"1694",513,"SP05.11","ME",2005,5,4,124,20,43.08717,-70.30017,1,0,1,1,0,"ME",15.8
"1695",513,"SP05.12","ME",2005,5,4,124,20,43.14783,-70.39033,15,7,8,12,3,"ME",15
"1696",513,"SP05.13","ME",2005,5,4,124,20,43.159,-70.40533,23,7,16,18,5,"ME",16.34
"1697",513,"SP05.14","ME",2005,5,5,125,20,43.29517,-70.49367,38,18,20,30,8,"ME",15.7
"1698",513,"SP05.15","ME",2005,5,5,125,20,43.29833,-70.10583,2,1,1,2,0,"ME",16.02
"1699",513,"SP05.16","ME",2005,5,5,125,20,43.40333,-70.13,2,0,2,2,0,"ME",16.32
"1700",513,"SP05.17","ME",2005,5,5,125,15,43.48767,-70.27533,86,44,42,75,11,"ME",8.145
"1701",513,"SP05.18","ME",2005,5,6,126,19,43.42233,-70.29083,111,39,72,71,40,"ME",13.642
"1702",513,"SP05.19","ME",2005,5,10,130,20,43.48117,-70.32183,77,36,41,49,28,"ME",14.2
"1703",513,"SP05.2","ME",2005,5,2,122,20,42.898,-70.60167,5,3,2,5,0,"ME",14.86
"1704",513,"SP05.20","ME",2005,5,10,130,20,43.51133,-70.19333,120,55,65,47,73,"ME",15.76
"1705",513,"SP05.21","ME",2005,5,10,130,20,43.46567,-70.06,1,0,1,1,0,"ME",15.44
"1706",513,"SP05.22","ME",2005,5,10,130,20,43.42767,-69.9275,1,1,0,1,0,"ME",15.24
"1707",513,"SP05.24","ME",2005,5,10,130,20,43.52883,-70.0185,1,0,1,1,0,"ME",15.72
"1708",513,"SP05.25","ME",2005,5,11,131,20,43.61417,-70.20033,79,34,45,55,24,"ME",13.38
"1709",513,"SP05.26","ME",2005,5,11,131,10,43.66233,-70.12767,75,29,46,59,16,"ME",3.62
"1710",513,"SP05.27","ME",2005,5,11,131,20,43.66233,-69.974,326,173,153,157,169,"ME",15.8
"1711",513,"SP05.28","ME",2005,5,11,131,20,43.711,-69.9305,462,217,245,294,168,"ME",15.7
"1712",513,"SP05.29","ME",2005,5,11,131,20,43.61183,-69.8625,9,6,3,7,2,"ME",14.64
"1713",513,"SP05.3","ME",2005,5,2,122,20,42.86167,-70.75267,25,14,11,23,2,"ME",15.82
"1714",513,"SP05.30","ME",2005,5,12,132,20,43.6595,-69.79067,43,26,17,41,2,"ME",16.28
"1715",513,"SP05.31","ME",2005,5,12,132,20,43.6875,-69.76617,70,40,30,66,4,"ME",15.42
"1716",513,"SP05.32","ME",2005,5,12,132,20,43.69933,-69.747,228,103,125,209,19,"ME",15.76
"1717",513,"SP05.33","ME",2005,5,12,132,20,43.78367,-69.70067,343,159,184,136,207,"ME",15
"1718",513,"SP05.34","ME",2005,5,12,132,20,43.75517,-69.64883,114,58,56,67,47,"ME",14.3
"1719",513,"SP05.35","ME",2005,5,13,133,18,43.83933,-69.483,102,57,45,44,58,"ME",11.7
"1720",513,"SP05.36","ME",2005,5,13,133,20,43.945,-69.38017,48,27,21,25,23,"ME",13.4
"1721",513,"SP05.37","ME",2005,5,13,133,20,43.796,-69.3635,68,41,27,45,23,"ME",14.96
"1722",513,"SP05.38","ME",2005,5,13,133,20,43.76083,-69.4665,4,0,4,3,1,"ME",15.7
"1723",513,"SP05.39","ME",2005,5,14,134,19,43.69417,-69.512,2,2,0,2,0,"ME",15.77
"1724",513,"SP05.4","ME",2005,5,2,122,20,42.98983,-70.65833,21,9,12,19,2,"ME",15.1
"1725",513,"SP05.40","ME",2005,5,14,134,20,43.679,-69.41933,1,0,1,1,0,"ME",15.1
"1726",513,"SP05.41","ME",2005,5,14,134,20,43.7485,-69.34383,8,3,5,5,3,"ME",15.58
"1727",513,"SP05.42","ME",2005,5,16,136,20,43.78567,-69.38467,18,9,9,12,6,"ME",14.8
"1728",512,"SP05.43","ME",2005,5,16,136,20,43.88667,-69.23017,438,219,219,225,213,"ME",16.08
"1729",512,"SP05.44","ME",2005,5,16,136,20,43.92583,-69.12,368,163,205,262,106,"ME",15.86
"1730",512,"SP05.45","ME",2005,5,16,136,20,43.8645,-69.08217,265,129,136,176,89,"ME",16.3
"1731",512,"SP05.46","ME",2005,5,16,136,20,43.872,-69.03583,643,325,318,432,211,"ME",15.96
"1732",512,"SP05.47","ME",2005,5,17,137,20,44.16117,-69.0745,69,23,46,45,24,"ME",16.22
"1733",512,"SP05.48","ME",2005,5,17,137,20,44.14533,-69.00933,6,4,2,5,1,"ME",16.92
"1734",512,"SP05.49","ME",2005,5,17,137,20,44.28983,-68.8865,2,1,1,2,0,"ME",13.46
"1735",513,"SP05.5","ME",2005,5,3,123,19,42.91767,-70.46117,2,2,0,2,0,"ME",13.851
"1736",512,"SP05.50","ME",2005,5,17,137,20,44.31283,-68.85417,1,1,0,1,0,"ME",16.1
"1737",512,"SP05.52","ME",2005,5,18,138,20,43.75967,-69.20983,3,3,0,3,0,"ME",15.4
"1738",512,"SP05.53","ME",2005,5,18,138,20,43.7715,-69.10167,10,5,5,9,1,"ME",16
"1739",512,"SP05.54","ME",2005,5,18,138,20,43.608,-68.94267,1,1,0,1,0,"ME",15.88
"1740",513,"SP05.55","ME",2005,5,18,138,20,43.582,-69.09067,2,2,0,2,0,"ME",17.1
"1741",512,"SP05.56","ME",2005,5,19,139,20,43.7785,-68.6375,1,0,1,1,0,"ME",14.54
"1742",512,"SP05.57","ME",2005,5,19,139,18,43.787,-68.69867,2,1,1,2,0,"ME",14.742
"1743",512,"SP05.58","ME",2005,5,20,140,20,43.91767,-68.62217,6,5,1,6,0,"ME",14.46
"1744",512,"SP05.59","ME",2005,5,20,140,20,43.91867,-68.754,13,7,6,13,0,"ME",14.5
"1745",513,"SP05.6","ME",2005,5,3,123,20,42.95767,-70.46167,2,2,0,2,0,"ME",15.74
"1746",512,"SP05.60","ME",2005,5,20,140,20,43.93267,-68.782,29,16,13,28,1,"ME",15.18
"1747",512,"SP05.61","ME",2005,5,20,140,20,44.00917,-68.874,397,193,204,232,165,"ME",16.46
"1748",512,"SP05.62","ME",2005,5,20,140,20,44.1325,-68.7555,24,11,13,20,4,"ME",15.52
"1749",512,"SP05.63","ME",2005,5,30,150,18,44.16333,-68.53367,94,39,55,74,20,"ME",13.428
"1750",512,"SP05.64","ME",2005,5,30,150,20,44.01083,-68.55383,26,15,11,21,5,"ME",16.2
"1751",512,"SP05.65","ME",2005,5,30,150,20,44.012,-68.40767,8,4,4,7,1,"ME",15.66
"1752",512,"SP05.66","ME",2005,5,30,150,15,43.95167,-68.45183,5,3,2,5,0,"ME",8.79
"1753",512,"SP05.67","ME",2005,5,31,151,20,43.97317,-68.30833,7,4,3,7,0,"ME",15
"1754",512,"SP05.68","ME",2005,5,31,151,20,43.963,-68.25517,6,5,1,5,1,"ME",15.6
"1755",512,"SP05.69","ME",2005,5,31,151,20,43.91167,-68.28583,3,1,2,3,0,"ME",15.82
"1756",512,"SP05.70","ME",2005,5,31,151,20,44.0155,-68.1935,6,6,0,6,0,"ME",16.38
"1757",512,"SP05.71","ME",2005,6,1,152,20,44.29617,-68.51717,11,3,8,9,2,"ME",17.08
"1758",512,"SP05.72","ME",2005,6,1,152,16,44.2795,-68.477,145,55,90,107,38,"ME",10.176
"1759",512,"SP05.73","ME",2005,6,1,152,19,44.21283,-68.4265,89,40,49,80,9,"ME",14.155
"1760",512,"SP05.74","ME",2005,6,1,152,17,44.13633,-68.25333,159,83,76,123,36,"ME",10.336
"1761",512,"SP05.75","ME",2005,6,1,152,18,44.20383,-68.30533,432,208,224,371,61,"ME",12.168
"1762",512,"SP05.76","ME",2005,6,2,153,20,44.02133,-67.98867,6,2,4,5,1,"ME",16
"1763",512,"SP05.77","ME",2005,6,2,153,20,44.05867,-68.0515,3,2,1,3,0,"ME",16.7
"1764",512,"SP05.78","ME",2005,6,2,153,20,44.162,-67.95717,11,8,3,8,3,"ME",15.88
"1765",512,"SP05.79","ME",2005,6,2,153,20,44.20533,-67.90067,5,3,2,5,0,"ME",15.88
"1766",513,"SP05.8","ME",2005,5,3,123,17,43.02633,-70.56067,24,15,9,22,2,"ME",10.812
"1767",512,"SP05.80","ME",2005,6,2,153,20,44.21467,-68.06283,20,9,11,10,10,"ME",16.32
"1768",512,"SP05.81","ME",2005,6,3,154,20,44.35317,-68.16633,115,58,57,88,27,"ME",15.3
"1769",512,"SP05.82","ME",2005,6,3,154,20,44.29733,-68.12767,26,9,17,11,15,"ME",15.44
"1770",512,"SP05.83","ME",2005,6,3,154,20,44.24917,-68.10333,37,21,16,25,12,"ME",15.3
"1771",512,"SP05.84","ME",2005,6,3,154,20,44.295,-68.05267,38,21,17,28,10,"ME",15.86
"1772",511,"SP05.85","ME",2005,6,6,157,20,44.3685,-67.90833,573,299,274,483,90,"ME",15.26
"1773",511,"SP05.86","ME",2005,6,6,157,20,44.317,-67.856,37,23,14,28,9,"ME",14.98
"1774",511,"SP05.87","ME",2005,6,6,157,20,44.2535,-67.8685,12,6,6,9,3,"ME",16.48
"1775",512,"SP05.88","ME",2005,6,6,157,20,44.205,-67.90267,4,4,0,4,0,"ME",14
"1776",511,"SP05.89","ME",2005,6,7,158,20,44.28917,-67.7345,15,10,5,15,0,"ME",14.84
"1777",513,"SP05.9","ME",2005,5,4,124,20,43.083,-70.4525,13,4,9,13,0,"ME",16.3
"1778",511,"SP05.90","ME",2005,6,7,158,20,44.299,-67.67867,15,11,4,14,1,"ME",15.34
"1779",511,"SP05.91","ME",2005,6,7,158,20,44.35883,-67.69517,24,12,12,24,0,"ME",16.4
"1780",511,"SP05.92","ME",2005,6,7,158,20,44.452,-67.721,206,114,92,156,50,"ME",14.32
"1781",511,"SP05.93","ME",2005,6,8,159,20,44.31983,-67.55483,7,6,1,7,0,"ME",15.74
"1782",511,"SP05.94","ME",2005,6,8,159,20,44.29883,-67.499,1,1,0,1,0,"ME",15.62
"1783",511,"SP05.95","ME",2005,6,8,159,20,44.27,-67.451,2,2,0,2,0,"ME",15.72
"1784",511,"SP05.96","ME",2005,6,8,159,20,44.22333,-67.50733,4,4,0,4,0,"ME",15.5
"1785",467,"SP05.98","ME",2005,6,9,160,16,44.70267,-66.959,3,1,2,3,0,"ME",10.864
"1786",511,"SP05.99","ME",2005,6,9,160,19,44.61867,-67.09567,18,5,13,15,3,"ME",14.383
"1787",513,"SP06.1","ME",2006,5,1,121,20,42.9702,-70.74345,20,8,12,15,5,"ME",16.2
"1788",513,"SP06.10","ME",2006,5,4,124,20,43.17962,-70.43505,22,13,9,18,4,"ME",17.04
"1789",511,"SP06.100","ME",2006,5,31,151,16,44.46857,-67.797,392,202,190,284,108,"ME",9.696
"1790",511,"SP06.101","ME",2006,5,31,151,16,44.45967,-67.72235,429,250,179,344,85,"ME",10.08
"1791",511,"SP06.102","ME",2006,6,3,154,20,44.59193,-67.28542,100,54,46,79,21,"ME",16.58
"1792",511,"SP06.103","ME",2006,6,3,154,20,44.65067,-67.18023,36,9,27,27,9,"ME",17.32
"1793",511,"SP06.104","ME",2006,6,3,154,18,44.66788,-67.11013,12,4,8,10,2,"ME",14.238
"1794",467,"SP06.105","ME",2006,6,3,154,20,44.7057,-66.9604,16,7,9,14,2,"ME",17.82
"1795",467,"SP06.106","ME",2006,6,3,154,20,44.71942,-66.98062,20,12,8,13,7,"ME",15.16
"1796",511,"SP06.107","ME",2006,6,5,156,20,44.48987,-67.28043,22,8,14,19,3,"ME",16.8
"1797",511,"SP06.108","ME",2006,6,5,156,20,44.39675,-67.09972,2,2,0,2,0,"ME",16.92
"1798",511,"SP06.109","ME",2006,6,5,156,15,44.42585,-67.13097,2,0,2,2,0,"ME",7.305
"1799",513,"SP06.11","ME",2006,5,4,124,20,43.15492,-70.3754,32,19,13,22,10,"ME",16.68
"1800",513,"SP06.12","ME",2006,5,4,124,20,43.13652,-70.27562,3,0,3,3,0,"ME",17.52
"1801",513,"SP06.13","ME",2006,5,4,124,21,43.25018,-70.35497,61,27,34,40,21,"ME",22.89
"1802",513,"SP06.14","ME",2006,5,4,124,20,43.28807,-70.53223,126,59,67,74,52,"ME",16.92
"1803",513,"SP06.15","ME",2006,5,4,124,16,43.32077,-70.33495,10,4,6,7,3,"ME",11.36
"1804",513,"SP06.16","ME",2006,5,5,125,20,43.33272,-70.21447,23,8,15,22,1,"ME",16.58
"1805",513,"SP06.17","ME",2006,5,5,125,20,43.38865,-70.20307,23,12,11,16,7,"ME",16.88
"1806",513,"SP06.18","ME",2006,5,5,125,20,43.40283,-70.13078,17,11,6,16,1,"ME",17.26
"1807",513,"SP06.2","ME",2006,5,1,121,19,42.97378,-70.66443,32,12,20,24,8,"ME",15.086
"1808",513,"SP06.20","ME",2006,5,5,125,20,43.43263,-70.09203,4,1,3,4,0,"ME",17.12
"1809",513,"SP06.21","ME",2006,5,5,125,20,43.42698,-70.22423,57,26,31,36,21,"ME",16.34
"1810",513,"SP06.22","ME",2006,5,5,125,18,43.42375,-70.2899,165,61,104,94,71,"ME",11.916
"1811",513,"SP06.23","ME",2006,5,6,126,19,43.54647,-70.28537,139,51,88,72,67,"ME",14.269
"1812",513,"SP06.24","ME",2006,5,6,126,20,43.52563,-70.235,316,150,166,168,148,"ME",16.32
"1813",513,"SP06.25","ME",2006,5,6,126,20,43.49902,-70.21693,176,82,94,139,37,"ME",17.72
"1814",513,"SP06.26","ME",2006,5,8,128,20,43.71273,-70.1747,61,28,33,7,54,"ME",16.24
"1815",513,"SP06.27","ME",2006,5,8,128,20,43.63552,-70.17192,53,31,22,30,23,"ME",16.84
"1816",513,"SP06.28","ME",2006,5,8,128,20,43.6756,-70.11128,57,26,31,31,26,"ME",16.78
"1817",513,"SP06.29","ME",2006,5,8,128,20,43.63488,-70.0579,81,56,25,47,34,"ME",16.26
"1818",513,"SP06.3","ME",2006,5,1,121,20,43.03613,-70.5587,24,12,12,22,2,"ME",17.02
"1819",513,"SP06.30","ME",2006,5,8,128,20,43.60245,-69.92462,30,15,15,21,9,"ME",16.52
"1820",513,"SP06.31","ME",2006,5,9,129,20,43.60967,-69.8645,21,9,12,9,12,"ME",15.34
"1821",513,"SP06.32","ME",2006,5,9,129,20,43.5347,-69.76625,1,1,0,1,0,"ME",15.26
"1822",513,"SP06.33","ME",2006,5,9,129,20,43.46618,-69.61845,3,3,0,3,0,"ME",16.7
"1823",513,"SP06.34","ME",2006,5,10,130,20,43.76103,-69.6954,193,101,92,73,120,"ME",16.46
"1824",513,"SP06.35","ME",2006,5,10,130,20,43.79598,-69.69837,227,105,122,60,167,"ME",16.98
"1825",513,"SP06.36","ME",2006,5,10,130,20,43.75143,-69.73443,121,56,65,87,34,"ME",16.3
"1826",513,"SP06.37","ME",2006,5,10,130,20,43.71547,-69.74228,109,52,57,93,16,"ME",16.64
"1827",513,"SP06.38","ME",2006,5,10,130,20,43.69443,-69.68288,118,52,66,63,55,"ME",16.62
"1828",513,"SP06.39","ME",2006,5,10,130,20,43.68763,-69.65713,55,25,30,28,27,"ME",16.24
"1829",513,"SP06.4","ME",2006,5,1,121,16,43.00325,-70.69762,3,2,1,3,0,"ME",10.256
"1830",513,"SP06.40","ME",2006,5,11,131,20,43.74053,-69.4995,13,6,7,9,4,"ME",16.48
"1831",513,"SP06.41","ME",2006,5,11,131,20,43.6963,-69.5134,3,3,0,2,1,"ME",16.94
"1832",513,"SP06.43","ME",2006,5,11,131,20,43.78675,-69.38422,76,39,37,45,31,"ME",16.72
"1833",513,"SP06.44","ME",2006,5,12,132,20,43.82962,-69.57582,362,187,175,166,196,"ME",17.1
"1834",513,"SP06.45","ME",2006,5,12,132,20,43.93333,-69.44883,126,62,64,21,105,"ME",16.22
"1835",513,"SP06.46","ME",2006,5,15,135,20,43.8386,-69.48467,175,97,78,56,119,"ME",16.4
"1836",513,"SP06.47","ME",2006,5,15,135,20,43.8379,-69.40628,196,104,92,114,82,"ME",16.52
"1837",512,"SP06.48","ME",2006,5,15,135,20,43.75388,-69.21387,21,12,9,17,4,"ME",15.44
"1838",512,"SP06.49","ME",2006,5,15,135,20,43.77843,-69.15082,30,15,15,25,5,"ME",16.2
"1839",513,"SP06.5","ME",2006,5,2,122,20,42.87997,-70.69537,21,6,15,17,4,"ME",16.92
"1840",512,"SP06.50","ME",2006,5,15,135,16,43.9284,-69.12502,708,304,404,372,336,"ME",11.44
"1841",512,"SP06.51","ME",2006,5,15,135,20,43.94097,-69.16333,1139,483,656,460,679,"ME",16
"1842",512,"SP06.52","ME",2006,5,16,136,19,44.05892,-69.01938,87,32,55,76,11,"ME",14.63
"1843",512,"SP06.53","ME",2006,5,16,136,20,44.12742,-69.01672,103,42,61,78,25,"ME",16.12
"1844",512,"SP06.54","ME",2006,5,16,136,17,44.20617,-69.0242,27,12,15,22,5,"ME",11.288
"1845",512,"SP06.55","ME",2006,5,16,136,20,44.1766,-68.94087,11,3,8,10,1,"ME",16.02
"1846",512,"SP06.56","ME",2006,5,16,136,20,44.20352,-68.94645,2,0,2,2,0,"ME",16.96
"1847",512,"SP06.58","ME",2006,5,17,137,18,43.76772,-68.7844,4,1,3,3,1,"ME",13.932
"1848",512,"SP06.59","ME",2006,5,17,137,19,43.65187,-68.75542,1,1,0,1,0,"ME",14.383
"1849",513,"SP06.6","ME",2006,5,3,123,19,42.90967,-70.65717,33,19,14,23,10,"ME",15.029
"1850",512,"SP06.61","ME",2006,5,17,137,20,43.68112,-68.85435,3,3,0,3,0,"ME",15.54
"1851",512,"SP06.62","ME",2006,5,18,138,20,43.7839,-68.70683,4,3,1,4,0,"ME",16.16
"1852",512,"SP06.63","ME",2006,5,18,138,20,43.82395,-68.56152,3,0,3,3,0,"ME",15.76
"1853",512,"SP06.64","ME",2006,5,18,138,21,43.86165,-68.61,6,3,3,6,0,"ME",17.115
"1854",512,"SP06.65","ME",2006,5,18,138,20,43.88483,-68.75653,28,17,11,23,5,"ME",16.26
"1855",512,"SP06.66","ME",2006,5,18,138,20,43.98772,-68.74067,64,29,35,38,26,"ME",15.38
"1856",512,"SP06.67","ME",2006,5,19,139,10,44.13423,-68.7805,97,46,51,49,48,"ME",6.38
"1857",512,"SP06.68","ME",2006,5,19,139,20,44.14673,-68.75958,57,27,30,43,14,"ME",15.64
"1858",512,"SP06.69","ME",2006,5,22,142,20,44.16523,-68.53128,228,110,118,150,78,"ME",15.88
"1859",513,"SP06.7","ME",2006,5,3,123,20,42.88162,-70.60247,4,2,2,4,0,"ME",18.12
"1860",512,"SP06.70","ME",2006,5,22,142,20,44.06368,-68.4022,93,44,49,64,29,"ME",15.88
"1861",512,"SP06.71","ME",2006,5,22,142,20,44.03855,-68.4057,32,18,14,24,8,"ME",16.28
"1862",512,"SP06.72","ME",2006,5,23,143,20,43.90623,-68.45105,4,3,1,4,0,"ME",16.52
"1863",512,"SP06.73","ME",2006,5,23,143,20,43.91997,-68.40468,7,6,1,7,0,"ME",17.06
"1864",512,"SP06.74","ME",2006,5,23,143,20,43.9509,-68.4029333,1,0,1,1,0,"ME",17.2
"1865",512,"SP06.75","ME",2006,5,23,143,20,43.95378,-68.2801,2,1,1,2,0,"ME",16.2
"1866",512,"SP06.76","ME",2006,5,23,143,20,43.96013,-68.233,2,2,0,2,0,"ME",16.18
"1867",512,"SP06.77","ME",2006,5,23,143,20,44.01565,-68.19485,4,3,1,4,0,"ME",15.86
"1868",512,"SP06.78","ME",2006,5,24,144,20,44.36527,-68.54137,1,1,0,0,1,"ME",16.28
"1869",513,"SP06.8","ME",2006,5,3,123,20,42.92545,-70.50073,4,4,0,4,0,"ME",15.66
"1870",512,"SP06.80","ME",2006,5,24,144,20,44.27717,-68.46958,23,10,13,21,2,"ME",17.44
"1871",512,"SP06.81","ME",2006,5,24,144,20,44.20712,-68.30522,547,279,268,402,145,"ME",16.42
"1872",512,"SP06.82","ME",2006,5,25,145,20,44.21753,-68.06887,60,26,34,25,35,"ME",17.02
"1873",512,"SP06.83","ME",2006,5,25,145,20,44.18363,-68.09707,65,34,31,37,28,"ME",16.52
"1874",512,"SP06.84","ME",2006,5,25,145,20,44.20262,-68.01905,19,9,10,15,4,"ME",16.32
"1875",512,"SP06.85","ME",2006,5,25,145,20,44.16428,-67.95025,5,0,5,3,2,"ME",17
"1876",512,"SP06.86","ME",2006,5,25,145,20,44.0829,-68.03278,3,1,2,3,0,"ME",15.08
"1877",512,"SP06.87","ME",2006,5,25,145,20,44.06078,-68.03368,3,2,1,3,0,"ME",16.42
"1878",512,"SP06.88","ME",2006,5,26,146,20,44.46425,-68.20633,23,8,15,14,9,"ME",16.8
"1879",512,"SP06.89","ME",2006,5,26,146,20,44.42592,-68.15393,34,14,20,22,12,"ME",16.42
"1880",513,"SP06.9","ME",2006,5,3,123,20,42.90242,-70.46793,3,3,0,3,0,"ME",17.42
"1881",512,"SP06.90","ME",2006,5,26,146,17,44.29415,-68.05065,81,49,32,52,29,"ME",11.203
"1882",512,"SP06.91","ME",2006,5,26,146,20,44.28322,-68.12968,107,53,54,69,38,"ME",15.84
"1883",512,"SP06.92","ME",2006,5,29,149,20,44.26843,-67.94797,42,27,15,24,18,"ME",16.12
"1884",512,"SP06.93","ME",2006,5,29,149,17,44.2313,-67.94598,32,17,15,21,11,"ME",10.914
"1885",511,"SP06.94","ME",2006,5,29,149,20,44.33832,-67.74518,56,34,22,32,24,"ME",16.28
"1886",511,"SP06.95","ME",2006,5,29,149,20,44.4091,-67.68633,273,150,123,171,102,"ME",16.38
"1887",511,"SP06.96","ME",2006,5,30,150,20,44.20227,-67.72002,1,0,1,1,0,"ME",15.9
"1888",511,"SP06.97","ME",2006,5,30,150,20,44.23607,-67.66505,6,3,3,4,2,"ME",16.24
"1889",511,"SP06.98","ME",2006,5,30,150,20,44.29288,-67.51212,6,2,4,6,0,"ME",17.1
"1890",513,"SP07.1","ME",2007,5,7,127,20,42.93688,-70.7453,2,1,1,1,1,"ME",16.4
"1891",513,"SP07.10","ME",2007,5,8,128,20,43.07315,-70.53625,22,10,12,18,4,"ME",16.36
"1892",511,"SP07.100","ME",2007,6,7,158,20,44.41887,-67.46263,42,24,18,34,8,"ME",16.46
"1893",467,"SP07.101","ME",2007,6,8,159,20,44.7723,-66.96408,2,2,0,2,0,"ME",17
"1894",511,"SP07.102","ME",2007,6,8,159,20,44.72477,-67.07585,27,12,15,25,2,"ME",17.24
"1895",467,"SP07.103","ME",2007,6,8,159,20,44.71315,-66.95775,5,2,3,4,1,"ME",20.4
"1896",511,"SP07.104","ME",2007,6,8,159,19,44.63573,-67.06715,100,50,50,41,59,"ME",17.48
"1897",511,"SP07.105","ME",2007,6,9,160,20,44.6313,-67.32503,96,44,52,62,34,"ME",16.06
"1898",511,"SP07.106","ME",2007,6,9,160,20,44.58982,-67.29557,49,31,18,40,9,"ME",17.6
"1899",511,"SP07.107","ME",2007,6,9,160,20,44.53658,-67.43455,157,75,82,102,55,"ME",17.08
"1900",511,"SP07.108","ME",2007,6,9,160,20,44.5256,-67.48617,124,68,56,89,35,"ME",16.56
"1901",513,"SP07.11","ME",2007,5,9,129,20,43.11487,-70.42372,28,17,11,22,6,"ME",16.7
"1902",513,"SP07.12","ME",2007,5,9,129,20,43.15353,-70.3784,36,13,23,28,8,"ME",17.2
"1903",513,"SP07.13","ME",2007,5,9,129,20,43.1949,-70.42822,10,5,5,8,2,"ME",15.88
"1904",513,"SP07.14","ME",2007,5,9,129,20,43.32922,-70.50463,1,0,1,0,1,"ME",16.1
"1905",513,"SP07.15","ME",2007,5,9,129,20,43.42275,-70.28952,92,43,49,64,28,"ME",16.62
"1906",513,"SP07.16","ME",2007,5,10,130,20,43.24972,-70.1728,3,1,2,2,1,"ME",17.2
"1907",513,"SP07.17","ME",2007,5,10,130,20,43.32507,-70.1965,12,5,7,11,1,"ME",17.32
"1908",513,"SP07.18","ME",2007,5,10,130,20,43.40285,-70.13347,14,5,9,14,0,"ME",16.98
"1909",513,"SP07.19","ME",2007,5,10,130,20,43.44808,-70.1828,115,47,68,84,31,"ME",17.36
"1910",513,"SP07.2","ME",2007,5,7,127,20,42.87555,-70.73122,39,17,22,37,2,"ME",16.82
"1911",513,"SP07.20","ME",2007,5,10,130,20,43.41525,-70.23743,108,42,66,66,42,"ME",17.1
"1912",513,"SP07.21","ME",2007,5,11,131,20,43.42982,-70.31045,82,41,41,75,7,"ME",16.28
"1913",513,"SP07.22","ME",2007,5,11,131,20,43.51413,-70.34505,1,0,1,1,0,"ME",16.3
"1914",513,"SP07.23","ME",2007,5,11,131,20,43.5318,-70.25608,6,2,4,4,2,"ME",16.6
"1915",513,"SP07.24","ME",2007,5,11,131,20,43.505,-70.23898,49,24,25,25,24,"ME",15.66
"1916",513,"SP07.25","ME",2007,5,14,134,12,43.75002,-70.04833,136,67,69,97,39,"ME",10.092
"1917",513,"SP07.26","ME",2007,5,14,134,20,43.65977,-69.91297,132,77,55,60,72,"ME",17.2
"1918",513,"SP07.27","ME",2007,5,14,134,22,43.55537,-69.9942,29,15,14,18,11,"ME",19.404
"1919",513,"SP07.28","ME",2007,5,14,134,20,43.50213,-70.1089,42,25,17,25,17,"ME",17.36
"1920",513,"SP07.29","ME",2007,5,14,134,15,43.6277,-70.1264,63,32,31,55,8,"ME",6.795
"1921",513,"SP07.3","ME",2007,5,7,127,20,42.87195,-70.5712,5,2,3,5,0,"ME",16.46
"1922",513,"SP07.30","ME",2007,5,15,135,12,43.69918,-69.91648,98,36,62,64,34,"ME",5.892
"1923",513,"SP07.31","ME",2007,5,15,135,20,43.68358,-69.83345,34,14,20,27,7,"ME",16.12
"1924",513,"SP07.32","ME",2007,5,15,135,20,43.63222,-69.70155,18,13,5,16,2,"ME",17.16
"1925",513,"SP07.33","ME",2007,5,15,135,20,43.57293,-69.77228,3,2,1,3,0,"ME",16.28
"1926",513,"SP07.34","ME",2007,5,15,135,20,43.60803,-69.86385,45,21,24,22,23,"ME",15.86
"1927",513,"SP07.35","ME",2007,5,16,136,20,43.51513,-69.7135,4,3,1,4,0,"ME",16.48
"1928",513,"SP07.36","ME",2007,5,16,136,18,43.56378,-69.68587,2,1,1,2,0,"ME",13.248
"1929",513,"SP07.37","ME",2007,5,16,136,20,43.83922,-69.48475,169,92,77,75,94,"ME",16.76
"1930",513,"SP07.38","ME",2007,5,17,137,20,43.91583,-69.44682,110,49,61,46,64,"ME",15.78
"1931",513,"SP07.39","ME",2007,5,17,137,20,43.85307,-69.41365,142,66,76,75,67,"ME",18.5
"1932",513,"SP07.4","ME",2007,5,7,127,20,42.92358,-70.53308,13,3,10,12,1,"ME",16.4
"1933",512,"SP07.40","ME",2007,5,17,137,19,43.88457,-69.324,70,31,39,33,37,"ME",14.25
"1934",513,"SP07.41","ME",2007,5,17,137,20,43.80362,-69.36067,176,77,99,94,82,"ME",16
"1935",513,"SP07.42","ME",2007,5,17,137,20,43.69403,-69.50942,4,3,1,4,0,"ME",16.88
"1936",513,"SP07.43","ME",2007,5,18,138,17,43.70405,-69.80365,76,31,45,63,13,"ME",10.2
"1937",513,"SP07.44","ME",2007,5,18,138,20,43.68878,-69.65808,93,44,49,46,47,"ME",16.1
"1938",513,"SP07.45","ME",2007,5,18,138,12,43.75352,-69.62628,130,78,52,52,78,"ME",5.388
"1939",512,"SP07.46","ME",2007,5,21,141,17,43.7839,-69.23048,118,61,57,49,69,"ME",12.257
"1940",512,"SP07.47","ME",2007,5,21,141,20,43.75322,-69.14507,16,8,8,13,3,"ME",15.72
"1941",512,"SP07.48","ME",2007,5,21,141,20,43.8095,-69.03423,90,45,45,57,33,"ME",16.06
"1942",512,"SP07.49","ME",2007,5,21,141,20,43.92637,-69.12158,545,251,294,385,160,"ME",17.02
"1943",513,"SP07.5","ME",2007,5,7,127,20,42.95555,-70.49135,6,3,3,5,1,"ME",16.7
"1944",512,"SP07.50","ME",2007,5,22,142,19,44.1358,-68.94132,61,18,43,46,15,"ME",14.801
"1945",512,"SP07.51","ME",2007,5,22,142,23,44.24517,-68.90818,2,1,1,2,0,"ME",24.38
"1946",512,"SP07.53","ME",2007,5,22,142,20,44.26568,-68.99442,28,11,17,14,14,"ME",18.06
"1947",512,"SP07.54","ME",2007,5,22,142,18,44.16808,-69.04498,21,4,17,14,7,"ME",13.842
"1948",513,"SP07.55","ME",2007,5,23,143,20,43.61045,-69.042,5,2,3,5,0,"ME",16.28
"1949",512,"SP07.56","ME",2007,5,23,143,20,43.60752,-68.94287,5,4,1,5,0,"ME",16.72
"1950",512,"SP07.57","ME",2007,5,23,143,20,43.56867,-68.88452,6,5,1,5,1,"ME",15.72
"1951",512,"SP07.58","ME",2007,5,24,144,20,43.98842,-68.74398,332,151,181,164,168,"ME",16.9
"1952",512,"SP07.59","ME",2007,5,24,144,20,43.9649,-68.71817,96,54,42,75,21,"ME",15.58
"1953",513,"SP07.6","ME",2007,5,8,128,20,43.00962,-70.55122,25,9,16,19,6,"ME",17.18
"1954",512,"SP07.60","ME",2007,5,24,144,20,43.93045,-68.7997,75,37,38,51,24,"ME",16.06
"1955",512,"SP07.61","ME",2007,5,24,144,20,43.90325,-68.75642,44,21,23,39,5,"ME",16.72
"1956",512,"SP07.62","ME",2007,5,24,144,18,43.89913,-68.6647,25,11,14,20,5,"ME",13.644
"1957",512,"SP07.63","ME",2007,5,24,144,19,43.8501,-68.57938,7,3,4,7,0,"ME",14.288
"1958",512,"SP07.64","ME",2007,5,25,145,14,44.04863,-68.6724,176,98,78,106,70,"ME",8.484
"1959",512,"SP07.65","ME",2007,5,25,145,20,44.14697,-68.76097,154,81,73,121,33,"ME",17.24
"1960",512,"SP07.66","ME",2007,5,25,145,17,44.24663,-68.72398,14,4,10,12,2,"ME",12.206
"1961",512,"SP07.68","ME",2007,5,28,148,16,44.1588,-68.54185,134,59,75,103,31,"ME",10.56
"1962",512,"SP07.69","ME",2007,5,28,148,20,43.98653,-68.55183,76,40,36,59,17,"ME",16.8
"1963",513,"SP07.7","ME",2007,5,8,128,20,42.9846,-70.42235,2,1,1,2,0,"ME",16.88
"1964",512,"SP07.70","ME",2007,5,28,148,20,43.95292,-68.57682,30,16,14,28,2,"ME",17.1
"1965",512,"SP07.71","ME",2007,5,28,148,20,43.94475,-68.47435,2,2,0,2,0,"ME",15.98
"1966",512,"SP07.72","ME",2007,5,29,149,20,43.83162,-68.51708,2,2,0,2,0,"ME",15.78
"1967",512,"SP07.73","ME",2007,5,29,149,20,43.86625,-68.37307,1,1,0,1,0,"ME",15.56
"1968",512,"SP07.74","ME",2007,5,29,149,20,43.92275,-68.14313,11,10,1,11,0,"ME",15.94
"1969",512,"SP07.75","ME",2007,5,29,149,20,44.0175,-68.3475,24,14,10,19,5,"ME",16.58
"1970",512,"SP07.76","ME",2007,5,30,150,20,44.27767,-68.51917,6,2,4,5,1,"ME",16.98
"1971",512,"SP07.77","ME",2007,5,30,150,20,44.34797,-68.53837,1,1,0,1,0,"ME",16.6
"1972",512,"SP07.78","ME",2007,5,30,150,20,44.21642,-68.44343,75,38,37,58,17,"ME",17.76
"1973",512,"SP07.79","ME",2007,5,30,150,14,44.20725,-68.36587,75,27,48,57,18,"ME",7.476
"1974",512,"SP07.80","ME",2007,5,30,150,20,44.2423,-68.1323,205,103,102,57,148,"ME",19.38
"1975",512,"SP07.81","ME",2007,6,3,154,20,44.10262,-68.11232,28,13,15,15,13,"ME",15.92
"1976",512,"SP07.82","ME",2007,6,3,154,20,44.05447,-68.06138,7,6,1,7,0,"ME",17.26
"1977",512,"SP07.83","ME",2007,6,3,154,20,44.152,-67.90413,5,3,2,5,0,"ME",16.78
"1978",512,"SP07.84","ME",2007,6,3,154,20,44.2254,-68.07997,151,77,74,53,98,"ME",16.24
"1979",512,"SP07.85","ME",2007,6,3,154,20,44.2995,-68.12928,242,110,132,100,142,"ME",16.84
"1980",512,"SP07.86","ME",2007,6,4,155,20,44.44153,-68.2223,18,10,8,10,8,"ME",16.18
"1981",512,"SP07.87","ME",2007,6,4,155,20,44.36137,-68.16285,553,262,291,318,235,"ME",17.38
"1982",512,"SP07.88","ME",2007,6,4,155,16,44.35637,-68.11547,424,190,234,175,249,"ME",10.672
"1983",511,"SP07.89","ME",2007,6,6,157,13,44.473,-67.7596,277,149,128,155,122,"ME",6.89
"1984",513,"SP07.9","ME",2007,5,8,128,20,43.09153,-70.28658,2,1,1,2,0,"ME",17.42
"1985",511,"SP07.90","ME",2007,6,6,157,20,44.4536,-67.72208,390,216,174,284,106,"ME",16.88
"1986",511,"SP07.91","ME",2007,6,6,157,19,44.42198,-67.73778,286,132,154,163,123,"ME",14.668
"1987",511,"SP07.92","ME",2007,6,6,157,20,44.33032,-67.77152,77,42,35,49,28,"ME",16.38
"1988",511,"SP07.93","ME",2007,6,6,157,20,44.35987,-67.70575,66,31,35,47,19,"ME",16
"1989",511,"SP07.94","ME",2007,6,6,157,20,44.33997,-67.66302,24,10,14,24,0,"ME",16.38
"1990",511,"SP07.95","ME",2007,6,7,158,20,44.37887,-67.55063,66,43,23,48,18,"ME",17.24
"1991",511,"SP07.96","ME",2007,6,7,158,20,44.23553,-67.582,15,9,6,15,0,"ME",16.84
"1992",511,"SP07.97","ME",2007,6,7,158,20,44.24813,-67.48313,4,4,0,4,0,"ME",17.34
"1993",511,"SP07.98","ME",2007,6,7,158,20,44.29567,-67.50882,1,1,0,1,0,"ME",17.08
"1994",511,"SP07.99","ME",2007,6,7,158,14,44.3472,-67.50023,6,6,0,6,0,"ME",8.498
"1995",513,"SP08.1","ME",2008,5,5,126,20,42.87223,-70.57597,6,2,4,6,0,"ME",15.34
"1996",513,"SP08.10","ME",2008,5,7,128,20,43.09187,-70.30763,2,2,0,2,0,"ME",16.3
"1997",511,"SP08.100","ME",2008,6,3,155,20,44.2955,-67.60723,6,6,0,6,0,"ME",17.64
"1998",511,"SP08.101","ME",2008,6,4,156,18,44.32883,-67.62658,16,9,7,15,1,"ME",13.968
"1999",511,"SP08.102","ME",2008,6,4,156,20,44.42498,-67.54345,67,30,37,51,16,"ME",16.8
"2000",511,"SP08.103","ME",2008,6,4,156,20,44.41578,-67.5715,89,48,41,57,32,"ME",16.28
"2001",511,"SP08.104","ME",2008,6,4,156,20,44.46712,-67.72625,202,108,94,182,20,"ME",17.54
"2002",511,"SP08.105","ME",2008,6,5,157,20,44.58513,-67.30222,51,23,28,42,9,"ME",18.52
"2003",511,"SP08.106","ME",2008,6,5,157,20,44.62123,-67.2131,33,18,15,32,1,"ME",17.72
"2004",511,"SP08.107","ME",2008,6,5,157,20,44.65793,-67.16414,42,24,18,28,14,"ME",15.74
"2005",511,"SP08.108","ME",2008,6,5,157,20,44.62048,-67.17497,20,11,9,16,4,"ME",16.64
"2006",511,"SP08.109","ME",2008,6,6,158,20,44.72175,-67.07557,10,3,7,6,4,"ME",18.06
"2007",511,"SP08.110","ME",2008,6,6,158,20,44.71813,-67.09575,71,35,36,53,18,"ME",19.4
"2008",467,"SP08.111","ME",2008,6,6,158,15,44.69953,-66.96047,5,2,3,4,1,"ME",11.25
"2009",467,"SP08.112","ME",2008,6,6,158,20,44.6841,-66.99813,30,9,21,26,4,"ME",15.44
"2010",513,"SP08.12","ME",2008,5,7,128,20,43.21978,-70.19377,2,1,1,2,0,"ME",16.66
"2011",513,"SP08.13","ME",2008,5,7,128,20,43.15102,-70.24813,2,2,0,2,0,"ME",17.48
"2012",513,"SP08.14","ME",2008,5,7,128,20,43.14557,-70.38943,7,4,3,5,2,"ME",17.02
"2013",513,"SP08.15","ME",2008,5,7,128,17,43.17678,-70.43615,41,17,24,29,12,"ME",12.427
"2014",513,"SP08.16","ME",2008,5,8,129,17,43.3001,-70.54642,36,15,21,26,10,"ME",11.543
"2015",513,"SP08.17","ME",2008,5,8,129,16,43.2278,-70.31923,2,1,1,0,2,"ME",10.592
"2016",513,"SP08.18","ME",2008,5,8,129,11,43.25148,-70.2681,7,2,5,5,2,"ME",5.093
"2017",513,"SP08.19","ME",2008,5,8,129,16,43.28543,-70.28692,7,4,3,7,0,"ME",10.816
"2018",513,"SP08.2","ME",2008,5,5,126,20,42.90848,-70.65222,9,4,5,6,3,"ME",16.26
"2019",513,"SP08.20","ME",2008,5,8,129,19,43.32118,-70.33833,7,3,4,6,1,"ME",14.212
"2020",513,"SP08.21","ME",2008,5,9,130,18,43.40483,-70.13467,5,4,1,4,1,"ME",12.6
"2021",513,"SP08.22","ME",2008,5,9,130,20,43.43103,-70.28087,142,62,80,78,64,"ME",17.8
"2022",513,"SP08.23","ME",2008,5,9,130,20,43.46728,-70.3192,29,16,13,24,5,"ME",17.08
"2023",513,"SP08.24","ME",2008,5,9,130,20,43.51457,-70.24202,116,46,70,59,57,"ME",15.86
"2024",513,"SP08.25","ME",2008,5,9,130,20,43.52968,-70.27512,26,8,18,20,6,"ME",16.58
"2025",513,"SP08.26","ME",2008,5,12,133,20,43.77743,-70.02355,92,49,43,21,71,"ME",18.18
"2026",513,"SP08.27","ME",2008,5,12,133,20,43.66312,-70.07682,94,53,41,44,50,"ME",16.54
"2027",513,"SP08.3","ME",2008,5,5,126,20,42.94687,-70.67332,21,11,10,19,2,"ME",16.56
"2028",513,"SP08.30","ME",2008,5,13,134,20,43.57333,-69.93453,4,2,2,3,1,"ME",16.72
"2029",513,"SP08.31","ME",2008,5,13,134,20,43.60162,-69.87523,9,6,3,5,4,"ME",16.98
"2030",513,"SP08.32","ME",2008,5,13,134,20,43.60068,-69.7173,3,2,1,3,0,"ME",17.5
"2031",513,"SP08.33","ME",2008,5,14,135,17,43.62768,-69.59768,5,3,2,4,1,"ME",11.424
"2032",513,"SP08.34","ME",2008,5,14,135,18,43.68793,-69.65567,21,10,11,14,7,"ME",14.508
"2033",513,"SP08.35","ME",2008,5,14,135,20,43.70837,-69.74238,171,78,93,151,20,"ME",15.92
"2034",513,"SP08.36","ME",2008,5,14,135,20,43.71048,-69.77782,101,48,53,84,17,"ME",16.4
"2035",513,"SP08.37","ME",2008,5,15,136,20,43.95595,-69.37887,59,31,28,13,46,"ME",16.46
"2036",512,"SP08.38","ME",2008,5,15,136,20,43.88013,-69.32633,163,77,86,83,80,"ME",16.62
"2037",512,"SP08.39","ME",2008,5,15,136,15,43.83537,-69.3087,235,110,125,79,156,"ME",8.94
"2038",513,"SP08.4","ME",2008,5,5,126,20,42.93622,-70.74542,10,6,4,9,1,"ME",16.26
"2039",513,"SP08.41","ME",2008,5,15,136,20,43.83883,-69.48473,175,98,77,51,124,"ME",16.42
"2040",513,"SP08.42","ME",2008,5,16,137,20,43.77215,-69.4894,18,9,9,10,8,"ME",17.74
"2041",513,"SP08.43","ME",2008,5,16,137,17,43.71852,-69.45202,1,1,0,1,0,"ME",11.832
"2042",512,"SP08.47","ME",2008,5,19,140,17,43.83375,-69.0605,136,66,70,84,52,"ME",12.223
"2043",512,"SP08.48","ME",2008,5,19,140,20,43.9169,-69.13567,448,217,231,369,79,"ME",17.32
"2044",512,"SP08.49","ME",2008,5,19,140,20,43.94532,-69.16723,166,71,95,74,92,"ME",17.04
"2045",513,"SP08.5","ME",2008,5,6,127,20,42.97752,-70.64992,34,14,20,26,8,"ME",16.98
"2046",512,"SP08.50","ME",2008,5,19,140,20,44.11687,-69.05345,34,8,26,25,9,"ME",17.18
"2047",512,"SP08.51","ME",2008,5,20,141,14,44.2558,-68.8314,3,0,3,2,1,"ME",8.092
"2048",512,"SP08.52","ME",2008,5,20,141,20,44.21588,-68.91252,2,0,2,2,0,"ME",17.52
"2049",512,"SP08.53","ME",2008,5,20,141,20,44.18008,-68.9351,14,5,9,11,3,"ME",16.86
"2050",512,"SP08.54","ME",2008,5,20,141,20,44.08875,-68.9927,42,23,19,33,9,"ME",17.1
"2051",512,"SP08.55","ME",2008,5,21,142,20,43.7686,-69.15643,33,14,19,23,10,"ME",16.74
"2052",512,"SP08.58","ME",2008,5,21,142,20,43.62135,-68.84477,2,1,1,2,0,"ME",16.04
"2053",512,"SP08.59","ME",2008,5,22,143,20,43.76745,-68.72287,1,1,0,1,0,"ME",16.4
"2054",513,"SP08.6","ME",2008,5,6,127,17,42.93552,-70.45435,4,3,1,4,0,"ME",11.849
"2055",512,"SP08.60","ME",2008,5,22,143,20,43.88512,-68.663,17,12,5,12,5,"ME",17.04
"2056",512,"SP08.61","ME",2008,5,22,143,20,43.91555,-68.75467,36,21,15,21,15,"ME",17.16
"2057",512,"SP08.62","ME",2008,5,22,143,20,43.92453,-68.78793,54,29,25,42,12,"ME",16.88
"2058",512,"SP08.63","ME",2008,5,22,143,18,43.98737,-68.75372,373,166,207,181,192,"ME",12.798
"2059",512,"SP08.64","ME",2008,5,23,144,16,44.32042,-68.76465,2,1,1,2,0,"ME",10.048
"2060",512,"SP08.65","ME",2008,5,23,144,18,44.18097,-68.7643,71,34,37,61,10,"ME",13.806
"2061",512,"SP08.66","ME",2008,5,23,144,20,44.16498,-68.75955,274,133,141,222,52,"ME",16.9
"2062",512,"SP08.67","ME",2008,5,23,144,20,44.13383,-68.75623,228,93,135,185,43,"ME",16.22
"2063",512,"SP08.68","ME",2008,5,26,147,20,44.0194,-68.53987,251,126,125,134,117,"ME",16.7
"2064",512,"SP08.69","ME",2008,5,26,147,15,44.11057,-68.58803,73,33,40,46,27,"ME",9.84
"2065",513,"SP08.7","ME",2008,5,6,127,20,42.93783,-70.35403,2,2,0,2,0,"ME",16.34
"2066",512,"SP08.70","ME",2008,5,26,147,14,44.15392,-68.54533,61,24,37,24,37,"ME",8.148
"2067",512,"SP08.71","ME",2008,5,26,147,20,44.23295,-68.50747,113,44,69,88,25,"ME",16.1
"2068",512,"SP08.72","ME",2008,5,27,148,20,44.38957,-68.51485,2,0,2,2,0,"ME",16.32
"2069",512,"SP08.73","ME",2008,5,27,148,20,44.33042,-68.54772,3,0,3,2,1,"ME",17
"2070",512,"SP08.74","ME",2008,5,27,148,20,44.3078,-68.46873,7,2,5,6,1,"ME",15.54
"2071",512,"SP08.75","ME",2008,5,28,149,20,43.91263,-68.51948,1,1,0,1,0,"ME",16.84
"2072",512,"SP08.76","ME",2008,5,28,149,20,43.99407,-68.44078,11,5,6,10,1,"ME",17.02
"2073",512,"SP08.77","ME",2008,5,28,149,20,43.92078,-68.26047,3,3,0,3,0,"ME",17.78
"2074",512,"SP08.78","ME",2008,5,28,149,20,43.96118,-68.2348,4,4,0,4,0,"ME",17.58
"2075",512,"SP08.79","ME",2008,5,28,149,20,44.00618,-68.29982,6,3,3,4,2,"ME",16.78
"2076",513,"SP08.8","ME",2008,5,6,127,19,43.0035,-70.51002,5,2,3,5,0,"ME",15.029
"2077",512,"SP08.80","ME",2008,5,28,149,20,44.18445,-68.28335,151,69,82,115,36,"ME",16.12
"2078",512,"SP08.81","ME",2008,5,29,150,20,44.07423,-68.1212,15,9,6,12,3,"ME",16.46
"2079",512,"SP08.82","ME",2008,5,29,150,20,44.05808,-68.05215,1,1,0,1,0,"ME",16.64
"2080",512,"SP08.83","ME",2008,5,29,150,20,44.1199,-67.95312,15,8,7,12,3,"ME",16.52
"2081",512,"SP08.84","ME",2008,5,29,150,20,44.12592,-67.88135,6,3,3,6,0,"ME",15.6
"2082",512,"SP08.85","ME",2008,5,29,150,20,44.18437,-68.03487,17,9,8,13,4,"ME",15.6
"2083",512,"SP08.86","ME",2008,5,30,151,13,44.40797,-68.23335,30,17,13,27,3,"ME",6.578
"2084",512,"SP08.87","ME",2008,5,30,151,20,44.21763,-68.06902,52,27,25,19,33,"ME",16.2
"2085",512,"SP08.88","ME",2008,5,30,151,20,44.28763,-68.08597,352,189,163,202,150,"ME",18.14
"2086",512,"SP08.89","ME",2008,5,30,151,20,44.28563,-68.12987,85,32,53,33,52,"ME",17.34
"2087",513,"SP08.9","ME",2008,5,6,127,20,43.21268,-70.5714,41,17,24,29,12,"ME",16.64
"2088",511,"SP08.90","ME",2008,6,2,154,14,44.39133,-67.93002,932,448,484,697,235,"ME",8.75
"2089",511,"SP08.91","ME",2008,6,2,154,19,44.3604,-67.89378,342,179,163,286,56,"ME",14.763
"2090",511,"SP08.92","ME",2008,6,2,154,20,44.28617,-67.84013,28,14,14,24,4,"ME",17.22
"2091",511,"SP08.93","ME",2008,6,2,154,20,44.27445,-67.77885,8,3,5,7,1,"ME",16.48
"2092",511,"SP08.94","ME",2008,6,2,154,20,44.31452,-67.73667,5,2,3,5,0,"ME",18
"2093",511,"SP08.95","ME",2008,6,3,155,20,44.2331,-67.67477,5,4,1,5,0,"ME",17.16
"2094",511,"SP08.97","ME",2008,6,3,155,20,44.25388,-67.4584,1,1,0,1,0,"ME",16.7
"2095",511,"SP08.98","ME",2008,6,3,155,20,44.30073,-67.49645,3,2,1,3,0,"ME",17.2
"2096",511,"SP08.99","ME",2008,6,3,155,20,44.35488,-67.47117,6,2,4,6,0,"ME",18.22
"2097",513,"SP09.1","ME",2009,5,4,124,15,42.94808,-70.6007,30,13,17,24,6,"ME",10.035
"2098",513,"SP09.10","ME",2009,5,5,125,20,43.20703,-70.40545,62,28,34,39,23,"ME",17.46
"2099",511,"SP09.100","ME",2009,6,3,154,20,44.42348,-67.12935,6,3,3,5,1,"ME",16.28
"2100",511,"SP09.101","ME",2009,6,3,154,14,44.55155,-67.18302,64,32,32,49,15,"ME",7.854
"2101",511,"SP09.102","ME",2009,6,3,154,19,44.50255,-67.28778,38,25,13,37,1,"ME",15.371
"2102",511,"SP09.103","ME",2009,6,3,154,20,44.34835,-67.4238,2,2,0,2,0,"ME",13.86
"2103",511,"SP09.105","ME",2009,6,4,155,13,44.63972,-67.10353,82,39,43,69,13,"ME",7.072
"2104",511,"SP09.106","ME",2009,6,4,155,20,44.66328,-67.04928,211,116,95,110,101,"ME",16.34
"2105",467,"SP09.107","ME",2009,6,4,155,20,44.71062,-66.95472,20,7,13,14,6,"ME",17.3
"2106",511,"SP09.108","ME",2009,6,4,155,20,44.74402,-67.01045,17,9,8,14,3,"ME",18.66
"2107",511,"SP09.109","ME",2009,6,4,155,20,44.69947,-67.11623,50,24,26,44,6,"ME",18.12
"2108",513,"SP09.11","ME",2009,5,6,126,20,43.21963,-70.47925,43,26,17,26,17,"ME",15.12
"2109",511,"SP09.110","ME",2009,6,4,155,16,44.62383,-67.34987,27,13,14,24,3,"ME",10.768
"2110",511,"SP09.111","ME",2009,6,5,156,18,44.59318,-67.28942,41,20,21,40,1,"ME",11.79
"2111",511,"SP09.112","ME",2009,6,5,156,19,44.48088,-67.50875,230,115,115,117,113,"ME",14.592
"2112",513,"SP09.12","ME",2009,5,6,126,20,43.30322,-70.35112,84,45,39,63,21,"ME",17.24
"2113",513,"SP09.13","ME",2009,5,6,126,20,43.2969,-70.49487,27,9,18,24,3,"ME",16.42
"2114",513,"SP09.14","ME",2009,5,6,126,20,43.20023,-70.57428,44,25,19,35,9,"ME",16.5
"2115",513,"SP09.15","ME",2009,5,7,127,20,43.11498,-70.23658,5,4,1,4,1,"ME",15.82
"2116",513,"SP09.17","ME",2009,5,7,127,20,43.22682,-70.14993,2,1,1,2,0,"ME",15.6
"2117",513,"SP09.18","ME",2009,5,7,127,20,43.31007,-70.2639,24,7,17,23,1,"ME",16.78
"2118",513,"SP09.19","ME",2009,5,7,127,20,43.39283,-70.11852,9,5,4,9,0,"ME",15.32
"2119",513,"SP09.2","ME",2009,5,4,124,20,42.86992,-70.6838,23,15,8,12,11,"ME",16.94
"2120",513,"SP09.20","ME",2009,5,8,128,20,43.44522,-70.09122,2,0,2,1,1,"ME",16.4
"2121",513,"SP09.21","ME",2009,5,8,128,20,43.42295,-70.1475,9,3,6,9,0,"ME",16.06
"2122",513,"SP09.22","ME",2009,5,8,128,20,43.43102,-70.28135,219,96,123,143,76,"ME",16.06
"2123",513,"SP09.23","ME",2009,5,8,128,20,43.42937,-70.31115,572,286,286,537,35,"ME",15.46
"2124",513,"SP09.24","ME",2009,5,8,128,20,43.51343,-70.2425,31,13,18,21,10,"ME",16.12
"2125",513,"SP09.25","ME",2009,5,11,131,20,43.45877,-69.91387,1,1,0,1,0,"ME",17.1
"2126",513,"SP09.26","ME",2009,5,11,131,20,43.5147,-69.91857,1,1,0,1,0,"ME",16.3
"2127",513,"SP09.27","ME",2009,5,11,131,18,43.59272,-69.83887,7,3,4,5,2,"ME",12.978
"2128",513,"SP09.28","ME",2009,5,11,131,20,43.6018,-69.874,13,6,7,9,4,"ME",16.3
"2129",513,"SP09.29","ME",2009,5,11,131,20,43.64345,-69.85095,147,65,82,74,73,"ME",15.54
"2130",513,"SP09.3","ME",2009,5,4,124,16,42.90577,-70.8009,1,0,1,1,0,"ME",10.32
"2131",513,"SP09.30","ME",2009,5,11,131,20,43.66897,-70.12995,79,33,46,50,29,"ME",16.36
"2132",513,"SP09.31","ME",2009,5,12,132,17,43.657,-69.99948,199,124,75,144,55,"ME",12.903
"2133",513,"SP09.32","ME",2009,5,12,132,20,43.66693,-69.90622,124,64,60,68,56,"ME",16.06
"2134",513,"SP09.33","ME",2009,5,12,132,20,43.74682,-69.87613,65,33,32,38,27,"ME",16
"2135",513,"SP09.34","ME",2009,5,12,132,20,43.6832,-69.83588,139,65,74,117,22,"ME",16.92
"2136",513,"SP09.35","ME",2009,5,12,132,20,43.71088,-69.79963,376,169,207,329,47,"ME",16.04
"2137",513,"SP09.36","ME",2009,5,13,133,20,43.53515,-69.69738,3,2,1,3,0,"ME",17.26
"2138",513,"SP09.37","ME",2009,5,13,133,20,43.62702,-69.70725,5,3,2,5,0,"ME",16.18
"2139",513,"SP09.38","ME",2009,5,13,133,20,43.61467,-69.75978,11,7,4,7,4,"ME",16.62
"2140",513,"SP09.39","ME",2009,5,13,133,20,43.69727,-69.74743,722,376,346,630,92,"ME",15
"2141",513,"SP09.4","ME",2009,5,4,124,20,42.94137,-70.74868,13,6,7,11,2,"ME",15.74
"2142",513,"SP09.40","ME",2009,5,13,133,20,43.7294,-69.67748,149,83,66,63,86,"ME",15.62
"2143",513,"SP09.41","ME",2009,5,14,134,20,43.76753,-69.38557,59,37,22,44,15,"ME",14.16
"2144",513,"SP09.42","ME",2009,5,14,134,20,43.76583,-69.35513,36,24,12,20,16,"ME",16.08
"2145",513,"SP09.43","ME",2009,5,14,134,20,43.66087,-69.45023,2,2,0,2,0,"ME",15.8
"2146",513,"SP09.44","ME",2009,5,14,134,20,43.68265,-69.51292,1,1,0,1,0,"ME",15.6
"2147",513,"SP09.45","ME",2009,5,15,135,20,43.94817,-69.38513,270,118,152,110,160,"ME",15.62
"2148",513,"SP09.46","ME",2009,5,15,135,20,43.82792,-69.48813,225,98,127,70,155,"ME",16.34
"2149",513,"SP09.47","ME",2009,5,15,135,20,43.85607,-69.5312,177,77,100,92,85,"ME",15.82
"2150",512,"SP09.48","ME",2009,5,18,138,20,43.75238,-69.1444,11,8,3,9,2,"ME",16.42
"2151",512,"SP09.49","ME",2009,5,18,138,20,43.77592,-69.18305,48,27,21,25,23,"ME",16.1
"2152",513,"SP09.5","ME",2009,5,4,124,16,42.94447,-70.72508,29,23,6,22,7,"ME",10.256
"2153",512,"SP09.50","ME",2009,5,18,138,18,43.88,-69.03888,887,399,488,284,603,"ME",13.392
"2154",512,"SP09.51","ME",2009,5,18,138,20,43.92852,-69.1247,898,425,473,641,257,"ME",15.42
"2155",512,"SP09.52","ME",2009,5,18,138,20,43.96818,-69.13407,1825,774,1048,514,1311,"ME",16.64
"2156",512,"SP09.53","ME",2009,5,19,139,16,44.3138,-68.9234,35,12,23,18,17,"ME",10.016
"2157",512,"SP09.54","ME",2009,5,19,139,20,44.30397,-68.85533,2,1,1,2,0,"ME",17.58
"2158",512,"SP09.56","ME",2009,5,19,139,20,44.15968,-69.00918,42,8,34,27,15,"ME",16.42
"2159",512,"SP09.57","ME",2009,5,19,139,20,44.10773,-69.05172,100,52,48,68,32,"ME",16.06
"2160",512,"SP09.58","ME",2009,5,19,139,16,43.9863,-69.04072,771,331,440,409,362,"ME",11.008
"2161",512,"SP09.59","ME",2009,5,20,140,20,43.58013,-68.84427,11,10,1,11,0,"ME",15.06
"2162",513,"SP09.6","ME",2009,5,5,125,20,42.95508,-70.49445,15,7,8,14,1,"ME",15.8
"2163",512,"SP09.60","ME",2009,5,20,140,20,43.53575,-68.96582,1,1,0,1,0,"ME",15.8
"2164",512,"SP09.61","ME",2009,5,20,140,20,43.6165,-68.93742,1,0,1,1,0,"ME",16.3
"2165",512,"SP09.62","ME",2009,5,20,140,20,43.80022,-69.04253,49,25,24,30,19,"ME",15.72
"2166",512,"SP09.63","ME",2009,5,21,141,20,43.75802,-68.7269,6,3,3,6,0,"ME",15.08
"2167",512,"SP09.64","ME",2009,5,21,141,20,43.9022,-68.75742,57,27,30,34,23,"ME",15.88
"2168",512,"SP09.65","ME",2009,5,21,141,20,43.9338,-68.78892,43,22,21,24,19,"ME",14.9
"2169",512,"SP09.66","ME",2009,5,21,141,20,43.9535,-68.71552,86,40,46,49,37,"ME",15.42
"2170",512,"SP09.67","ME",2009,5,22,142,20,44.27478,-68.77707,3,2,1,2,1,"ME",16.44
"2171",512,"SP09.68","ME",2009,5,22,142,20,44.1723,-68.79888,25,13,12,19,6,"ME",16.28
"2172",512,"SP09.69","ME",2009,5,22,142,20,44.13373,-68.75568,102,51,51,77,25,"ME",15.24
"2173",513,"SP09.7","ME",2009,5,5,125,20,43.07937,-70.37507,5,3,2,5,0,"ME",16.88
"2174",512,"SP09.70","ME",2009,5,25,145,20,43.92945,-68.5532,10,5,5,10,0,"ME",17.06
"2175",512,"SP09.71","ME",2009,5,25,145,20,43.99647,-68.5548,72,34,38,42,30,"ME",17.12
"2176",512,"SP09.72","ME",2009,5,25,145,20,44.1524,-68.54443,192,111,81,116,76,"ME",17.34
"2177",512,"SP09.73","ME",2009,5,25,145,14,44.11027,-68.59047,141,65,76,74,67,"ME",8.078
"2178",512,"SP09.74","ME",2009,5,26,146,20,43.92048,-68.40632,2,1,1,2,0,"ME",16.66
"2179",512,"SP09.75","ME",2009,5,26,146,20,43.95307,-68.3165,5,1,4,5,0,"ME",16.28
"2180",512,"SP09.76","ME",2009,5,26,146,20,43.9997,-68.31843,3,2,1,3,0,"ME",17.88
"2181",512,"SP09.77","ME",2009,5,26,146,20,44.01205,-68.2577,3,1,2,3,0,"ME",14.52
"2182",512,"SP09.78","ME",2009,5,26,146,20,44.06612,-68.40143,152,66,85,101,51,"ME",16.4
"2183",512,"SP09.79","ME",2009,5,27,147,20,44.1482,-68.1062,99,52,47,36,63,"ME",14.86
"2184",513,"SP09.8","ME",2009,5,5,125,20,43.13108,-70.36783,11,5,6,11,0,"ME",16.36
"2185",512,"SP09.80","ME",2009,5,27,147,20,44.24532,-68.43072,132,54,78,75,57,"ME",17.06
"2186",512,"SP09.81","ME",2009,5,27,147,20,44.30055,-68.49838,71,31,40,20,51,"ME",16.94
"2187",512,"SP09.82","ME",2009,5,27,147,20,44.2902,-68.51975,30,14,16,14,16,"ME",17.16
"2188",512,"SP09.83","ME",2009,5,28,148,19,44.06915,-67.91995,2,1,1,2,0,"ME",14.668
"2189",512,"SP09.84","ME",2009,5,29,149,20,44.05823,-68.05292,9,4,5,9,0,"ME",16.28
"2190",512,"SP09.85","ME",2009,5,29,149,18,44.08988,-68.04638,3,3,0,3,0,"ME",12.69
"2191",512,"SP09.86","ME",2009,5,29,149,20,44.13018,-68.01992,11,5,6,11,0,"ME",15.72
"2192",512,"SP09.87","ME",2009,5,29,149,20,44.22622,-68.08192,94,37,57,30,64,"ME",15.26
"2193",512,"SP09.88","ME",2009,5,29,149,20,44.34427,-68.11493,341,168,173,85,256,"ME",16.46
"2194",512,"SP09.89","ME",2009,5,29,149,20,44.36095,-68.16337,694,304,390,298,396,"ME",16
"2195",513,"SP09.9","ME",2009,5,5,125,20,43.14762,-70.38918,14,7,7,13,1,"ME",15.78
"2196",512,"SP09.90","ME",2009,5,29,149,20,44.29683,-68.12913,364,172,192,100,264,"ME",16.22
"2197",511,"SP09.91","ME",2009,6,1,152,20,44.16278,-67.80695,1,0,1,1,0,"ME",17.32
"2198",511,"SP09.92","ME",2009,6,1,152,20,44.20568,-67.77017,1,1,0,1,0,"ME",15.92
"2199",511,"SP09.93","ME",2009,6,1,152,20,44.2631,-67.7895,11,4,7,8,3,"ME",16.4
"2200",511,"SP09.94","ME",2009,6,1,152,20,44.26567,-67.7372,2,2,0,2,0,"ME",16.76
"2201",511,"SP09.95","ME",2009,6,2,153,20,44.415,-67.56937,204,102,102,149,55,"ME",16.72
"2202",511,"SP09.96","ME",2009,6,2,153,20,44.3947,-67.53062,70,35,35,62,8,"ME",16.46
"2203",511,"SP09.97","ME",2009,6,2,153,10,44.37212,-67.66995,39,19,20,37,2,"ME",4.34
"2204",511,"SP09.98","ME",2009,6,2,153,15,44.46625,-67.7607,377,213,164,283,94,"ME",9.72
"2205",511,"SP09.99","ME",2009,6,2,153,20,44.45623,-67.72258,562,292,270,395,167,"ME",16.96
"2206",513,"SP10.1","ME",2010,5,3,123,20,42.8989,-70.5963,17,10,7,13,4,"ME",17.064
"2207",513,"SP10.10","ME",2010,5,4,124,20,43.15338,-70.37748,61,22,39,43,18,"ME",16.774
"2208",511,"SP10.100","ME",2010,5,31,151,20,44.42407,-67.79162,158,93,65,101,57,"ME",16.242
"2209",511,"SP10.101","ME",2010,6,1,152,20,44.46607,-67.726,487,269,218,313,174,"ME",16.5368
"2210",511,"SP10.102","ME",2010,6,1,152,20,44.3044,-67.68435,19,13,6,18,1,"ME",16.6472
"2211",511,"SP10.103","ME",2010,6,2,153,20,44.25372,-67.66887,4,3,1,4,0,"ME",14.7662
"2212",511,"SP10.104","ME",2010,6,2,153,20,44.22507,-67.50063,3,1,2,3,0,"ME",17.1676
"2213",511,"SP10.105","ME",2010,6,2,153,20,44.30008,-67.49858,8,6,2,8,0,"ME",15.6082
"2214",511,"SP10.106","ME",2010,6,2,153,20,44.2711,-67.57157,5,3,2,5,0,"ME",14.942
"2215",511,"SP10.107","ME",2010,6,2,153,20,44.32917,-67.5559,23,20,3,21,2,"ME",13.7754
"2216",511,"SP10.108","ME",2010,6,2,153,18,44.35445,-67.69398,49,24,25,44,5,"ME",14.1975
"2217",511,"SP10.109","ME",2010,6,3,154,20,44.51337,-67.5128,338,168,170,164,174,"ME",16.211
"2218",513,"SP10.11","ME",2010,5,5,125,20,43.2122,-70.57152,37,22,15,29,8,"ME",17.536
"2219",511,"SP10.110","ME",2010,6,3,154,20,44.49548,-67.41082,121,61,60,92,29,"ME",16.0956
"2220",511,"SP10.111","ME",2010,6,3,154,20,44.46232,-67.3695,60,31,29,49,11,"ME",16.5276
"2221",511,"SP10.112","ME",2010,6,3,154,20,44.57163,-67.28747,168,72,96,125,43,"ME",17.5512
"2222",511,"SP10.113","ME",2010,6,3,154,20,44.58492,-67.30907,65,34,31,62,3,"ME",16.7578
"2223",511,"SP10.114","ME",2010,6,3,154,20,44.63737,-67.3208,175,74,101,109,66,"ME",15.4328
"2224",467,"SP10.115","ME",2010,6,4,155,20,44.7084,-66.95567,31,18,13,24,7,"ME",18.5862
"2225",511,"SP10.116","ME",2010,6,4,155,20,44.64102,-67.1546,155,85,70,119,36,"ME",16.749
"2226",511,"SP10.117","ME",2010,6,4,155,20,44.62072,-67.09298,114,57,57,84,30,"ME",15.7956
"2227",513,"SP10.12","ME",2010,5,5,125,20,43.28108,-70.51855,138,62,76,103,35,"ME",16.436
"2228",513,"SP10.13","ME",2010,5,5,125,17,43.2909,-70.34665,50,28,22,36,14,"ME",11.2999
"2229",513,"SP10.14","ME",2010,5,5,125,20,43.34697,-70.21897,36,15,21,34,2,"ME",16.18
"2230",513,"SP10.15","ME",2010,5,5,125,20,43.43207,-70.28145,145,66,79,97,48,"ME",16.336
"2231",513,"SP10.16","ME",2010,5,6,126,20,43.39207,-70.11937,10,7,3,9,1,"ME",15.138
"2232",513,"SP10.18","ME",2010,5,6,126,20,43.32773,-70.10252,2,2,0,2,0,"ME",15.506
"2233",513,"SP10.19","ME",2010,5,6,126,20,43.41618,-70.08995,6,3,3,6,0,"ME",16.492
"2234",513,"SP10.2","ME",2010,5,3,123,20,43.0297,-70.43572,19,9,10,19,0,"ME",16.526
"2235",513,"SP10.20","ME",2010,5,7,127,20,43.47748,-70.21737,276,125,151,139,137,"ME",16.02
"2236",513,"SP10.21","ME",2010,5,7,127,20,43.51525,-70.2214,272,99,173,128,144,"ME",16.3
"2237",513,"SP10.22","ME",2010,5,7,127,20,43.5004,-70.36552,3,1,2,1,2,"ME",15.98
"2238",513,"SP10.23","ME",2010,5,7,127,20,43.53108,-70.27132,6,3,3,4,2,"ME",15.878
"2239",513,"SP10.24","ME",2010,5,10,130,20,43.56542,-69.95328,37,23,14,29,8,"ME",16.246
"2240",513,"SP10.25","ME",2010,5,10,130,20,43.51535,-69.91478,6,6,0,6,0,"ME",16.354
"2241",513,"SP10.26","ME",2010,5,10,130,20,43.4631,-69.78683,3,3,0,3,0,"ME",16.508
"2242",513,"SP10.27","ME",2010,5,10,130,20,43.60182,-69.87277,36,18,18,17,19,"ME",16.174
"2243",513,"SP10.28","ME",2010,5,11,131,20,43.72373,-70.16272,32,12,20,9,23,"ME",15.882
"2244",513,"SP10.29","ME",2010,5,11,131,20,43.77528,-70.06885,30,18,12,7,23,"ME",16.424
"2245",513,"SP10.3","ME",2010,5,3,123,20,42.98113,-70.66103,41,16,25,34,7,"ME",16.472
"2246",513,"SP10.30","ME",2010,5,11,131,20,43.68512,-69.94212,186,84,102,77,109,"ME",16.08734
"2247",513,"SP10.31","ME",2010,5,11,131,20,43.70533,-69.87033,104,52,52,87,17,"ME",15.352
"2248",513,"SP10.32","ME",2010,5,11,131,20,43.69858,-69.74625,210,85,125,190,20,"ME",16.33
"2249",513,"SP10.33","ME",2010,5,11,131,20,43.76007,-69.65595,176,76,100,66,110,"ME",16.128
"2250",513,"SP10.34","ME",2010,5,12,132,20,43.79062,-69.61455,219,117,102,59,160,"ME",16.232
"2251",513,"SP10.35","ME",2010,5,12,132,20,43.61471667,-69.76143,33,13,20,25,8,"ME",16.182
"2252",513,"SP10.36","ME",2010,5,12,132,20,43.54673,-69.69123,3,1,2,3,0,"ME",17.064
"2253",513,"SP10.37","ME",2010,5,12,132,20,43.68575,-69.65527,104,50,54,41,63,"ME",15.426
"2254",512,"SP10.38","ME",2010,5,13,133,20,43.8605,-69.27093,462,217,245,126,336,"ME",16.326
"2255",513,"SP10.39","ME",2010,5,13,133,20,43.95142,-69.38663,45,22,23,5,40,"ME",16.596
"2256",513,"SP10.4","ME",2010,5,3,123,20,42.87293,-70.71278,74,47,27,65,9,"ME",17.332
"2257",513,"SP10.40","ME",2010,5,13,133,20,43.9148,-69.44753,67,36,31,21,46,"ME",15.678
"2258",513,"SP10.41","ME",2010,5,13,133,17,43.88035,-69.46845,186,92,94,68,118,"ME",12.3896
"2259",513,"SP10.42","ME",2010,5,13,133,20,43.83852,-69.48493,227,106,121,78,149,"ME",16.838
"2260",513,"SP10.43","ME",2010,5,14,134,20,43.68517,-69.5133,11,7,4,7,4,"ME",16.132
"2261",513,"SP10.44","ME",2010,5,14,134,20,43.7571,-69.50222,44,20,24,23,21,"ME",16.24
"2262",513,"SP10.45","ME",2010,5,14,134,20,43.74877,-69.43323,37,18,19,24,13,"ME",17.194
"2263",513,"SP10.46","ME",2010,5,14,134,20,43.68642,-69.41705,4,4,0,3,1,"ME",16.72
"2264",513,"SP10.47","ME",2010,5,14,134,20,43.67627,-69.47137,3,1,2,3,0,"ME",16.002
"2265",512,"SP10.48","ME",2010,5,17,137,19,43.91668,-69.25082,173,75,98,45,128,"ME",14.0942
"2266",512,"SP10.49","ME",2010,5,17,137,20,43.85432,-69.11362,268,133,135,70,198,"ME",16.058
"2267",513,"SP10.5","ME",2010,5,3,123,20,42.92945,-70.75162,25,16,9,22,3,"ME",16.072
"2268",512,"SP10.50","ME",2010,5,17,137,20,43.8912,-69.08725,524,252,272,216,308,"ME",16.384
"2269",512,"SP10.51","ME",2010,5,17,137,20,43.91905,-69.13468,1225,623,602,695,530,"ME",16.3148
"2270",512,"SP10.52","ME",2010,5,17,137,20,43.9642,-69.13525,181,85,96,80,101,"ME",16.2232
"2271",512,"SP10.53","ME",2010,5,17,137,20,44.13078,-69.03955,286,139,147,111,175,"ME",16.9176
"2272",512,"SP10.54","ME",2010,5,18,138,20,43.7416,-69.16612,18,8,10,16,2,"ME",16.046
"2273",513,"SP10.55","ME",2010,5,18,138,20,43.64622,-69.1291,1,0,1,1,0,"ME",16.1458
"2274",513,"SP10.56","ME",2010,5,18,138,20,43.61075,-69.03827,2,1,1,2,0,"ME",16.4292
"2275",512,"SP10.57","ME",2010,5,18,138,20,43.53757,-68.96233,4,2,2,4,0,"ME",15.0226
"2276",512,"SP10.58","ME",2010,5,18,138,20,43.56598,-68.91415,4,4,0,4,0,"ME",15.3748
"2277",512,"SP10.59","ME",2010,5,18,138,20,43.60472,-68.94472,5,3,2,5,0,"ME",17.0216
"2278",513,"SP10.6","ME",2010,5,4,124,20,43.03322,-70.35338,10,6,4,10,0,"ME",16.47
"2279",512,"SP10.60","ME",2010,5,19,139,20,44.15565,-69.00583,228,99,129,118,110,"ME",15.7556
"2280",512,"SP10.61","ME",2010,5,19,139,20,44.24733,-68.87773,3,2,1,3,0,"ME",17.3218
"2281",512,"SP10.62","ME",2010,5,19,139,20,44.23033,-68.85783,29,11,18,17,12,"ME",16.4128
"2282",512,"SP10.64","ME",2010,5,20,140,20,43.76802,-68.65422,1,1,0,1,0,"ME",17.2398
"2283",512,"SP10.65","ME",2010,5,20,140,14,43.84545,-68.62808,7,5,2,6,1,"ME",8.456
"2284",512,"SP10.66","ME",2010,5,20,140,20,43.88492,-68.68762,63,40,23,39,24,"ME",16.7458
"2285",512,"SP10.67","ME",2010,5,20,140,20,43.90197,-68.65877,25,16,9,12,13,"ME",15.8828
"2286",512,"SP10.68","ME",2010,5,21,141,20,43.90215,-68.75712,99,52,47,44,55,"ME",16.2982
"2287",512,"SP10.69","ME",2010,5,21,141,20,43.95318,-68.71543,177,84,93,90,87,"ME",15.0376
"2288",513,"SP10.7","ME",2010,5,4,124,20,43.11183,-70.36847,16,8,8,16,0,"ME",17.002
"2289",512,"SP10.70","ME",2010,5,21,141,20,44.13393,-68.75683,208,82,126,146,62,"ME",16.5092
"2290",512,"SP10.71","ME",2010,5,21,141,20,44.1148,-68.78348,298,146,152,139,159,"ME",16.1882
"2291",512,"SP10.72","ME",2010,5,24,144,20,43.9332,-68.55272,10,8,2,8,2,"ME",17.4196
"2292",512,"SP10.73","ME",2010,5,24,144,18,43.86828,-68.49732,4,2,2,4,0,"ME",13.36806
"2293",512,"SP10.74","ME",2010,5,24,144,20,43.94248,-68.44712,6,5,1,5,1,"ME",16.581
"2294",512,"SP10.75","ME",2010,5,24,144,15,43.97762,-68.51785,54,25,29,25,29,"ME",9.1884
"2295",512,"SP10.76","ME",2010,5,24,144,20,44.02737,-68.54547,535,266,269,285,250,"ME",15.8866
"2296",512,"SP10.77","ME",2010,5,25,145,19,44.11262,-68.5835,726,401,325,329,397,"ME",14.33949
"2297",512,"SP10.78","ME",2010,5,25,145,19,44.15297,-68.54595,249,113,136,158,91,"ME",14.34101
"2298",512,"SP10.79","ME",2010,5,25,145,20,44.23197,-68.4612,237,107,130,69,168,"ME",16.0798
"2299",513,"SP10.8","ME",2010,5,4,124,18,43.1648,-70.30427,10,3,7,10,0,"ME",13.2318
"2300",512,"SP10.80","ME",2010,5,25,145,20,44.27423,-68.507,16,5,11,10,6,"ME",16.5262
"2301",512,"SP10.81","ME",2010,5,25,145,18,44.29305,-68.47855,10,2,8,9,1,"ME",13.48974
"2302",512,"SP10.82","ME",2010,5,26,146,20,44.00267,-68.2755,10,8,2,9,1,"ME",16.0696
"2303",512,"SP10.83","ME",2010,5,26,146,20,43.9528,-68.34942,12,12,0,12,0,"ME",16.0968
"2304",512,"SP10.84","ME",2010,5,26,146,20,43.89538,-68.29763,2,1,1,2,0,"ME",15.616
"2305",512,"SP10.85","ME",2010,5,26,146,20,44.05392,-68.06088,8,5,3,8,0,"ME",15.4896
"2306",512,"SP10.86","ME",2010,5,26,146,20,44.06527,-68.12453,9,4,5,7,2,"ME",16.3532
"2307",512,"SP10.87","ME",2010,5,27,147,20,44.12688,-67.9063,12,7,5,12,0,"ME",16.9128
"2308",512,"SP10.88","ME",2010,5,27,147,20,44.12867,-68.01215,12,11,1,12,0,"ME",17.0878
"2309",512,"SP10.89","ME",2010,5,27,147,20,44.12275,-68.04658,15,9,6,14,1,"ME",15.6544
"2310",513,"SP10.9","ME",2010,5,4,124,17,43.20583,-70.36192,27,10,17,21,6,"ME",11.1401
"2311",512,"SP10.90","ME",2010,5,27,147,20,44.20975,-68.03977,92,41,51,43,49,"ME",15.8416
"2312",512,"SP10.91","ME",2010,5,27,147,20,44.22262,-68.07405,156,68,88,64,92,"ME",15.8106
"2313",512,"SP10.92","ME",2010,5,27,147,20,44.23022,-68.13392,346,170,176,83,263,"ME",16.1014
"2314",512,"SP10.93","ME",2010,5,28,148,20,44.28752,-68.12958,374,183,191,111,263,"ME",16.6904
"2315",512,"SP10.94","ME",2010,5,28,148,20,44.40877,-68.23085,108,50,58,64,44,"ME",16.3816
"2316",512,"SP10.95","ME",2010,5,28,148,20,44.43592,-68.15257,123,64,59,68,55,"ME",14.7752
"2317",512,"SP10.96","ME",2010,5,28,148,20,44.37128,-68.15463,212,98,114,104,108,"ME",16.0952
"2318",511,"SP10.97","ME",2010,5,31,151,20,44.25213,-67.8497,42,20,22,32,10,"ME",16.1122
"2319",511,"SP10.98","ME",2010,5,31,151,19,44.19897,-67.8037,4,3,1,4,0,"ME",15.77779
"2320",511,"SP10.99","ME",2010,5,31,151,20,44.37928,-67.91157,365,190,175,234,131,"ME",16.0326
"2321",513,"SP11.1","ME",2011,5,2,122,19,42.95741667,-70.72121667,28,14,14,20,8,"ME",13.9346
"2322",513,"SP11.10","ME",2011,5,3,123,17,43.21823333,-70.33246667,23,11,12,19,4,"ME",11.7657
"2323",511,"SP11.100","ME",2011,5,31,151,18,44.34323333,-67.66053333,252,120,132,213,39,"ME",12.8466
"2324",511,"SP11.101","ME",2011,5,31,151,20,44.3743,-67.66326667,394,176,218,305,89,"ME",16.29
"2325",511,"SP11.102","ME",2011,5,31,151,20,44.45201667,-67.72166667,1767,997,770,1067,700,"ME",16.458
"2326",511,"SP11.103","ME",2011,5,31,151,19,44.46783333,-67.75886667,1080,618,462,645,435,"ME",14.4153
"2327",511,"SP11.104","ME",2011,6,1,152,20,44.25136667,-67.5907,13,12,1,13,0,"ME",17.46
"2328",511,"SP11.105","ME",2011,6,1,152,20,44.29418333,-67.50926667,17,12,5,17,0,"ME",17.016
"2329",511,"SP11.106","ME",2011,6,1,152,20,44.27948333,-67.50111667,6,5,1,6,0,"ME",15.44
"2330",511,"SP11.108","ME",2011,6,2,153,20,44.59683333,-67.43733333,98,40,58,71,27,"ME",15.738
"2331",511,"SP11.109","ME",2011,6,2,153,15,44.50315,-67.39588333,196,112,84,132,64,"ME",9.3225
"2332",513,"SP11.11","ME",2011,5,3,123,20,43.20593333,-70.28716667,29,15,14,28,1,"ME",15.968
"2333",511,"SP11.110","ME",2011,6,2,153,16,44.54353333,-67.41746667,240,136,104,155,85,"ME",10.032
"2334",511,"SP11.111","ME",2011,6,2,153,16,44.4327,-67.19261667,4,4,0,4,0,"ME",10.1376
"2335",511,"SP11.112","ME",2011,6,2,153,20,44.5904,-67.28596667,190,92,98,113,77,"ME",16.978
"2336",511,"SP11.113","ME",2011,6,3,154,20,44.55635,-67.18531667,99,49,50,57,42,"ME",16.308
"2337",467,"SP11.114","ME",2011,6,3,154,20,44.69733333,-66.963,64,28,36,40,24,"ME",18.238
"2338",511,"SP11.115","ME",2011,6,3,154,20,44.74413333,-67.00083333,41,17,24,29,12,"ME",16.054
"2339",511,"SP11.116","ME",2011,6,3,154,16,44.6553,-67.09048333,177,82,95,119,58,"ME",11.8688
"2340",513,"SP11.12","ME",2011,5,3,123,20,43.12105,-70.27086667,14,4,10,13,1,"ME",16.062
"2341",513,"SP11.13","ME",2011,5,3,123,20,43.02958333,-70.29916667,12,6,6,12,0,"ME",16.588
"2342",513,"SP11.14","ME",2011,5,4,124,20,43.20481667,-70.50151667,54,31,23,47,7,"ME",15.45
"2343",513,"SP11.15","ME",2011,5,4,124,20,43.2877,-70.5138,49,25,24,30,19,"ME",15.832
"2344",513,"SP11.16","ME",2011,5,4,124,19,43.25791667,-70.57745,3,1,2,0,3,"ME",14.6832
"2345",513,"SP11.17","ME",2011,5,5,125,20,43.33286667,-70.21293333,35,14,21,34,1,"ME",16.09
"2346",513,"SP11.18","ME",2011,5,5,125,20,43.30883333,-70.1421,10,5,5,9,1,"ME",15.222
"2347",513,"SP11.19","ME",2011,5,5,125,20,43.40195,-70.12961667,32,14,18,29,3,"ME",15.25
"2348",513,"SP11.2","ME",2011,5,2,122,20,42.92916667,-70.75375,21,7,14,19,2,"ME",13.416
"2349",513,"SP11.20","ME",2011,5,5,125,20,43.4584,-70.08235,33,18,15,28,5,"ME",16.368
"2350",513,"SP11.21","ME",2011,5,6,126,20,43.473,-70.23015,153,57,96,72,81,"ME",16.332
"2351",513,"SP11.22","ME",2011,5,6,126,20,43.43021667,-70.28296667,148,68,80,88,60,"ME",14.852
"2352",513,"SP11.23","ME",2011,5,6,126,20,43.52238333,-70.292,6,0,6,5,1,"ME",16.204
"2353",513,"SP11.24","ME",2011,5,6,126,20,43.5076,-70.23456667,298,136,162,152,146,"ME",16.52
"2354",513,"SP11.25","ME",2011,5,9,129,20,43.72686667,-70.15591667,17,4,13,13,4,"ME",16.31
"2355",513,"SP11.26","ME",2011,5,9,129,20,43.77875,-70.02571667,25,12,13,10,15,"ME",16.1
"2356",513,"SP11.27","ME",2011,5,9,129,20,43.65258333,-70.05568333,666,336,330,345,321,"ME",16.396
"2357",513,"SP11.28","ME",2011,5,9,129,20,43.68705,-70.13428333,55,17,38,40,15,"ME",16.96
"2358",513,"SP11.29","ME",2011,5,9,129,20,43.64895,-70.16736667,55,17,38,48,7,"ME",17.012
"2359",513,"SP11.3","ME",2011,5,2,122,20,42.94166667,-70.65793333,91,48,43,40,51,"ME",17.116
"2360",513,"SP11.30","ME",2011,5,11,131,20,43.4829,-69.96265,6,4,2,6,0,"ME",16.744
"2361",513,"SP11.31","ME",2011,5,11,131,20,43.49751667,-69.91913333,8,6,2,6,2,"ME",15.69
"2362",513,"SP11.32","ME",2011,5,11,131,20,43.54468333,-69.95508333,25,14,11,20,5,"ME",17.22
"2363",513,"SP11.33","ME",2011,5,11,131,20,43.59986667,-69.87653333,46,28,18,26,20,"ME",15.504
"2364",513,"SP11.34","ME",2011,5,11,131,20,43.587,-69.81035,25,15,10,24,1,"ME",17.192
"2365",513,"SP11.35","ME",2011,5,11,131,20,43.62356667,-69.76091667,71,30,41,54,17,"ME",15.486
"2366",513,"SP11.36","ME",2011,5,11,131,20,43.7066,-69.69331667,273,138,135,107,166,"ME",17.06
"2367",513,"SP11.37","ME",2011,5,12,132,20,43.69498333,-69.74846667,257,126,131,216,41,"ME",15.708
"2368",513,"SP11.38","ME",2011,5,12,132,20,43.75298333,-69.7347,149,69,80,101,48,"ME",17.558
"2369",513,"SP11.39","ME",2011,5,12,132,20,43.77771667,-69.69993333,260,123,137,99,161,"ME",16.996
"2370",513,"SP11.4","ME",2011,5,2,122,20,42.89141667,-70.47473333,3,1,2,3,0,"ME",14.158
"2371",513,"SP11.40","ME",2011,5,12,132,20,43.80461667,-69.6434,186,78,108,58,128,"ME",16.376
"2372",513,"SP11.41","ME",2011,5,13,133,20,43.69556667,-69.51165,31,13,18,23,8,"ME",17.73
"2373",513,"SP11.42","ME",2011,5,13,133,20,43.66498333,-69.40155,7,5,2,6,1,"ME",16.686
"2374",513,"SP11.43","ME",2011,5,13,133,20,43.66796667,-69.44191667,16,9,7,15,1,"ME",16.888
"2375",513,"SP11.44","ME",2011,5,13,133,16,43.72911667,-69.45118333,49,23,26,39,10,"ME",10.7616
"2376",513,"SP11.45","ME",2011,5,13,133,20,43.76376667,-69.50495,143,68,75,59,84,"ME",15.266
"2377",513,"SP11.46","ME",2011,5,13,133,20,43.83995,-69.48305,294,161,133,84,210,"ME",15.486
"2378",513,"SP11.47","ME",2011,5,13,133,20,43.81593333,-69.3514,531,263,268,174,357,"ME",16.492
"2379",513,"SP11.48","ME",2011,5,13,133,20,43.76465,-69.35695,194,88,106,128,66,"ME",17.2
"2380",512,"SP11.49","ME",2011,5,16,136,17,43.91413333,-69.13941667,463,227,236,222,241,"ME",8.8774
"2381",513,"SP11.5","ME",2011,5,2,122,20,42.93595,-70.48696667,9,6,3,9,0,"ME",17.486
"2382",512,"SP11.50","ME",2011,5,17,137,20,44.17216667,-68.94283333,120,40,80,89,31,"ME",16.36
"2383",512,"SP11.51","ME",2011,5,17,137,20,44.32571667,-68.84503333,6,1,5,5,1,"ME",17.868
"2384",512,"SP11.52","ME",2011,5,17,137,20,44.27415,-68.78,4,2,2,4,0,"ME",16.62
"2385",512,"SP11.53","ME",2011,5,17,137,20,44.22383333,-68.92608333,46,18,28,36,10,"ME",18.132
"2386",512,"SP11.54","ME",2011,5,17,137,16,44.19101667,-68.997,47,13,34,24,23,"ME",11.384
"2387",512,"SP11.55","ME",2011,5,17,137,20,44.09773333,-68.99855,373,173,200,304,69,"ME",17.36
"2388",512,"SP11.56","ME",2011,5,18,138,20,43.87423333,-69.03536667,1298,631,667,274,1024,"ME",16.806
"2389",512,"SP11.57","ME",2011,5,18,138,17,43.84803333,-69.05981667,508,232,275,152,356,"ME",12.5188
"2390",512,"SP11.58","ME",2011,5,18,138,20,43.77908333,-69.11186667,134,65,69,70,64,"ME",16.134
"2391",512,"SP11.59","ME",2011,5,18,138,20,43.73196667,-69.08555,56,28,28,37,19,"ME",15.16
"2392",513,"SP11.6","ME",2011,5,2,122,20,42.98473333,-70.42665,16,11,5,14,2,"ME",16.14
"2393",512,"SP11.60","ME",2011,5,18,138,20,43.6173,-68.93696667,8,3,5,7,1,"ME",16.526
"2394",512,"SP11.61","ME",2011,5,18,138,20,43.57685,-68.87301667,5,3,2,5,0,"ME",16.652
"2395",512,"SP11.62","ME",2011,5,18,138,20,43.68185,-68.8571,20,14,6,17,3,"ME",16.624
"2396",512,"SP11.63","ME",2011,5,19,139,20,43.91728333,-68.7547,320,133,187,175,145,"ME",15.296
"2397",512,"SP11.64","ME",2011,5,19,139,16,43.76575,-68.7243,18,9,9,12,6,"ME",10.496
"2398",512,"SP11.65","ME",2011,5,19,139,20,43.74103333,-68.6346,3,3,0,3,0,"ME",16.092
"2399",512,"SP11.66","ME",2011,5,19,139,15,43.80625,-68.59221667,4,3,1,4,0,"ME",8.2215
"2400",512,"SP11.67","ME",2011,5,19,139,16,43.8532,-68.62548333,39,25,14,31,8,"ME",10.4384
"2401",512,"SP11.68","ME",2011,5,19,139,20,43.8892,-68.67986667,141,74,67,53,88,"ME",15.726
"2402",512,"SP11.69","ME",2011,5,20,140,19,44.12156667,-68.77375,843,401,442,418,425,"ME",13.4444
"2403",513,"SP11.7","ME",2011,5,3,123,20,43.08105,-70.4829,60,31,29,51,9,"ME",16.418
"2404",512,"SP11.70","ME",2011,5,20,140,21,44.15053333,-68.7622,453,206,247,334,119,"ME",17.703
"2405",512,"SP11.71","ME",2011,5,20,140,20,44.1521,-68.73086667,460,208,252,222,238,"ME",16.24
"2406",512,"SP11.72","ME",2011,5,23,143,20,43.94153333,-68.55501667,132,63,69,71,61,"ME",16.368
"2407",512,"SP11.73","ME",2011,5,23,143,20,43.99595,-68.4346,150,78,72,94,56,"ME",15.2
"2408",512,"SP11.74","ME",2011,5,23,143,19,44.0063,-68.40033333,152,55,97,95,57,"ME",15.5971
"2409",512,"SP11.75","ME",2011,5,23,143,20,44.02843333,-68.54411667,1082,555,527,437,645,"ME",16.302
"2410",512,"SP11.76","ME",2011,5,23,143,20,44.16485,-68.53345,403,217,186,323,80,"ME",15.786
"2411",512,"SP11.77","ME",2011,5,24,144,17,44.31755,-68.54426667,6,4,2,5,1,"ME",11.1146
"2412",512,"SP11.78","ME",2011,5,24,144,10,44.26018333,-68.4827,327,151,176,274,53,"ME",3.946
"2413",512,"SP11.79","ME",2011,5,24,144,15,44.2173,-68.44406667,716,359,357,367,349,"ME",9.303
"2414",513,"SP11.8","ME",2011,5,3,123,20,43.07878333,-70.4147,35,13,22,33,2,"ME",15.98
"2415",512,"SP11.80","ME",2011,5,25,145,21,43.90753333,-68.36436667,10,7,3,10,0,"ME",16.4115
"2416",512,"SP11.81","ME",2011,5,25,145,20,43.8805,-68.29565,10,5,5,10,0,"ME",16.108
"2417",512,"SP11.82","ME",2011,5,25,145,17,43.9608,-68.23351667,12,11,1,12,0,"ME",11.6076
"2418",512,"SP11.83","ME",2011,5,25,145,20,43.92221667,-68.14076667,7,6,1,6,1,"ME",16.744
"2419",512,"SP11.84","ME",2011,5,25,145,20,44.04761667,-68.25903333,136,66,70,114,22,"ME",16.186
"2420",512,"SP11.85","ME",2011,5,26,146,20,44.40721667,-68.23116667,179,79,100,111,68,"ME",17.044
"2421",512,"SP11.86","ME",2011,5,26,146,15,44.31463333,-68.08646667,626,293,333,182,444,"ME",9.048
"2422",512,"SP11.87","ME",2011,5,26,146,20,44.21743333,-68.06821667,205,105,100,90,115,"ME",16.206
"2423",512,"SP11.88","ME",2011,5,26,146,20,44.2402,-68.13408333,635,309,325,152,483,"ME",16.536
"2424",512,"SP11.89","ME",2011,5,26,146,16,44.2833,-68.19778333,377,190,187,189,188,"ME",9.4544
"2425",513,"SP11.9","ME",2011,5,3,123,20,43.154,-70.3775,61,22,39,46,15,"ME",16.578
"2426",512,"SP11.90","ME",2011,5,26,146,20,44.28426667,-68.13081667,250,126,124,94,156,"ME",17.176
"2427",512,"SP11.91","ME",2011,5,27,147,20,44.12453333,-68.0194,46,20,26,41,5,"ME",15.878
"2428",512,"SP11.92","ME",2011,5,27,147,20,44.13611667,-67.91221667,38,24,14,37,1,"ME",15.728
"2429",512,"SP11.93","ME",2011,5,27,147,20,44.05915,-68.05206667,17,10,7,15,2,"ME",18.026
"2430",512,"SP11.94","ME",2011,5,27,147,20,44.05865,-68.12893333,73,36,37,60,13,"ME",16.222
"2431",511,"SP11.95","ME",2011,5,30,150,20,44.31705,-67.85721667,688,340,348,405,283,"ME",16.43
"2432",511,"SP11.96","ME",2011,5,30,150,20,44.26071667,-67.81406667,103,55,48,75,28,"ME",16.124
"2433",511,"SP11.97","ME",2011,5,30,150,20,44.19795,-67.74381667,8,7,1,8,0,"ME",14.882
"2434",511,"SP11.98","ME",2011,5,30,150,18,44.38825,-67.75543333,310,156,154,173,137,"ME",12.8214
"2435",511,"SP11.99","ME",2011,5,31,151,20,44.398,-67.52698333,109,50,59,87,22,"ME",16.168
"2436",513,"SP12.1","ME",2012,4,30,121,20,42.93807,-70.74302,4,4,0,4,0,"ME",16.402
"2437",513,"SP12.10","ME",2012,5,2,123,20,42.97613,-70.31823,2,1,1,2,0,"ME",16.174
"2438",511,"SP12.100","ME",2012,5,28,149,15,44.45213,-67.72067,742,444,298,502,240,"ME",9.9315
"2439",511,"SP12.101","ME",2012,5,29,150,20,44.32087,-67.72367,130,65,65,121,9,"ME",16.818
"2440",511,"SP12.102","ME",2012,5,29,150,19,44.3028,-67.697,66,40,26,63,3,"ME",15.5952
"2441",511,"SP12.103","ME",2012,5,29,150,20,44.23398,-67.78367,44,28,16,41,3,"ME",16.262
"2442",511,"SP12.104","ME",2012,5,29,150,20,44.17338,-67.7504,5,3,2,5,0,"ME",16.216
"2443",511,"SP12.105","ME",2012,5,30,151,20,44.27195,-67.57958,31,28,3,31,0,"ME",14.842
"2444",511,"SP12.106","ME",2012,5,30,151,20,44.29822,-67.50215,32,22,10,32,0,"ME",17.93
"2445",511,"SP12.107","ME",2012,5,30,151,20,44.2959,-67.40832,4,4,0,4,0,"ME",15.674
"2446",511,"SP12.108","ME",2012,5,30,151,15,44.434,-67.55777,127,77,50,77,50,"ME",8.6565
"2447",511,"SP12.109","ME",2012,5,31,152,20,44.43312,-67.19447,3,3,0,3,0,"ME",16.74
"2448",513,"SP12.11","ME",2012,5,2,123,20,43.00038,-70.33345,2,0,2,2,0,"ME",15.6
"2449",511,"SP12.110","ME",2012,5,31,152,15,44.43018,-67.14585,8,4,4,8,0,"ME",9.612
"2450",511,"SP12.111","ME",2012,5,31,152,15,44.52302,-67.25317,80,44,36,69,11,"ME",10.275
"2451",511,"SP12.112","ME",2012,5,31,152,16,44.527,-67.3043,91,50,41,65,26,"ME",11.504
"2452",511,"SP12.113","ME",2012,5,31,152,20,44.59002,-67.46902,355,171,184,286,69,"ME",16.072
"2453",511,"SP12.114","ME",2012,5,31,152,20,44.58393,-67.30932,183,95,88,141,42,"ME",17.322
"2454",511,"SP12.115","ME",2012,5,31,152,20,44.62422,-67.3322,367,160,207,232,135,"ME",17.092
"2455",467,"SP12.116","ME",2012,6,1,153,20,44.69875,-66.99852,251,122,129,137,114,"ME",15.678
"2456",467,"SP12.117","ME",2012,6,1,153,16,44.70848,-66.9573,118,62,56,83,35,"ME",10.0736
"2457",467,"SP12.118","ME",2012,6,1,153,20,44.76877,-66.97087,31,16,15,28,3,"ME",22.876
"2458",467,"SP12.119","ME",2012,6,1,153,10,44.80467,-66.94837,60,32,28,29,31,"ME",4.587
"2459",513,"SP12.12","ME",2012,5,2,123,20,43.05563,-70.34848,11,4,7,11,0,"ME",16.626
"2460",513,"SP12.13","ME",2012,5,2,123,16,43.0317,-70.38823,12,7,5,11,1,"ME",10.528
"2461",513,"SP12.14","ME",2012,5,3,124,20,43.19677,-70.58083,44,20,24,35,9,"ME",16.486
"2462",513,"SP12.15","ME",2012,5,3,124,20,43.24245,-70.50392,204,72,132,112,92,"ME",15.728
"2463",513,"SP12.16","ME",2012,5,3,124,15,43.15028,-70.38447,51,21,30,39,12,"ME",8.6415
"2464",513,"SP12.17","ME",2012,5,3,124,20,43.17993,-70.2707,16,10,6,16,0,"ME",16.276
"2465",513,"SP12.18","ME",2012,5,3,124,15,43.20017,-70.29597,15,6,9,13,2,"ME",8.577
"2466",513,"SP12.19","ME",2012,5,3,124,15,43.41017,-70.23888,140,58,82,88,52,"ME",8.337
"2467",513,"SP12.2","ME",2012,4,30,121,20,42.9049,-70.80092,1,1,0,0,1,"ME",16.38
"2468",513,"SP12.20","ME",2012,5,4,125,18,43.4472,-70.18472,142,58,84,101,41,"ME",13.1274
"2469",513,"SP12.21","ME",2012,5,4,125,20,43.43275,-70.15632,64,31,33,54,10,"ME",16.236
"2470",513,"SP12.22","ME",2012,5,4,125,20,43.39543,-70.12248,53,31,22,51,2,"ME",16.342
"2471",513,"SP12.23","ME",2012,5,4,125,16,43.42205,-70.29055,166,80,86,79,87,"ME",10.0992
"2472",513,"SP12.24","ME",2012,5,4,125,20,43.52203,-70.31553,8,2,6,5,3,"ME",16.428
"2473",513,"SP12.25","ME",2012,5,7,128,20,43.58528,-69.94103,55,34,21,27,28,"ME",16.568
"2474",513,"SP12.26","ME",2012,5,7,128,20,43.54512,-69.91852,24,12,12,21,3,"ME",15.75
"2475",513,"SP12.27","ME",2012,5,7,128,20,43.60895,-69.8652,78,26,52,45,33,"ME",16.816
"2476",513,"SP12.28","ME",2012,5,7,128,20,43.6592,-69.8619,123,74,49,98,25,"ME",15.616
"2477",513,"SP12.29","ME",2012,5,7,128,20,43.76322,-69.88013,77,34,43,25,52,"ME",16.502
"2478",513,"SP12.3","ME",2012,4,30,121,20,42.93147,-70.70722,83,33,50,49,34,"ME",16.776
"2479",513,"SP12.30","ME",2012,5,7,128,20,43.70387,-69.93973,583,304,279,279,304,"ME",17.384
"2480",513,"SP12.31","ME",2012,5,7,128,17,43.65782,-69.99757,249,140,109,133,116,"ME",11.1231
"2481",513,"SP12.32","ME",2012,5,8,129,20,43.46183,-69.78563,6,3,3,5,1,"ME",16.916
"2482",513,"SP12.33","ME",2012,5,8,129,20,43.54075,-69.69388,13,7,6,11,2,"ME",16.422
"2483",513,"SP12.34","ME",2012,5,8,129,20,43.55777,-69.78697,12,9,3,11,1,"ME",16.624
"2484",513,"SP12.35","ME",2012,5,9,130,20,43.69457,-69.74748,624,318,306,452,172,"ME",16.04
"2485",513,"SP12.36","ME",2012,5,9,130,20,43.68902,-69.65645,192,86,106,81,111,"ME",15.798
"2486",513,"SP12.37","ME",2012,5,9,130,16,43.76002,-69.65613,326,174,152,92,234,"ME",9.5712
"2487",513,"SP12.38","ME",2012,5,10,131,20,43.56715,-69.55548,6,3,3,5,1,"ME",16.288
"2488",513,"SP12.39","ME",2012,5,10,131,18,43.66627,-69.40112,22,13,9,21,1,"ME",12.6918
"2489",513,"SP12.4","ME",2012,4,30,121,20,42.98668,-70.65218,40,23,17,27,13,"ME",16.3
"2490",513,"SP12.40","ME",2012,5,10,131,20,43.76655,-69.35492,276,132,144,168,108,"ME",17.126
"2491",513,"SP12.41","ME",2012,5,10,131,20,43.68382,-69.51273,50,29,21,33,17,"ME",16.546
"2492",513,"SP12.42","ME",2012,5,10,131,20,43.77997,-69.50033,119,56,63,64,55,"ME",17.044
"2493",513,"SP12.43","ME",2012,5,11,132,18,43.86188,-69.53707,480,232,248,150,330,"ME",12.9708
"2494",513,"SP12.44","ME",2012,5,11,132,20,43.8338,-69.48517,320,141,179,89,231,"ME",15.604
"2495",513,"SP12.45","ME",2012,5,11,132,20,43.91462,-69.44937,818,376,442,282,536,"ME",15.06
"2496",513,"SP12.46","ME",2012,5,11,132,20,43.9602,-69.3798,69,40,29,16,53,"ME",16.384
"2497",512,"SP12.47","ME",2012,5,11,132,20,43.86033,-69.27055,800,361,439,378,422,"ME",17.118
"2498",512,"SP12.48","ME",2012,5,14,135,20,43.75127,-69.1476,99,56,43,56,43,"ME",16.228
"2499",512,"SP12.49","ME",2012,5,14,135,20,43.77482,-69.18028,528,254,274,167,361,"ME",16.278
"2500",513,"SP12.5","ME",2012,4,30,121,17,43.00483,-70.70013,5,1,4,4,1,"ME",11.39
"2501",512,"SP12.50","ME",2012,5,14,135,17,43.7798,-69.14577,211,110,101,84,127,"ME",11.4087
"2502",512,"SP12.51","ME",2012,5,14,135,15,43.82372,-69.10665,205,105,100,67,138,"ME",9.108
"2503",512,"SP12.52","ME",2012,5,14,135,20,43.87385,-69.08352,386,181,205,105,281,"ME",15.026
"2504",512,"SP12.53","ME",2012,5,14,135,20,43.87475,-69.03518,1087,556,531,211,876,"ME",17.374
"2505",512,"SP12.54","ME",2012,5,14,135,20,43.92087,-69.13235,1125,573,552,300,825,"ME",16.65
"2506",512,"SP12.55","ME",2012,5,15,136,20,44.19005,-68.92385,358,147,211,254,104,"ME",16.312
"2507",512,"SP12.56","ME",2012,5,15,136,20,44.22617,-68.85675,150,47,103,97,53,"ME",16.256
"2508",512,"SP12.57","ME",2012,5,15,136,15,44.27483,-68.77675,3,1,2,3,0,"ME",8.4795
"2509",512,"SP12.58","ME",2012,5,15,136,15,44.29653,-68.80072,2,0,2,2,0,"ME",8.0325
"2510",512,"SP12.59","ME",2012,5,15,136,20,44.20237,-69.02463,191,80,111,105,86,"ME",16.424
"2511",513,"SP12.6","ME",2012,5,1,122,17,42.94878,-70.6009,124,56,68,76,48,"ME",11.8915
"2512",513,"SP12.60","ME",2012,5,16,137,20,43.54597,-69.03783,6,2,4,6,0,"ME",16.41
"2513",512,"SP12.61","ME",2012,5,16,137,20,43.565,-68.91488,3,2,1,3,0,"ME",14.53
"2514",512,"SP12.62","ME",2012,5,16,137,20,43.6067,-68.94468,16,5,11,13,3,"ME",16.816
"2515",512,"SP12.63","ME",2012,5,17,138,20,43.9024,-68.75653,242,100,142,146,96,"ME",16.086
"2516",512,"SP12.64","ME",2012,5,17,138,20,43.8973,-68.64907,166,80,86,116,50,"ME",17.226
"2517",512,"SP12.65","ME",2012,5,17,138,19,43.85372,-68.62457,85,50,35,70,15,"ME",14.2519
"2518",512,"SP12.66","ME",2012,5,17,138,15,43.75213,-68.67862,38,25,13,35,3,"ME",8.7015
"2519",512,"SP12.67","ME",2012,5,17,138,15,43.85492,-68.73393,246,122,124,83,163,"ME",8.6595
"2520",512,"SP12.68","ME",2012,5,18,139,17,43.97633,-68.71622,725,368,357,523,202,"ME",11.7912
"2521",512,"SP12.69","ME",2012,5,18,139,17,44.11283,-68.75158,286,133,153,231,55,"ME",11.3696
"2522",513,"SP12.7","ME",2012,5,1,122,20,42.90912,-70.6478,78,36,42,37,41,"ME",16.296
"2523",512,"SP12.70","ME",2012,5,18,139,20,44.13563,-68.75363,621,269,352,411,210,"ME",16.056
"2524",512,"SP12.71","ME",2012,5,18,139,16,44.15072,-68.78763,138,52,86,92,46,"ME",10.3728
"2525",512,"SP12.72","ME",2012,5,21,142,20,43.97767,-68.52095,448,254,194,257,191,"ME",16.306
"2526",512,"SP12.73","ME",2012,5,21,142,20,43.92072,-68.49173,59,25,34,37,22,"ME",15.7
"2527",512,"SP12.74","ME",2012,5,21,142,20,43.84022,-68.5098,8,6,2,8,0,"ME",17.24
"2528",512,"SP12.75","ME",2012,5,21,142,10,44.13067,-68.48393,301,137,164,233,68,"ME",4.002
"2529",512,"SP12.76","ME",2012,5,22,143,20,44.16342,-68.53535,744,402,342,559,185,"ME",15.342
"2530",512,"SP12.77","ME",2012,5,22,143,20,44.31038,-68.464,45,12,33,31,14,"ME",15.758
"2531",513,"SP12.8","ME",2012,5,1,122,20,42.89218,-70.54257,13,3,10,12,1,"ME",16.574
"2532",512,"SP12.80","ME",2012,5,22,143,16,44.20723,-68.43563,807,372,435,498,309,"ME",10.4912
"2533",512,"SP12.81","ME",2012,5,23,144,20,44.02823,-68.3007,207,111,96,143,64,"ME",16.344
"2534",512,"SP12.82","ME",2012,5,23,144,20,43.94733,-68.35302,31,22,9,31,0,"ME",15.886
"2535",512,"SP12.83","ME",2012,5,23,144,20,43.89533,-68.29518,10,8,2,10,0,"ME",16.412
"2536",512,"SP12.84","ME",2012,5,23,144,15,43.96003,-68.23595,8,7,1,8,0,"ME",8.22
"2537",512,"SP12.85","ME",2012,5,23,144,20,43.99143,-68.26543,29,15,14,25,4,"ME",15.828
"2538",512,"SP12.86","ME",2012,5,24,145,20,44.05925,-68.05215,18,8,10,16,2,"ME",15.662
"2539",512,"SP12.87","ME",2012,5,24,145,20,44.08328,-68.03617,39,21,18,36,3,"ME",16.414
"2540",512,"SP12.88","ME",2012,5,24,145,20,44.11002,-67.99978,69,43,26,62,7,"ME",15.91
"2541",512,"SP12.89","ME",2012,5,24,145,20,44.1772,-68.02382,126,58,68,75,51,"ME",16.228
"2542",513,"SP12.9","ME",2012,5,1,122,20,42.98798,-70.45757,26,9,17,23,3,"ME",16.15
"2543",512,"SP12.90","ME",2012,5,24,145,20,44.21815,-68.07165,421,214,207,166,255,"ME",16.61
"2544",512,"SP12.91","ME",2012,5,25,146,20,44.43948,-68.22445,182,86,96,84,98,"ME",16.322
"2545",512,"SP12.92","ME",2012,5,25,146,20,44.43385,-68.17152,289,113,176,165,124,"ME",16.394
"2546",512,"SP12.93","ME",2012,5,25,146,20,44.29465,-68.07178,829,376,452,188,641,"ME",16.184
"2547",512,"SP12.94","ME",2012,5,25,146,20,44.284,-68.13057,782,356,426,190,592,"ME",16.84
"2548",512,"SP12.95","ME",2012,5,25,146,15,44.29055,-68.20333,1120,588,532,327,793,"ME",9.7785
"2549",512,"SP12.96","ME",2012,5,28,149,19,44.2482,-67.91353,218,114,104,78,140,"ME",15.1791
"2550",511,"SP12.97","ME",2012,5,28,149,20,44.27033,-67.87785,254,115,139,142,112,"ME",17.546
"2551",511,"SP12.98","ME",2012,5,28,149,15,44.34712,-67.82023,210,124,86,146,64,"ME",8.9055
"2552",511,"SP12.99","ME",2012,5,28,149,20,44.4175,-67.73907,462,233,229,242,220,"ME",15.494
"2553",513,"SP13.1","ME",2013,5,6,126,20,42.93425,-70.6732,144,72,72,81,63,"ME",16.36
"2554",513,"SP13.10","ME",2013,5,7,127,12,43.02848,-70.56163,32,21,11,22,10,"ME",5.232
"2555",511,"SP13.100","ME",2013,6,4,155,20,44.25655,-67.66745,16,10,6,16,0,"ME",16.544
"2556",511,"SP13.101","ME",2013,6,4,155,20,44.27578,-67.66455,25,17,8,25,0,"ME",16.112
"2557",511,"SP13.102","ME",2013,6,4,155,20,44.30362,-67.68788,64,33,31,61,3,"ME",17.076
"2558",511,"SP13.103","ME",2013,6,5,156,20,44.27563,-67.57067,32,22,10,32,0,"ME",15.718
"2559",511,"SP13.104","ME",2013,6,5,156,20,44.29288,-67.51002,15,12,3,15,0,"ME",16.804
"2560",511,"SP13.105","ME",2013,6,5,156,20,44.28267,-67.497,5,5,0,5,0,"ME",17.644
"2561",511,"SP13.106","ME",2013,6,5,156,20,44.31685,-67.37418,1,1,0,1,0,"ME",16.83
"2562",511,"SP13.107","ME",2013,6,5,156,20,44.34212,-67.50638,19,7,12,19,0,"ME",16.226
"2563",511,"SP13.108","ME",2013,6,6,157,13,44.50153,-67.29643,61,29,32,55,6,"ME",6.786
"2564",511,"SP13.109","ME",2013,6,6,157,17,44.42832,-67.20368,3,1,2,3,0,"ME",11.5498
"2565",513,"SP13.11","ME",2013,5,8,128,17,43.20845,-70.5745,81,33,48,63,18,"ME",13.2124
"2566",511,"SP13.110","ME",2013,6,6,157,20,44.42627,-67.1537,10,3,7,9,1,"ME",15.718
"2567",511,"SP13.111","ME",2013,6,6,157,20,44.59168,-67.29,95,52,43,85,10,"ME",17.404
"2568",511,"SP13.112","ME",2013,6,6,157,15,44.57705,-67.29685,86,39,47,72,14,"ME",9.27
"2569",511,"SP13.113","ME",2013,6,6,157,17,44.62267,-67.32742,115,43,72,96,19,"ME",11.2438
"2570",513,"SP13.12","ME",2013,5,8,128,18,43.28545,-70.53257,149,47,102,98,51,"ME",12.8232
"2571",513,"SP13.13","ME",2013,5,8,128,20,43.20332,-70.40908,121,62,59,66,55,"ME",15.318
"2572",513,"SP13.14","ME",2013,5,8,128,15,43.20403,-70.29257,36,14,22,32,4,"ME",9.171
"2573",513,"SP13.15","ME",2013,5,8,128,20,43.1696,-70.26775,33,16,17,31,2,"ME",17.114
"2574",513,"SP13.16","ME",2013,5,9,129,20,43.10773,-70.25767,6,2,4,5,1,"ME",17.19
"2575",513,"SP13.17","ME",2013,5,9,129,20,43.25397,-70.20768,14,5,9,14,0,"ME",15.372
"2576",513,"SP13.18","ME",2013,5,9,129,20,43.40352,-70.13353,74,38,36,69,5,"ME",16.56
"2577",513,"SP13.19","ME",2013,5,9,129,20,43.39837,-70.04308,11,9,2,11,0,"ME",16.76
"2578",513,"SP13.2","ME",2013,5,6,126,20,42.90712,-70.64753,70,31,39,55,15,"ME",15.93
"2579",513,"SP13.20","ME",2013,5,10,130,21,43.512,-70.19247,216,96,120,78,138,"ME",17.0436
"2580",513,"SP13.21","ME",2013,5,10,130,20,43.42488,-70.226,165,78,87,97,68,"ME",16.162
"2581",513,"SP13.22","ME",2013,5,10,130,16,43.42457,-70.28762,195,85,110,78,117,"ME",10.0944
"2582",513,"SP13.23","ME",2013,5,10,130,20,43.5173,-70.34255,2,0,2,0,2,"ME",17.706
"2583",513,"SP13.24","ME",2013,5,10,130,20,43.50507,-70.25325,83,37,46,30,53,"ME",16.206
"2584",513,"SP13.25","ME",2013,5,13,133,20,43.65765,-70.1578,1092,505,587,478,614,"ME",15.308
"2585",513,"SP13.26","ME",2013,5,13,133,12,43.71595,-70.09688,402,173,229,160,242,"ME",5.3772
"2586",513,"SP13.27","ME",2013,5,13,133,20,43.76018,-70.08513,121,65,56,49,72,"ME",17.27
"2587",513,"SP13.28","ME",2013,5,13,133,17,43.66125,-70.07612,533,293,240,253,280,"ME",12.274
"2588",513,"SP13.29","ME",2013,5,14,134,20,43.51817,-70.11115,97,43,54,33,64,"ME",16.026
"2589",513,"SP13.3","ME",2013,5,6,126,20,42.92923,-70.75467,63,37,26,54,9,"ME",16.986
"2590",513,"SP13.30","ME",2013,5,14,134,20,43.42505,-69.92465,2,2,0,2,0,"ME",17.254
"2591",513,"SP13.31","ME",2013,5,14,134,17,43.53933,-69.87363,41,19,22,40,1,"ME",11.6569
"2592",513,"SP13.32","ME",2013,5,14,134,15,43.57912,-69.84532,39,16,23,30,9,"ME",8.403
"2593",513,"SP13.33","ME",2013,5,14,134,20,43.56422,-69.7798,41,16,25,38,3,"ME",15.752
"2594",513,"SP13.34","ME",2013,5,14,134,15,43.68418,-69.70978,229,99,130,109,120,"ME",9.3705
"2595",513,"SP13.35","ME",2013,5,15,135,20,43.70805,-69.74367,458,217,241,356,102,"ME",17.044
"2596",513,"SP13.36","ME",2013,5,15,135,20,43.66067,-69.81482,118,60,58,99,19,"ME",16.152
"2597",513,"SP13.37","ME",2013,5,15,135,19,43.60822,-69.8631,67,33,33,38,29,"ME",14.3317
"2598",513,"SP13.38","ME",2013,5,15,135,20,43.66173,-69.91063,165,97,68,76,89,"ME",16.27
"2599",513,"SP13.39","ME",2013,5,15,135,14,43.7095,-69.69098,131,54,77,62,69,"ME",7.4858
"2600",513,"SP13.4","ME",2013,5,6,126,20,42.9496,-70.71228,113,56,57,81,32,"ME",16.17
"2601",513,"SP13.40","ME",2013,5,16,136,20,43.56148,-69.62628,8,1,7,7,1,"ME",17.478
"2602",513,"SP13.41","ME",2013,5,16,136,20,43.54213,-69.573,2,1,1,2,0,"ME",17.462
"2603",513,"SP13.42","ME",2013,5,16,136,15,43.62727,-69.59702,47,14,33,37,10,"ME",8.6265
"2604",513,"SP13.43","ME",2013,5,16,136,20,43.68172,-69.5136,77,46,31,63,14,"ME",17.554
"2605",513,"SP13.44","ME",2013,5,16,136,20,43.71603,-69.5501,162,75,87,55,107,"ME",15.646
"2606",513,"SP13.45","ME",2013,5,17,137,15,43.8203,-69.5291,442,220,222,103,339,"ME",9.42
"2607",513,"SP13.46","ME",2013,5,17,137,20,43.83702,-69.48637,408,196,211,103,305,"ME",15.078
"2608",513,"SP13.47","ME",2013,5,17,137,15,43.76297,-69.35773,145,72,73,85,60,"ME",9.174
"2609",513,"SP13.48","ME",2013,5,17,137,20,43.73592,-69.66337,367,172,194,127,240,"ME",16.084
"2610",513,"SP13.49","ME",2013,5,17,137,17,43.79032,-69.64802,298,158,140,77,221,"ME",11.3322
"2611",513,"SP13.5","ME",2013,5,6,126,19,43.03263,-70.69445,98,36,62,82,16,"ME",15.162
"2612",512,"SP13.50","ME",2013,5,20,140,16,43.75963,-69.21268,128,60,68,49,79,"ME",10.1056
"2613",512,"SP13.51","ME",2013,5,20,140,17,43.74367,-69.15395,55,25,30,40,15,"ME",10.8188
"2614",512,"SP13.52","ME",2013,5,20,140,22,43.77257,-69.15408,159,77,82,54,105,"ME",20.3412
"2615",512,"SP13.53","ME",2013,5,20,140,20,43.88417,-69.2285,780,365,415,276,504,"ME",17.754
"2616",512,"SP13.54","ME",2013,5,20,140,19,43.96235,-69.15322,889,373,516,224,665,"ME",15.4527
"2617",512,"SP13.55","ME",2013,5,21,141,12,44.19535,-68.87232,159,71,88,130,29,"ME",5.4
"2618",512,"SP13.56","ME",2013,5,21,141,15,44.24498,-68.72067,38,16,22,33,5,"ME",9.849
"2619",512,"SP13.57","ME",2013,5,21,141,20,44.29317,-68.75542,5,0,5,5,0,"ME",16.462
"2620",512,"SP13.58","ME",2013,5,21,141,19,44.22513,-68.91328,95,28,67,74,21,"ME",15.4622
"2621",512,"SP13.59","ME",2013,5,21,141,20,44.18818,-69.0181,406,167,239,195,211,"ME",17.2
"2622",513,"SP13.6","ME",2013,5,7,127,20,42.86605,-70.48073,8,5,3,8,0,"ME",16.886
"2623",512,"SP13.60","ME",2013,5,21,141,20,44.13565,-69.0405,208,89,119,89,119,"ME",15.854
"2624",512,"SP13.61","ME",2013,5,22,142,20,43.86185,-69.06042,417,193,224,91,326,"ME",16.072
"2625",512,"SP13.62","ME",2013,5,22,142,16,43.79352,-69.07842,169,76,93,78,91,"ME",10.3216
"2626",513,"SP13.63","ME",2013,5,22,142,20,43.64592,-69.13185,7,3,4,7,0,"ME",16.798
"2627",512,"SP13.64","ME",2013,5,22,142,20,43.53822,-68.96157,26,15,11,25,1,"ME",15.5
"2628",512,"SP13.65","ME",2013,5,22,142,19,43.60595,-68.9447,11,5,6,10,1,"ME",15.0556
"2629",512,"SP13.66","ME",2013,5,23,143,11,43.85472,-68.59168,56,47,9,55,1,"ME",4.4781
"2630",512,"SP13.67","ME",2013,5,23,143,20,43.79422,-68.62847,35,27,8,35,0,"ME",15.07
"2631",512,"SP13.68","ME",2013,5,23,143,15,43.85143,-68.74118,192,84,108,64,128,"ME",8.349
"2632",512,"SP13.69","ME",2013,5,23,143,20,43.89305,-68.67483,241,124,117,159,82,"ME",15.728
"2633",513,"SP13.7","ME",2013,5,7,127,20,42.9415,-70.4593,17,9,8,16,1,"ME",15.334
"2634",512,"SP13.70","ME",2013,5,23,143,20,43.90465,-68.7567,331,145,186,153,178,"ME",15.968
"2635",512,"SP13.71","ME",2013,5,24,144,15,44.13488,-68.75653,446,198,248,276,170,"ME",9.1185
"2636",512,"SP13.72","ME",2013,5,27,147,19,44.05547,-68.39343,694,345,349,342,352,"ME",14.8637
"2637",512,"SP13.73","ME",2013,5,27,147,15,43.99977,-68.4034,84,37,47,65,19,"ME",9.1785
"2638",512,"SP13.74","ME",2013,5,27,147,10,43.90785,-68.36405,4,2,2,4,0,"ME",3.992
"2639",512,"SP13.75","ME",2013,5,27,147,19,43.9099,-68.42265,13,8,5,12,1,"ME",13.8909
"2640",512,"SP13.76","ME",2013,5,27,147,20,43.95915,-68.40913,59,39,20,56,3,"ME",15.298
"2641",512,"SP13.77","ME",2013,5,28,148,18,44.2461,-68.46327,500,216,284,190,310,"ME",12.5622
"2642",512,"SP13.78","ME",2013,5,28,148,15,44.36448,-68.54178,5,0,5,4,1,"ME",8.07
"2643",512,"SP13.79","ME",2013,5,28,148,16,44.3615,-68.4555,24,8,16,24,0,"ME",9.4928
"2644",513,"SP13.8","ME",2013,5,7,127,15,42.97955,-70.5105,38,20,18,34,4,"ME",8.589
"2645",512,"SP13.80","ME",2013,5,29,149,15,44.05708,-68.12555,33,16,17,28,5,"ME",9.4365
"2646",512,"SP13.81","ME",2013,5,29,149,15,44.05612,-68.05892,15,8,7,10,5,"ME",10.2045
"2647",512,"SP13.82","ME",2013,5,29,149,14,43.99333,-68.05732,51,39,12,48,3,"ME",7.9226
"2648",512,"SP13.83","ME",2013,5,29,149,16,44.10433,-68.00643,9,4,5,8,1,"ME",10.0336
"2649",512,"SP13.84","ME",2013,5,29,149,23,44.12687,-68.01643,45,21,24,39,6,"ME",21.6499
"2650",512,"SP13.85","ME",2013,5,30,150,20,44.21675,-68.06902,260,110,150,119,141,"ME",16.016
"2651",512,"SP13.86","ME",2013,5,30,150,20,44.26465,-68.02188,416,202,214,208,208,"ME",16.686
"2652",512,"SP13.87","ME",2013,5,30,150,20,44.14513,-67.91397,68,44,24,66,2,"ME",17.032
"2653",512,"SP13.88","ME",2013,5,30,150,20,44.18722,-67.97313,80,44,36,63,17,"ME",16.096
"2654",512,"SP13.89","ME",2013,5,30,150,20,44.22878,-68.13347,515,253,262,181,334,"ME",16.294
"2655",513,"SP13.9","ME",2013,5,7,127,20,43.06173,-70.4621,49,24,25,41,8,"ME",15.424
"2656",512,"SP13.90","ME",2013,5,31,151,15,44.28505,-68.13067,278,126,152,105,173,"ME",8.6085
"2657",512,"SP13.91","ME",2013,5,31,151,20,44.3344,-68.1161,445,201,244,135,310,"ME",16.778
"2658",512,"SP13.92","ME",2013,5,31,151,14,44.43877,-68.15363,222,111,111,101,121,"ME",7.28
"2659",512,"SP13.93","ME",2013,5,31,151,16,44.44065,-68.18635,102,43,59,64,38,"ME",10.6896
"2660",512,"SP13.94","ME",2013,5,31,151,18,44.43925,-68.24292,221,85,136,134,87,"ME",12.987
"2661",512,"SP13.95","ME",2013,6,3,154,15,44.24613,-67.9174,186,86,100,103,83,"ME",8.52
"2662",511,"SP13.96","ME",2013,6,3,154,20,44.38007,-67.91152,1034,483,551,708,326,"ME",16.26
"2663",511,"SP13.97","ME",2013,6,3,154,15,44.4022,-67.75153,235,109,126,157,78,"ME",9.204
"2664",511,"SP13.98","ME",2013,6,4,155,15,44.45222,-67.72172,432,221,211,223,209,"ME",9.183
"2665",511,"SP13.99","ME",2013,6,4,155,13,44.3721,-67.65898,272,139,133,227,45,"ME",6.9992
"2666",513,"SP14.1","ME",2014,5,5,125,20,42.93682,-70.7438,33,16,17,21,12,"ME",15.982
"2667",513,"SP14.10","ME",2014,5,6,126,15,43.08758,-70.48902,37,16,21,31,6,"ME",8.814
"2668",511,"SP14.100","ME",2014,6,3,154,20,44.2922,-67.51112,32,26,6,32,0,"ME",17.334
"2669",511,"SP14.101","ME",2014,6,3,154,20,44.32397,-67.52637,56,32,24,54,2,"ME",16.532
"2670",511,"SP14.102","ME",2014,6,4,155,19,44.48405,-67.65258,460,205,255,191,269,"ME",14.8694
"2671",511,"SP14.103","ME",2014,6,4,155,19,44.46222,-67.72453,758,371,387,264,494,"ME",14.3469
"2672",511,"SP14.104","ME",2014,6,4,155,17,44.47995,-67.50902,422,221,201,222,200,"ME",11.407
"2673",511,"SP14.105","ME",2014,6,4,155,20,44.51385,-67.51472,322,170,152,191,131,"ME",16.908
"2674",511,"SP14.106","ME",2014,6,5,156,20,44.37722,-67.14093,25,18,7,25,0,"ME",16.83
"2675",511,"SP14.107","ME",2014,6,5,156,15,44.43092,-67.14505,17,8,9,17,0,"ME",9.888
"2676",511,"SP14.108","ME",2014,6,5,156,15,44.54723,-67.171,39,17,22,34,5,"ME",10.971
"2677",511,"SP14.109","ME",2014,6,5,156,16,44.55888,-67.21712,149,86,63,118,31,"ME",11.3072
"2678",513,"SP14.11","ME",2014,5,7,127,18,43.17657,-70.58297,9,3,6,8,1,"ME",12.9816
"2679",511,"SP14.110","ME",2014,6,5,156,17,44.58625,-67.30307,166,86,80,114,52,"ME",11.6331
"2680",511,"SP14.111","ME",2014,6,6,157,20,44.74422,-67.04003,32,14,18,23,9,"ME",18.404
"2681",511,"SP14.112","ME",2014,6,6,157,15,44.73623,-67.01073,67,21,46,52,15,"ME",10.662
"2682",511,"SP14.113","ME",2014,6,6,157,20,44.67977,-67.1192,85,38,47,63,22,"ME",17.184
"2683",511,"SP14.114","ME",2014,6,6,157,12,44.6936,-67.12262,57,22,35,47,10,"ME",5.9388
"2684",513,"SP14.12","ME",2014,5,7,127,20,43.2411,-70.57358,18,7,11,15,3,"ME",16.82
"2685",513,"SP14.13","ME",2014,5,7,127,20,43.2959,-70.49872,18,10,8,13,5,"ME",16.7
"2686",513,"SP14.14","ME",2014,5,7,127,20,43.20213,-70.40662,77,34,43,42,35,"ME",16.588
"2687",513,"SP14.15","ME",2014,5,7,127,15,43.1665,-70.45753,40,25,15,32,8,"ME",8.793
"2688",513,"SP14.16","ME",2014,5,8,128,20,43.19057,-70.2241,13,6,7,13,0,"ME",16.332
"2689",513,"SP14.17","ME",2014,5,8,128,20,43.25805,-70.19025,4,3,1,4,0,"ME",15.976
"2690",513,"SP14.18","ME",2014,5,8,128,17,43.28238,-70.28435,57,24,33,49,8,"ME",12.3012
"2691",513,"SP14.19","ME",2014,5,8,128,15,43.3412,-70.23002,125,59,66,89,36,"ME",9.108
"2692",513,"SP14.2","ME",2014,5,5,125,20,42.88628,-70.67158,107,45,62,65,42,"ME",12.462
"2693",513,"SP14.20","ME",2014,5,8,128,20,43.37282,-70.1035,12,7,5,11,1,"ME",16.638
"2694",513,"SP14.21","ME",2014,5,8,128,19,43.39748,-70.12438,25,10,15,19,6,"ME",14.5331
"2695",513,"SP14.22","ME",2014,5,9,129,20,43.448217,-70.18975,151,62,89,82,69,"ME",16.586
"2696",513,"SP14.23","ME",2014,5,9,129,18,43.42332,-70.29108,324,153,171,185,139,"ME",14.13
"2697",513,"SP14.24","ME",2014,5,9,129,20,43.50425,-70.35162,1,0,1,1,0,"ME",16.184
"2698",513,"SP14.25","ME",2014,5,9,129,20,43.50365,-70.25657,23,9,14,13,10,"ME",16.666
"2699",513,"SP14.26","ME",2014,5,12,132,20,43.71125,-70.17613333,24,12,12,15,9,"ME",16.834
"2700",513,"SP14.27","ME",2014,5,12,132,20,43.77613,-70.02635,74,24,50,40,34,"ME",15.858
"2701",513,"SP14.28","ME",2014,5,12,132,18,43.64933,-70.00807,93,60,33,74,19,"ME",13.266
"2702",513,"SP14.29","ME",2014,5,12,132,20,43.65715,-69.91098,106,46,60,70,36,"ME",17.1
"2703",513,"SP14.3","ME",2014,5,5,125,20,42.90045,-70.5951,42,14,28,36,6,"ME",17.202
"2704",513,"SP14.30","ME",2014,5,12,132,20,43.72557,-69.8654,10,4,6,7,3,"ME",16.522
"2705",513,"SP14.31","ME",2014,5,13,133,20,43.56932,-69.95583,120,63,57,70,50,"ME",16.4
"2706",513,"SP14.32","ME",2014,5,13,133,20,43.47415,-69.9216,2,0,2,2,0,"ME",16.41
"2707",513,"SP14.33","ME",2014,5,13,133,20,43.50007,-69.7488,6,6,0,6,0,"ME",16.472
"2708",513,"SP14.34","ME",2014,5,13,133,20,43.57158,-69.81267,22,8,14,21,1,"ME",17.29
"2709",513,"SP14.35","ME",2014,5,13,133,20,43.59757,-69.8813,159,59,100,127,32,"ME",16.384
"2710",513,"SP14.36","ME",2014,5,14,134,15,43.63407,-69.75555,186,89,97,103,83,"ME",8.9415
"2711",513,"SP14.37","ME",2014,5,14,134,17,43.70512,-69.746,289,140,149,254,35,"ME",11.628
"2712",513,"SP14.38","ME",2014,5,14,134,21,43.77593,-69.71697,79,27,52,61,18,"ME",19.1898
"2713",513,"SP14.39","ME",2014,5,14,134,10,43.80383,-69.69972,39,20,19,18,21,"ME",4.07
"2714",513,"SP14.4","ME",2014,5,5,125,15,42.94017,-70.52378,34,16,18,29,5,"ME",12.156
"2715",513,"SP14.40","ME",2014,5,15,135,20,43.69737,-69.68538,221,112,109,75,146,"ME",16.732
"2716",513,"SP14.41","ME",2014,5,15,135,20,43.54773,-69.56877,5,5,0,5,0,"ME",16.664
"2717",513,"SP14.42","ME",2014,5,15,135,20,43.66362,-69.52432,24,13,11,22,2,"ME",16.518
"2718",513,"SP14.43","ME",2014,5,15,135,20,43.68608,-69.51313,34,15,19,34,0,"ME",16.552
"2719",513,"SP14.44","ME",2014,5,15,135,20,43.72835,-69.50903,196,88,108,115,81,"ME",16.212
"2720",513,"SP14.45","ME",2014,5,16,136,20,43.79198,-69.49463,445,224,221,112,333,"ME",15.922
"2721",513,"SP14.46","ME",2014,5,16,136,18,43.86743,-69.47307,300,129,171,112,188,"ME",12.5856
"2722",513,"SP14.47","ME",2014,5,16,136,20,43.82847,-69.4891,394,178,216,101,293,"ME",16.336
"2723",512,"SP14.48","ME",2014,5,16,136,20,43.87263,-69.327,40,20,20,23,17,"ME",16.76
"2724",512,"SP14.49","ME",2014,5,16,136,20,43.85568,-69.27793,820,390,430,264,556,"ME",16.508
"2725",513,"SP14.5","ME",2014,5,5,125,15,42.98975,-70.6352,20,8,12,19,1,"ME",9.117
"2726",512,"SP14.50","ME",2014,5,19,139,20,43.74388,-69.15335,262,117,145,194,68,"ME",16.486
"2727",512,"SP14.51","ME",2014,5,19,139,17,43.73197,-69.07662,285,129,156,210,75,"ME",11.56
"2728",512,"SP14.52","ME",2014,5,19,139,20,43.79933,-69.07427,355,163,192,173,182,"ME",15.972
"2729",512,"SP14.53","ME",2014,5,19,139,15,43.8754,-69.23968,911,401,510,308,603,"ME",9.3525
"2730",512,"SP14.54","ME",2014,5,20,140,20,44.11958,-69.0549,506,223,283,281,225,"ME",17.252
"2731",512,"SP14.55","ME",2014,5,20,140,20,44.2113,-69.0079,362,139,223,235,127,"ME",17.144
"2732",512,"SP14.56","ME",2014,5,20,140,20,44.26877,-68.89005,63,20,43,45,18,"ME",17.312
"2733",512,"SP14.57","ME",2014,5,20,140,20,44.29565,-68.76958,1,0,1,1,0,"ME",16.038
"2734",512,"SP14.58","ME",2014,5,20,140,20,44.30852,-68.87933,31,12,19,20,11,"ME",17.656
"2735",513,"SP14.59","ME",2014,5,21,141,16,43.64133,-69.13607,2,2,0,2,0,"ME",10.6704
"2736",513,"SP14.6","ME",2014,5,6,126,20,42.97435,-70.40483,16,10,6,16,0,"ME",16.866
"2737",512,"SP14.60","ME",2014,5,21,141,20,43.53657,-68.96463,42,26,16,38,4,"ME",16.524
"2738",512,"SP14.61","ME",2014,5,21,141,19,43.61223,-68.9402,21,12,9,20,1,"ME",14.5426
"2739",512,"SP14.62","ME",2014,5,21,141,15,43.61547,-68.84828,18,13,5,17,1,"ME",9.96
"2740",512,"SP14.63","ME",2014,5,22,142,20,43.91718,-68.75403,558,239,319,323,235,"ME",16.938
"2741",512,"SP14.64","ME",2014,5,22,142,18,43.84532,-68.6275,168,97,71,139,29,"ME",13.2552
"2742",512,"SP14.65","ME",2014,5,22,142,20,43.83588,-68.54952,48,30,18,47,1,"ME",16.496
"2743",512,"SP14.66","ME",2014,5,22,142,20,43.78403,-68.66562,117,67,50,109,8,"ME",15.85
"2744",512,"SP14.67","ME",2014,5,22,142,15,43.85152,-68.74148,321,154,167,124,197,"ME",8.886
"2745",512,"SP14.68","ME",2014,5,23,143,19,43.98713,-68.75332,813,378,435,236,577,"ME",14.2443
"2746",512,"SP14.69","ME",2014,5,23,143,20,44.10082,-68.77268,333,163,170,209,124,"ME",16.158
"2747",513,"SP14.7","ME",2014,5,6,126,20,43.03643,-70.41353,134,66,68,120,14,"ME",15.748
"2748",512,"SP14.70","ME",2014,5,23,143,20,44.14623,-68.76037,561,253,308,375,186,"ME",17.628
"2749",512,"SP14.71","ME",2014,5,23,143,19,44.15698,-68.79382,135,54,81,101,34,"ME",14.6832
"2750",512,"SP14.72","ME",2014,5,26,146,20,43.93367,-68.4498,180,96,84,152,28,"ME",15.926
"2751",512,"SP14.73","ME",2014,5,26,146,20,43.99258,-68.44,322,159,163,188,134,"ME",17.024
"2752",512,"SP14.74","ME",2014,5,26,146,17,44.10563,-68.48542,197,101,96,156,41,"ME",11.6161
"2753",512,"SP14.75","ME",2014,5,27,147,17,44.26273,-68.49355,754,292,462,461,293,"ME",12.308
"2754",512,"SP14.76","ME",2014,5,27,147,20,44.39133,-68.51572,18,6,12,16,2,"ME",17.066
"2755",512,"SP14.77","ME",2014,5,27,147,20,44.21313,-68.43935,770,354,416,406,364,"ME",16.35
"2756",512,"SP14.78","ME",2014,5,27,147,14,44.14603,-68.26493,1564,981,583,1085,479,"ME",7.7602
"2757",512,"SP14.79","ME",2014,5,27,147,20,44.17963,-68.27713,872,426,446,385,487,"ME",16.058
"2758",513,"SP14.8","ME",2014,5,6,126,20,43.12332,-70.35123,43,13,30,40,3,"ME",16.426
"2759",512,"SP14.80","ME",2014,5,28,148,16,44.05728,-68.24568,218,117,101,156,62,"ME",10.6224
"2760",512,"SP14.81","ME",2014,5,29,149,20,44.06262,-68.12593,151,80,71,111,40,"ME",15.97
"2761",512,"SP14.82","ME",2014,5,29,149,20,44.0503,-68.06457,57,28,29,57,0,"ME",19.3
"2762",512,"SP14.83","ME",2014,5,29,149,18,44.02625,-68.00162,62,42,20,62,0,"ME",12.4254
"2763",512,"SP14.84","ME",2014,5,29,149,20,44.14877,-68.1073,394,197,197,136,258,"ME",17.3
"2764",512,"SP14.85","ME",2014,5,29,149,20,44.18632,-68.03518,182,90,92,98,84,"ME",16.304
"2765",512,"SP14.86","ME",2014,5,29,149,17,44.21623,-68.06653,481,230,251,175,306,"ME",11.8507
"2766",512,"SP14.87","ME",2014,5,30,150,17,44.28565,-68.13107,662,300,362,228,434,"ME",10.9769
"2767",512,"SP14.88","ME",2014,5,30,150,15,44.24857,-68.1026,452,228,224,133,319,"ME",9.438
"2768",512,"SP14.89","ME",2014,5,30,150,20,44.35755,-68.16837,1565,757,808,826,739,"ME",17.192
"2769",513,"SP14.9","ME",2014,5,6,126,20,43.15183,-70.37942,90,48,42,47,43,"ME",16.098
"2770",512,"SP14.90","ME",2014,5,30,150,16,44.44243,-68.22205,134,52,82,93,41,"ME",9.8624
"2771",512,"SP14.91","ME",2014,5,30,150,20,44.41152,-68.23077,189,92,97,136,53,"ME",16.646
"2772",511,"SP14.92","ME",2014,6,2,153,20,44.14805,-67.7903,52,40,12,52,0,"ME",16.282
"2773",511,"SP14.93","ME",2014,6,2,153,16,44.18652,-67.82097,38,29,9,38,0,"ME",10.92
"2774",512,"SP14.94","ME",2014,6,2,153,20,44.2364,-67.89262,195,104,91,139,56,"ME",15.8
"2775",512,"SP14.95","ME",2014,6,2,153,20,44.2608,-67.89852,398,205,193,243,155,"ME",16.94
"2776",511,"SP14.96","ME",2014,6,2,153,20,44.3017,-67.86935,517,237,280,239,278,"ME",16.644
"2777",511,"SP14.97","ME",2014,6,3,154,17,44.39892,-67.68805,620,335,285,325,295,"ME",11.6535
"2778",511,"SP14.98","ME",2014,6,3,154,18,44.25903,-67.67365,27,19,8,26,1,"ME",13.3056
"2779",511,"SP14.99","ME",2014,6,3,154,20,44.27883,-67.64088,42,21,21,41,1,"ME",17.194
"2780",513,"SP15.1","ME",2015,5,4,124,15,42.95858,-70.46448,30,13,17,30,0,"ME",9.699
"2781",513,"SP15.10","ME",2015,5,5,125,14,43.08918,-70.44603,79,32,47,71,8,"ME",8.2866
"2782",512,"SP15.100","ME",2015,6,1,152,20,44.2206,-67.91557,276,135,141,192,84,"ME",17.144
"2783",511,"SP15.101","ME",2015,6,1,152,17,44.323,-67.85372,200,85,115,141,59,"ME",12.0802
"2784",511,"SP15.102","ME",2015,6,1,152,20,44.3578,-67.73745,220,91,129,166,54,"ME",16.992
"2785",511,"SP15.103","ME",2015,6,1,152,20,44.46445,-67.64192,284,138,146,183,101,"ME",16.2
"2786",511,"SP15.104","ME",2015,6,2,153,20,44.32967,-67.70738,199,94,105,187,12,"ME",16.47
"2787",511,"SP15.105","ME",2015,6,2,153,20,44.27317,-67.70163,51,28,23,47,4,"ME",16.212
"2788",511,"SP15.106","ME",2015,6,2,153,20,44.25012,-67.68033,34,20,14,34,0,"ME",15.508
"2789",511,"SP15.107","ME",2015,6,5,156,20,44.23682,-67.74373,46,29,17,46,0,"ME",17.838
"2790",511,"SP15.108","ME",2015,6,2,153,20,44.1992,-67.7426,49,34,15,49,0,"ME",17.546
"2791",511,"SP15.109","ME",2015,6,3,154,17,44.5228,-67.52783,70,35,35,44,26,"ME",11.1928
"2792",513,"SP15.11","ME",2015,5,6,126,20,43.1672,-70.44475,111,56,55,77,34,"ME",16.328
"2793",511,"SP15.110","ME",2015,6,3,154,20,44.42347,-67.4744,263,131,132,202,61,"ME",17.262
"2794",511,"SP15.111","ME",2015,6,3,154,20,44.35215,-67.42058,32,23,9,32,0,"ME",16.948
"2795",511,"SP15.112","ME",2015,6,3,154,20,44.32687,-67.554,134,62,72,104,30,"ME",17.676
"2796",511,"SP15.113","ME",2015,6,3,154,20,44.33717,-67.62053,270,129,141,242,28,"ME",17.442
"2797",511,"SP15.114","ME",2015,6,3,154,20,44.38312,-67.55642,339,185,154,291,48,"ME",16.618
"2798",511,"SP15.115","ME",2015,6,4,155,20,44.49182,-67.44165,199,94,105,159,40,"ME",17.44
"2799",511,"SP15.116","ME",2015,6,4,155,18,44.42985,-67.19948,18,9,9,18,0,"ME",13.3488
"2800",511,"SP15.117","ME",2015,6,4,155,18,44.40365,-67.17393,12,7,5,12,0,"ME",13.6296
"2801",511,"SP15.118","ME",2015,6,4,155,20,44.3669,-67.17998,26,23,3,26,0,"ME",16.364
"2802",511,"SP15.119","ME",2015,6,4,155,16,44.50138,-67.28683,146,73,73,122,24,"ME",10.5056
"2803",513,"SP15.12","ME",2015,5,6,126,20,43.28395,-70.28507,109,40,69,79,30,"ME",15.864
"2804",511,"SP15.120","ME",2015,6,4,155,16,44.52757,-67.30727,59,35,24,41,18,"ME",11.8944
"2805",511,"SP15.121","ME",2015,6,5,156,20,44.60663,-67.36553,138,58,80,97,41,"ME",17.218
"2806",511,"SP15.122","ME",2015,6,5,156,15,44.58498,-67.30383,120,46,74,84,36,"ME",10.5555
"2807",511,"SP15.123","ME",2015,6,5,156,20,44.52617,-67.44842,168,81,87,118,50,"ME",15.728
"2808",513,"SP15.13","ME",2015,5,6,126,17,43.29515,-70.4967,33,13,20,27,6,"ME",12.2825
"2809",513,"SP15.14","ME",2015,5,6,126,20,43.24607,-70.50288,108,43,65,74,34,"ME",16.662
"2810",513,"SP15.15","ME",2015,5,6,126,20,43.19472,-70.57968,9,2,7,5,4,"ME",16.614
"2811",513,"SP15.16","ME",2015,5,7,127,19,43.25615,-70.26095,43,21,22,37,6,"ME",14.7459
"2812",513,"SP15.17","ME",2015,5,7,127,20,43.25742,-70.20088,18,12,6,18,0,"ME",17.312
"2813",513,"SP15.18","ME",2015,5,7,127,20,43.31958,-70.20403,55,25,30,46,9,"ME",16.074
"2814",513,"SP15.19","ME",2015,5,7,127,20,43.31568,-70.1146,16,12,4,14,2,"ME",16.588
"2815",513,"SP15.2","ME",2015,5,4,124,21,42.93505,-70.52648,66,32,34,62,4,"ME",18.417
"2816",513,"SP15.20","ME",2015,5,7,127,20,43.45773,-70.08183,98,38,60,81,17,"ME",17.17
"2817",513,"SP15.21","ME",2015,5,8,128,20,43.4792,-70.21788,224,89,135,99,125,"ME",16.94
"2818",513,"SP15.22","ME",2015,5,8,128,20,43.55033,-70.28458,1,1,0,0,1,"ME",15.88
"2819",513,"SP15.23","ME",2015,5,8,128,17,43.53305,-70.25837,3,2,1,3,0,"ME",12.0326
"2820",513,"SP15.24","ME",2015,5,8,128,16,43.51632,-70.24293,15,7,8,11,4,"ME",10.4464
"2821",513,"SP15.25","ME",2015,5,11,131,20,43.63235,-70.05827,239,138,101,155,84,"ME",16.56
"2822",513,"SP15.26","ME",2015,5,11,131,19,43.68473,-69.9859,190,90,100,93,97,"ME",14.326
"2823",513,"SP15.27","ME",2015,5,11,131,17,43.75853,-69.91493,2,0,2,1,1,"ME",11.3288
"2824",513,"SP15.28","ME",2015,5,11,131,20,43.7028,-69.93277,49,22,27,29,20,"ME",16.684
"2825",513,"SP15.29","ME",2015,5,11,131,20,43.67122,-70.06982,101,51,50,73,28,"ME",16.11
"2826",513,"SP15.3","ME",2015,5,4,124,20,42.908,-70.64838,87,44,43,58,29,"ME",16.722
"2827",513,"SP15.30","ME",2015,5,11,131,17,43.66258,-70.130067,55,25,30,23,32,"ME",11.2387
"2828",513,"SP15.31","ME",2015,5,12,132,20,43.5389,-70.0117,134,65,69,77,57,"ME",15.662
"2829",513,"SP15.32","ME",2015,5,12,132,20,43.44953,-69.93035,2,1,1,2,0,"ME",21.12
"2830",513,"SP15.33","ME",2015,5,12,132,20,43.50683,-69.91887,8,6,2,7,1,"ME",16.038
"2831",513,"SP15.34","ME",2015,5,12,132,20,43.5922,-69.84828,92,49,43,71,21,"ME",16.314
"2832",513,"SP15.35","ME",2015,5,12,132,20,43.60375,-69.70812,65,36,29,56,9,"ME",16.422
"2833",513,"SP15.36","ME",2015,5,13,133,20,43.78725,-69.61425,116,71,45,44,72,"ME",16.828
"2834",513,"SP15.37","ME",2015,5,13,133,20,43.75338,-69.7341,73,38,35,59,14,"ME",16.948
"2835",513,"SP15.38","ME",2015,5,13,133,20,43.7163,-69.73462,241,122,119,191,50,"ME",16.506
"2836",513,"SP15.39","ME",2015,5,13,133,20,43.72972,-69.69877,250,121,129,113,137,"ME",16.804
"2837",513,"SP15.4","ME",2015,5,4,124,20,42.97902,-70.66422,22,13,9,21,1,"ME",16.272
"2838",513,"SP15.40","ME",2015,5,14,134,18,43.72018,-69.55032,174,98,76,58,116,"ME",12.6576
"2839",513,"SP15.41","ME",2015,5,14,134,15,43.60958,-69.41302,5,4,1,4,1,"ME",8.9835
"2840",513,"SP15.42","ME",2015,5,14,134,20,43.5775,-69.4548,5,4,1,4,1,"ME",16.232
"2841",513,"SP15.43","ME",2015,5,14,134,20,43.58653,-69.55565,6,4,2,6,0,"ME",16.58
"2842",513,"SP15.44","ME",2015,5,14,134,20,43.55465,-69.6213,4,3,1,4,0,"ME",16.868
"2843",513,"SP15.45","ME",2015,5,15,135,15,43.81577,-69.48515,206,106,100,66,140,"ME",8.7945
"2844",513,"SP15.46","ME",2015,5,15,135,20,43.87983,-69.46857,181,100,81,72,109,"ME",16.75
"2845",513,"SP15.47","ME",2015,5,15,135,20,43.80225,-69.3608,289,170,118,97,192,"ME",16.332
"2846",513,"SP15.48","ME",2015,5,15,135,20,43.73418,-69.34048,188,100,88,118,70,"ME",16.406
"2847",513,"SP15.49","ME",2015,5,15,135,15,43.75812,-69.46835,93,48,45,61,32,"ME",9.384
"2848",513,"SP15.5","ME",2015,5,4,124,13,42.98737,-70.67817,2,1,1,2,0,"ME",6.5793
"2849",512,"SP15.50","ME",2015,5,18,138,20,43.75787,-69.21068,152,72,80,66,86,"ME",17.24
"2850",512,"SP15.51","ME",2015,5,18,138,20,43.81167,-69.11563,278,139,139,100,178,"ME",16.748
"2851",512,"SP15.52","ME",2015,5,18,138,20,43.8617,-69.08253,248,129,119,74,174,"ME",15.878
"2852",512,"SP15.53","ME",2015,5,18,138,20,43.92997,-69.18222,282,117,165,147,135,"ME",16.088
"2853",512,"SP15.54","ME",2015,5,18,138,16,43.93918,-69.1215,339,153,186,128,211,"ME",10.3632
"2854",512,"SP15.55","ME",2015,5,19,139,20,44.1306,-69.053,315,129,186,225,90,"ME",16.34
"2855",512,"SP15.56","ME",2015,5,19,139,17,44.21583,-69.03937,108,39,69,91,17,"ME",12.0853
"2856",512,"SP15.57","ME",2015,5,19,139,20,44.30767,-68.93107,23,5,18,18,5,"ME",16.636
"2857",512,"SP15.58","ME",2015,5,19,139,20,44.16867,-68.9468,257,97,160,203,54,"ME",16.688
"2858",512,"SP15.59","ME",2015,5,19,139,20,44.26933,-68.85928,13,3,10,12,1,"ME",17.744
"2859",513,"SP15.6","ME",2015,5,5,125,20,42.99963,-70.40678,15,5,10,14,1,"ME",16.56
"2860",512,"SP15.60","ME",2015,5,19,139,20,44.12475,-69.01983,387,196,191,251,136,"ME",17.68
"2861",512,"SP15.61","ME",2015,5,20,140,15,43.82003,-69.06168,197,105,92,63,134,"ME",9.555
"2862",513,"SP15.62","ME",2015,5,20,140,20,43.64283,-69.22143,6,4,2,6,0,"ME",16.956
"2863",513,"SP15.63","ME",2015,5,20,140,20,43.56218,-69.0861,5,5,0,5,0,"ME",16.228
"2864",512,"SP15.64","ME",2015,5,20,140,20,43.6805,-68.85823,78,50,28,78,0,"ME",16.928
"2865",512,"SP15.65","ME",2015,5,20,140,20,43.7232,-68.81102,51,36,15,51,0,"ME",17.234
"2866",512,"SP15.66","ME",2015,5,21,141,20,43.91132,-68.58785,155,66,89,127,28,"ME",15.924
"2867",512,"SP15.67","ME",2015,5,21,141,20,43.84402,-68.62865,214,124,90,194,20,"ME",17.034
"2868",512,"SP15.68","ME",2015,5,21,141,20,43.77015,-68.65142,78,41,37,77,1,"ME",16.96
"2869",512,"SP15.69","ME",2015,5,21,141,15,43.77045,-68.72107,89,62,27,83,6,"ME",9.048
"2870",513,"SP15.7","ME",2015,5,5,125,20,43.07908,-70.36093,90,37,53,87,3,"ME",17.404
"2871",512,"SP15.70","ME",2015,5,21,141,20,43.76533,-68.78353,182,92,90,133,49,"ME",15.77
"2872",512,"SP15.71","ME",2015,5,22,142,20,43.93398,-68.77642,510,245,265,158,352,"ME",16.004
"2873",512,"SP15.72","ME",2015,5,22,142,18,43.987,-68.75417,574,305,269,180,394,"ME",13.5972
"2874",512,"SP15.73","ME",2015,5,22,142,17,44.04253,-68.67763,303,166,137,127,176,"ME",12.6191
"2875",512,"SP15.74","ME",2015,5,22,142,17,44.15828,-68.7675,431,198,233,255,176,"ME",12.5834
"2876",512,"SP15.75","ME",2015,5,25,145,20,44.00513,-68.48405,477,247,230,307,170,"ME",17.006
"2877",512,"SP15.76","ME",2015,5,25,145,20,44.01643,-68.34947,380,185,195,282,98,"ME",16.52
"2878",512,"SP15.77","ME",2015,5,25,145,20,43.94917,-68.4069,78,36,42,73,5,"ME",15.604
"2879",512,"SP15.78","ME",2015,5,25,145,20,43.89327,-68.42633,30,22,8,29,1,"ME",17.644
"2880",512,"SP15.79","ME",2015,5,25,145,20,43.86333,-68.41358,19,15,4,19,0,"ME",17.442
"2881",513,"SP15.8","ME",2015,5,5,125,20,43.1206,-70.38718,50,23,27,46,4,"ME",16.742
"2882",512,"SP15.80","ME",2015,5,25,145,20,43.85332,-68.4949,32,23,9,31,1,"ME",16.26
"2883",512,"SP15.81","ME",2015,5,26,146,16,44.15648,-68.54283,365,165,200,236,129,"ME",10.1168
"2884",512,"SP15.82","ME",2015,5,26,146,20,44.22998,-68.46022,319,127,192,153,166,"ME",15.742
"2885",512,"SP15.83","ME",2015,5,26,146,20,44.36788,-68.45048,43,10,33,41,2,"ME",16.596
"2886",512,"SP15.84","ME",2015,5,26,146,20,44.38752,-68.40415,2,1,1,2,0,"ME",17.058
"2887",512,"SP15.85","ME",2015,5,26,146,17,44.2048,-68.3652,579,215,364,389,190,"ME",11.2353
"2888",512,"SP15.86","ME",2015,5,27,147,13,44.20673,-68.3118,233,103,130,155,78,"ME",6.903
"2889",512,"SP15.87","ME",2015,5,27,147,20,44.05677,-68.11775,223,120,103,170,53,"ME",16.846
"2890",512,"SP15.88","ME",2015,5,27,147,20,44.01353,-68.03802,97,73,24,97,0,"ME",16.06
"2891",512,"SP15.89","ME",2015,5,27,147,20,43.99437,-68.08677,192,110,82,112,80,"ME",17.308
"2892",513,"SP15.9","ME",2015,5,5,125,20,43.08045,-70.41273,49,27,22,45,4,"ME",16.49
"2893",512,"SP15.90","ME",2015,5,27,147,16,43.95372,-68.11397,251,147,103,98,153,"ME",10.7968
"2894",512,"SP15.91","ME",2015,5,28,148,20,44.14393,-68.11362,459,222,237,212,247,"ME",17.116
"2895",512,"SP15.92","ME",2015,5,28,148,20,44.17105,-68.00452,183,96,87,128,55,"ME",17.28
"2896",512,"SP15.93","ME",2015,5,28,148,20,44.1896,-67.91645,171,104,67,145,26,"ME",17.372
"2897",512,"SP15.94","ME",2015,5,28,148,20,44.1478,-67.90198,162,90,72,151,11,"ME",18.176
"2898",512,"SP15.95","ME",2015,5,29,149,20,44.31758,-68.15727,525,271,254,268,257,"ME",17.374
"2899",512,"SP15.96","ME",2015,5,29,149,20,44.34533,-68.11455,281,134,147,123,158,"ME",16.95
"2900",512,"SP15.97","ME",2015,5,29,149,20,44.3017,-68.06657,632,269,363,230,402,"ME",16.038
"2901",512,"SP15.98","ME",2015,5,29,149,20,44.26763,-68.02318,366,186,180,119,247,"ME",16.642
"2902",512,"SP15.99","ME",2015,5,29,149,20,44.2273,-68.13418,528,249,279,158,370,"ME",16.912
"2903",513,"SP16.1","ME",2016,5,2,123,20,42.98842,-70.49923,72,28,44,65,7,"ME",16.6
"2904",513,"SP16.10","ME",2016,5,3,124,20,43.11785,-70.2431,15,8,7,15,0,"ME",16.6
"2905",511,"SP16.100","ME",2016,5,30,151,20,44.20862,-67.7619,48,35,13,48,0,"ME",17
"2906",511,"SP16.101","ME",2016,5,30,151,12,44.29153,-67.79918,75,39,36,47,28,"ME",5.88
"2907",511,"SP16.102","ME",2016,5,31,152,20,44.36423,-67.68867,588,263,325,400,188,"ME",16.4
"2908",511,"SP16.103","ME",2016,5,31,152,20,44.33812,-67.62218,431,211,220,377,54,"ME",17.4
"2909",511,"SP16.104","ME",2016,5,31,152,20,44.3679,-67.74105,332,175,157,192,140,"ME",17.2
"2910",511,"SP16.105","ME",2016,5,31,152,20,44.42072,-67.76583,333,159,174,160,173,"ME",16
"2911",511,"SP16.106","ME",2016,5,31,152,20,44.41782,-67.74045,478,222,256,160,318,"ME",17.4
"2912",511,"SP16.107","ME",2016,5,31,152,13,44.50095,-67.70087,724,343,381,278,446,"ME",7.15
"2913",511,"SP16.108","ME",2016,6,1,153,20,44.24982,-67.4729,15,13,2,13,2,"ME",18
"2914",511,"SP16.109","ME",2016,6,1,153,20,44.32117,-67.3784,23,17,6,23,0,"ME",17
"2915",513,"SP16.11","ME",2016,5,3,124,12,43.03562,-70.36698,15,8,7,14,1,"ME",6
"2916",511,"SP16.110","ME",2016,6,1,153,16,44.35892,-67.41702,23,11,12,23,0,"ME",10.56
"2917",511,"SP16.111","ME",2016,6,1,153,20,44.41255,-67.48653,299,158,141,223,76,"ME",17.2
"2918",511,"SP16.112","ME",2016,6,2,154,16,44.56907,-67.41735,67,35,32,52,15,"ME",10.72
"2919",511,"SP16.113","ME",2016,6,2,154,20,44.51243,-67.4309,274,119,155,166,108,"ME",17
"2920",511,"SP16.114","ME",2016,6,2,154,16,44.46675,-67.36175,128,65,63,79,49,"ME",10.4
"2921",511,"SP16.115","ME",2016,6,2,154,20,44.53028,-67.29433,135,64,71,69,66,"ME",18.2
"2922",511,"SP16.116","ME",2016,6,2,154,20,44.56653,-67.27107,186,89,97,136,50,"ME",16.8
"2923",511,"SP16.117","ME",2016,6,2,154,12,44.60617,-67.2543,272,127,145,191,81,"ME",6.36
"2924",511,"SP16.118","ME",2016,6,2,154,20,44.58682,-67.30342,237,105,132,147,90,"ME",18.8
"2925",511,"SP16.119","ME",2016,6,3,155,16,44.6191,-67.20343,458,220,238,219,239,"ME",11.2
"2926",513,"SP16.12","ME",2016,5,3,124,20,43.1511666,-70.38065,159,81,78,108,51,"ME",16.4
"2927",511,"SP16.120","ME",2016,6,3,155,20,44.6799,-67.11987,160,79,81,119,41,"ME",16.8
"2928",511,"SP16.121","ME",2016,6,3,155,13,44.68918,-67.13147,27,14,13,24,3,"ME",6.76
"2929",511,"SP16.122","ME",2016,6,3,155,20,44.664,-67.12197,257,118,139,185,72,"ME",19.2
"2930",513,"SP16.13","ME",2016,5,4,125,15,43.18002,-70.38842,71,35,36,52,19,"ME",9.3
"2931",513,"SP16.14","ME",2016,5,4,125,19,43.17562,-70.43843,173,76,97,115,58,"ME",15.39
"2932",513,"SP16.15","ME",2016,5,4,125,20,43.24617,-70.50112,174,73,101,111,63,"ME",16.8
"2933",513,"SP16.16","ME",2016,5,4,125,18,43.31028,-70.54098,10,4,6,7,3,"ME",13.14
"2934",513,"SP16.17","ME",2016,5,4,125,20,43.2123,-70.57178,11,3,8,7,4,"ME",17.2
"2935",513,"SP16.18","ME",2016,5,5,126,20,43.27072,-70.15222,14,7,7,12,2,"ME",16.8
"2936",513,"SP16.19","ME",2016,5,5,126,20,43.39898,-70.04208,10,8,2,10,0,"ME",16.4
"2937",513,"SP16.2","ME",2016,5,2,123,20,42.94143,-70.45088,19,14,5,18,1,"ME",17
"2938",513,"SP16.20","ME",2016,5,5,126,20,43.4531,-70.08637,58,36,22,45,13,"ME",17
"2939",513,"SP16.21","ME",2016,5,6,127,15,43.50025,-70.20792,289,110,179,125,164,"ME",7.95
"2940",513,"SP16.22","ME",2016,5,6,127,16,43.44058,-70.31402,211,122,89,190,21,"ME",11.52
"2941",513,"SP16.23","ME",2016,5,6,127,20,43.41733,-70.23723,160,59,101,107,53,"ME",16.6
"2942",513,"SP16.24","ME",2016,5,6,127,20,43.43113,-70.20635,80,32,48,60,20,"ME",17.2
"2943",513,"SP16.25","ME",2016,5,9,130,14,43.54887,-70.00282,92,40,52,59,33,"ME",8.12
"2944",513,"SP16.26","ME",2016,5,9,130,20,43.44585,-69.82555,2,2,0,2,0,"ME",15.8
"2945",513,"SP16.27","ME",2016,5,9,130,20,43.49408,-69.75165,12,7,5,12,0,"ME",17.6
"2946",513,"SP16.28","ME",2016,5,9,130,20,43.48303,-69.94628,22,15,7,22,0,"ME",16.8
"2947",513,"SP16.29","ME",2016,5,9,130,20,43.50057,-70.02453,33,20,13,29,4,"ME",17.4
"2948",513,"SP16.3","ME",2016,5,2,123,20,42.95422,-70.64178,105,59,46,62,43,"ME",16.6
"2949",513,"SP16.30","ME",2016,5,10,131,20,43.71848,-70.09507,608,285,323,243,365,"ME",17.2
"2950",513,"SP16.31","ME",2016,5,10,131,20,43.78953,-70.05397,37,11,26,21,16,"ME",17.2
"2951",513,"SP16.32","ME",2016,5,10,131,20,43.71977,-70.01255,44,21,23,34,10,"ME",17.8
"2952",513,"SP16.33","ME",2016,5,10,131,20,43.64932,-70.00928,165,87,78,108,57,"ME",16.6
"2953",513,"SP16.34","ME",2016,5,10,131,20,43.68063,-69.94742,410,211,199,179,231,"ME",16.8
"2954",513,"SP16.35","ME",2016,5,10,131,20,43.70007,-69.84453,221,110,111,189,32,"ME",16.8
"2955",513,"SP16.36","ME",2016,5,11,132,20,43.8061,-69.64397,159,75,84,53,106,"ME",17.2
"2956",513,"SP16.37","ME",2016,5,11,132,20,43.7554,-69.73858,109,54,55,86,23,"ME",17.8
"2957",513,"SP16.38","ME",2016,5,11,132,17,43.72888,-69.69643,215,117,98,77,138,"ME",11.73
"2958",513,"SP16.39","ME",2016,5,11,132,14,43.597,-69.71248,77,43,34,61,16,"ME",8.4
"2959",513,"SP16.4","ME",2016,5,2,123,20,42.98252,-70.64627,85,39,46,76,9,"ME",17.4
"2960",513,"SP16.40","ME",2016,5,11,132,20,43.5609,-69.78492,39,17,22,35,4,"ME",16.8
"2961",513,"SP16.41","ME",2016,5,11,132,20,43.68785,-69.6563,251,123,128,77,174,"ME",16.8
"2962",513,"SP16.42","ME",2016,5,12,133,20,43.78458,-69.49163,311,159,152,102,209,"ME",17.4
"2963",513,"SP16.43","ME",2016,5,12,133,20,43.80898,-69.43718,266,139,127,90,176,"ME",16.4
"2964",513,"SP16.44","ME",2016,5,12,133,17,43.81262,-69.35458,416,219,197,135,281,"ME",12.07
"2965",512,"SP16.45","ME",2016,5,12,133,16,43.84815,-69.28747,540,249,290,232,308,"ME",10.88
"2966",512,"SP16.46","ME",2016,5,12,133,20,43.87095,-69.32837,63,30,33,36,27,"ME",17.2
"2967",513,"SP16.47","ME",2016,5,13,134,19,43.65503,-69.4569,50,30,20,44,6,"ME",15.2
"2968",513,"SP16.48","ME",2016,5,13,134,20,43.72778,-69.45082,124,64,60,93,31,"ME",17.2
"2969",512,"SP16.49","ME",2016,5,15,136,20,43.76347,-69.21552,271,131,140,111,160,"ME",15.8
"2970",513,"SP16.5","ME",2016,5,2,123,20,42.93255,-70.74533,56,21,35,36,20,"ME",16.8
"2971",512,"SP16.50","ME",2016,5,15,136,20,43.88858,-69.22723,480,205,275,192,288,"ME",17
"2972",512,"SP16.51","ME",2016,5,15,136,20,44.16198,-69.07485,158,70,88,85,73,"ME",16.2
"2973",512,"SP16.52","ME",2016,5,15,136,20,44.15048,-69.00838,342,153,189,177,165,"ME",17
"2974",512,"SP16.53","ME",2016,5,17,138,20,44.20107,-68.87637,182,67,115,148,34,"ME",17.8
"2975",512,"SP16.54","ME",2016,5,17,138,20,44.24815,-68.80012,24,6,18,22,2,"ME",15.8
"2976",512,"SP16.55","ME",2016,5,17,138,20,44.25378,-68.73072,38,17,21,29,9,"ME",17.4
"2977",512,"SP16.56","ME",2016,5,17,138,20,44.31597,-68.92048,63,20,43,51,12,"ME",16.6
"2978",512,"SP16.57","ME",2016,5,18,139,13,43.87253,-69.03523,823,427,396,220,603,"ME",7.28
"2979",512,"SP16.58","ME",2016,5,18,139,20,43.80147,-69.04112,317,152,165,141,176,"ME",17.6
"2980",512,"SP16.59","ME",2016,5,18,139,20,43.75377,-69.07407,270,119,151,174,96,"ME",17.4
"2981",513,"SP16.6","ME",2016,5,2,123,20,43.0298,-70.69495,47,13,34,37,10,"ME",16.6
"2982",512,"SP16.60","ME",2016,5,18,139,16,43.7226,-69.0949,82,48,34,74,8,"ME",11.2
"2983",513,"SP16.61","ME",2016,5,18,139,20,43.63713,-69.14038,52,38,14,52,0,"ME",16.8
"2984",513,"SP16.62","ME",2016,5,18,139,20,43.60717,-69.05623,30,22,8,30,0,"ME",16.4
"2985",512,"SP16.63","ME",2016,5,18,139,16,43.6216,-68.93537,17,9,8,17,0,"ME",10.56
"2986",512,"SP16.64","ME",2016,5,19,140,20,43.90383,-68.75627,584,254,330,280,304,"ME",16
"2987",512,"SP16.65","ME",2016,5,19,140,17,43.78322,-68.69877,126,67,59,113,13,"ME",12.41
"2988",512,"SP16.66","ME",2016,5,19,140,20,43.80412,-68.56893,35,19,16,35,0,"ME",18.4
"2989",512,"SP16.67","ME",2016,5,19,140,20,43.78262,-68.63563,41,22,19,40,1,"ME",17.4
"2990",512,"SP16.68","ME",2016,5,19,140,20,43.88892,-68.67888,255,122,133,131,124,"ME",17.2
"2991",512,"SP16.69","ME",2016,5,20,141,20,43.9871,-68.75298,950,467,483,349,601,"ME",17.8
"2992",513,"SP16.7","ME",2016,5,3,124,20,43.0786,-70.48743,81,43,38,72,9,"ME",16.2
"2993",512,"SP16.70","ME",2016,5,20,141,20,43.92675,-68.64988,303,140,163,168,135,"ME",17.2
"2994",512,"SP16.71","ME",2016,5,20,141,20,43.94363,-68.67627,493,238,255,272,221,"ME",16.8
"2995",512,"SP16.72","ME",2016,5,20,141,20,44.15015,-68.7866,254,99,155,183,71,"ME",17.8
"2996",512,"SP16.73","ME",2016,5,20,141,20,44.14503,-68.75973,382,171,211,231,151,"ME",17.4
"2997",512,"SP16.74","ME",2016,5,23,144,18,43.83623,-68.47715,28,20,8,28,0,"ME",14.22
"2998",512,"SP16.75","ME",2016,5,23,144,20,43.91342,-68.41745,75,45,30,66,9,"ME",16.8
"2999",512,"SP16.76","ME",2016,5,23,144,18,43.98383,-68.50948,340,175,165,149,191,"ME",13.14
"3000",512,"SP16.77","ME",2016,5,23,144,20,44.04237,-68.54115,925,506,419,389,536,"ME",16.4
"3001",512,"SP16.78","ME",2016,5,24,145,14,44.1306,-68.4834,228,119,109,161,67,"ME",7.98
"3002",512,"SP16.79","ME",2016,5,24,145,20,44.24438,-68.43138,863,349,514,383,480,"ME",17.4
"3003",513,"SP16.8","ME",2016,5,3,124,20,43.11938,-70.39175,129,60,69,98,31,"ME",16.4
"3004",512,"SP16.80","ME",2016,5,24,145,20,44.35998,-68.4837,19,8,11,17,2,"ME",17.2
"3005",512,"SP16.81","ME",2016,5,24,145,20,44.27738,-68.47413,388,166,222,209,179,"ME",17.8
"3006",512,"SP16.82","ME",2016,5,24,145,16,44.21712,-68.32272,747,345,402,425,322,"ME",11.36
"3007",512,"SP16.83","ME",2016,5,25,146,20,44.09093,-68.29717,711,406,305,498,213,"ME",18
"3008",512,"SP16.84","ME",2016,5,25,146,20,43.96623,-68.33973,168,96,72,149,19,"ME",17.8
"3009",512,"SP16.85","ME",2016,5,25,146,20,43.93398,-68.32227,88,61,27,86,2,"ME",18
"3010",512,"SP16.86","ME",2016,5,25,146,20,44.03688,-68.27212,180,88,92,130,50,"ME",18
"3011",512,"SP16.87","ME",2016,5,25,146,20,44.13867,-68.1234,304,164,140,109,195,"ME",17.2
"3012",512,"SP16.88","ME",2016,5,26,147,20,44.17803,-68.05123,344,164,180,200,144,"ME",17.2
"3013",512,"SP16.89","ME",2016,5,26,147,20,44.05945,-68.00442,65,40,25,58,7,"ME",16.2
"3014",513,"SP16.9","ME",2016,5,3,124,20,43.11742,-70.30205,38,18,20,37,1,"ME",17.4
"3015",512,"SP16.90","ME",2016,5,26,147,20,44.02228,-67.9181,38,31,7,37,1,"ME",17
"3016",512,"SP16.91","ME",2016,5,26,147,20,44.12867,-68.01238,282,133,149,223,59,"ME",17.4
"3017",512,"SP16.92","ME",2016,5,26,147,20,44.10282,-68.09042,265,141,124,212,53,"ME",16.8
"3018",512,"SP16.93","ME",2016,5,27,148,20,44.29008,-68.1778,858,420,438,336,522,"ME",17.4
"3019",512,"SP16.94","ME",2016,5,27,148,20,44.29573,-68.05503,481,227,254,146,335,"ME",18
"3020",512,"SP16.95","ME",2016,5,27,148,20,44.39468,-68.11435,334,159,175,60,274,"ME",17
"3021",512,"SP16.96","ME",2016,5,27,148,20,44.43595,-68.15507,509,215,294,187,322,"ME",17.2
"3022",512,"SP16.97","ME",2016,5,27,148,20,44.3713,-68.15253,858,383,475,275,583,"ME",17.4
"3023",512,"SP16.98","ME",2016,5,30,151,20,44.23622,-67.8728,272,140,132,204,68,"ME",18.8
"3024",511,"SP16.99","ME",2016,5,30,151,20,44.1947,-67.83152,48,23,25,44,4,"ME",16.6
"3025",513,"FL15.10","ME",2015,9,29,272,20,43.0019,-70.4103,0,0,0,0,0,"ME",NA
"3026",513,"FL15.11","ME",2015,9,30,273,20,43.1228,-70.3851,0,0,0,0,0,"ME",NA
"3027",513,"FL15.27","ME",2015,10,7,280,20,43.58752,-69.55592,0,0,0,0,0,"ME",NA
"3028",513,"FL15.28","ME",2015,10,7,280,20,43.55497,-69.62072,0,0,0,0,0,"ME",NA
"3029",513,"FL16.13","ME",2016,9,29,273,20,43.2715,-70.14863,0,0,0,0,0,"ME",NA
"3030",513,"FL16.14","ME",2016,9,29,273,20,43.38875,-70.08195,0,0,0,0,0,"ME",NA
"3031",513,"FL16.24","ME",2016,10,3,277,20,43.46052,-69.83697,0,0,0,0,0,"ME",NA
"3032",513,"FL00.15","ME",2000,11,4,309,20,43.50518,-70.04458,0,0,0,0,0,"ME",18.6
"3033",512,"FL00.36","ME",2000,11,14,319,20,44.41567,-68.83356,0,0,0,0,0,"ME",19.54
"3034",512,"FL00.43","ME",2000,11,20,325,20,44.1417,-68.7586,0,0,0,0,0,"ME",18.2
"3035",512,"FL00.51","ME",2000,11,22,327,20,44.3695,-68.4827,0,0,0,0,0,"ME",20.2
"3036",512,"FL00.57","ME",2000,11,28,333,20,44.4063,-68.2264,0,0,0,0,0,"ME",6.6
"3037",512,"FL00.58","ME",2000,11,28,333,20,44.4434,-68.297,0,0,0,0,0,"ME",19
"3038",512,"FL00.59","ME",2000,11,29,334,20,44.1614,-67.8835,0,0,0,0,0,"ME",23.8
"3039",513,"FL01.5","ME",2001,9,25,268,20,43.0499,-70.3564,0,0,0,0,0,"ME",17.6
"3040",513,"FL01.13","ME",2001,9,27,270,18,43.4037,-70.1359,0,0,0,0,0,"ME",16.2
"3041",513,"FL01.32","ME",2001,10,4,277,20,43.7113,-69.5309,0,0,0,0,0,"ME",17.4
"3042",512,"FL01.44","ME",2001,10,10,283,20,43.6149,-68.9355,0,0,0,0,0,"ME",18.6
"3043",512,"FL01.57","ME",2001,10,16,289,16,44.3642,-68.4875,0,0,0,0,0,"ME",14.08
"3044",512,"FL01.66","ME",2001,10,20,293,20,44.0565,-68.0511,0,0,0,0,0,"ME",17
"3045",512,"FL01.69","ME",2001,10,20,293,20,44.2127,-68.0761,0,0,0,0,0,"ME",18.6
"3046",512,"FL01.70","ME",2001,10,22,295,21,44.2493,-67.9102,0,0,0,0,0,"ME",18.69
"3047",511,"FL01.71","ME",2001,10,23,296,20,44.3003,-67.4955,0,0,0,0,0,"ME",21.6
"3048",511,"FL01.72","ME",2001,10,23,296,21,44.3026,-67.6796,0,0,0,0,0,"ME",20.79
"3049",511,"FL01.73","ME",2001,10,23,296,20,44.3187,-67.7258,0,0,0,0,0,"ME",19.2
"3050",511,"FL01.74","ME",2001,10,25,298,20,44.4014,-67.0811,0,0,0,0,0,"ME",17.6
"3051",511,"FL01.75","ME",2001,10,25,298,22,44.4016,-67.0365,0,0,0,0,0,"ME",21.12
"3052",513,"FL02.5","ME",2002,10,15,288,21,42.91822,-70.50203,0,0,0,0,0,"ME",19.95
"3053",512,"FL02.41","ME",2002,10,30,303,20,44.3285,-68.85253,0,0,0,0,0,"ME",15.8
"3054",512,"FL02.42","ME",2002,10,30,303,20,44.26233,-68.79,0,0,0,0,0,"ME",15.6
"3055",513,"FL03.5","ME",2003,10,13,286,20,42.9405,-70.3935,0,0,0,0,0,"ME",15.4
"3056",513,"FL03.7","ME",2003,10,14,287,20,43.03333,-70.34867,0,0,0,0,0,"ME",16.2
"3057",513,"FL03.8","ME",2003,10,14,287,22,43.0815,-70.30283,0,0,0,0,0,"ME",16.28
"3058",513,"FL03.10","ME",2003,10,16,289,20,43.39483,-70.1205,0,0,0,0,0,"ME",15.6
"3059",513,"FL03.17","ME",2003,10,20,293,20,43.42633,-69.93067,0,0,0,0,0,"ME",14
"3060",513,"FL03.18","ME",2003,10,20,293,16,43.51633,-69.91833,0,0,0,0,0,"ME",8.96
"3061",513,"FL03.30","ME",2003,10,24,297,20,43.64033,-69.43983,0,0,0,0,0,"ME",16
"3062",513,"FL03.38","ME",2003,11,1,305,20,43.5855,-69.07817,0,0,0,0,0,"ME",15.2
"3063",512,"FL03.50","ME",2003,11,5,309,20,44.37867,-68.53317,0,0,0,0,0,"ME",14.2
"3064",511,"FL03.69","ME",2003,11,12,316,20,44.31317,-67.37617,0,0,0,0,0,"ME",15.8
"3065",511,"FL03.77","ME",2003,11,18,322,20,44.598,-67.43967,0,0,0,0,0,"ME",15.2
"3066",513,"FL04.8","ME",2004,10,13,287,20,43.08483,-70.3005,0,0,0,0,0,"ME",16.4
"3067",513,"FL04.12","ME",2004,10,14,288,20,43.13583,-70.19417,0,0,0,0,0,"ME",15.2
"3068",513,"FL04.14","ME",2004,10,14,288,20,43.3175,-70.16183,0,0,0,0,0,"ME",13.4
"3069",513,"FL04.20","ME",2004,10,18,292,21,43.50148,-70.00898,0,0,0,0,0,"ME",15.75
"3070",513,"FL04.21","ME",2004,10,18,292,20,43.42247,-69.9337,0,0,0,0,0,"ME",15
"3071",513,"FL04.22","ME",2004,10,18,292,20,43.50575,-69.79512,0,0,0,0,0,"ME",15.2
"3072",513,"FL04.28","ME",2004,10,20,294,20,43.60157,-69.71042,0,0,0,0,0,"ME",15.8
"3073",513,"FL04.34","ME",2004,10,21,295,20,43.68253,-69.51282,0,0,0,0,0,"ME",15.2
"3074",512,"FL04.47","ME",2004,10,27,301,20,44.26167,-68.80258,0,0,0,0,0,"ME",18
"3075",512,"FL04.63","ME",2004,11,3,308,15,44.38515,-68.41463,0,0,0,0,0,"ME",9.75
"3076",511,"FL04.79","ME",2004,11,10,315,20,44.31997,-67.36917,0,0,0,0,0,"ME",15.8
"3077",513,"FL05.6","ME",2005,10,11,284,20,42.96033,-70.34767,0,0,0,0,0,"ME",17.08
"3078",513,"FL05.10","ME",2005,10,17,290,20,43.401,-70.13,0,0,0,0,0,"ME",15.8
"3079",513,"FL05.17","ME",2005,10,19,292,20,43.54,-69.69133,0,0,0,0,0,"ME",15.9
"3080",513,"FL05.22","ME",2005,10,21,294,14,43.59933,-69.25967,0,0,0,0,0,"ME",7.924
"3081",512,"FL05.45","ME",2005,11,2,306,17,44.369,-68.448,0,0,0,0,0,"ME",11.067
"3082",513,"FL06.6","ME",2006,10,3,276,20,42.90008,-70.3847,0,0,0,0,0,"ME",15.66
"3083",513,"FL06.7","ME",2006,10,3,276,20,42.94148,-70.38945,0,0,0,0,0,"ME",16.1
"3084",513,"FL06.32","ME",2006,10,11,284,20,43.56695,-69.60853,0,0,0,0,0,"ME",15.48
"3085",512,"FL06.53","ME",2006,10,18,291,20,44.26052,-68.80188,0,0,0,0,0,"ME",16.66
"3086",512,"FL06.56","ME",2006,10,19,292,20,43.82383,-68.56413,0,0,0,0,0,"ME",15.94
"3087",513,"FL07.6","ME",2007,10,2,275,20,42.8775833,-70.4433333,0,0,0,0,0,"ME",15.4
"3088",513,"FL07.25","ME",2007,10,8,281,20,43.50593,-69.88257,0,0,0,0,0,"ME",15.56
"3089",513,"FL07.26","ME",2007,10,9,282,20,43.47038,-69.78937,0,0,0,0,0,"ME",14.78
"3090",513,"FL07.27","ME",2007,10,9,282,20,43.56447,-69.78372,0,0,0,0,0,"ME",16.42
"3091",513,"FL07.35","ME",2007,10,11,284,20,43.68367,-69.51427,0,0,0,0,0,"ME",16.88
"3092",513,"FL07.36","ME",2007,10,11,284,20,43.62692,-69.46958,0,0,0,0,0,"ME",16.82
"3093",513,"FL07.44","ME",2007,10,16,289,20,43.60838,-69.1375,0,0,0,0,0,"ME",15.86
"3094",513,"FL07.45","ME",2007,10,16,289,20,43.55587,-69.05078,0,0,0,0,0,"ME",16.76
"3095",512,"FL07.65","ME",2007,10,24,297,20,43.84885,-68.39125,0,0,0,0,0,"ME",17.3
"3096",512,"FL07.73","ME",2007,10,26,299,20,44.0629,-67.85395,0,0,0,0,0,"ME",17.56
"3097",511,"FL07.81","ME",2007,10,31,304,19,44.15265,-67.77795,0,0,0,0,0,"ME",14.573
"3098",511,"FL07.82","ME",2007,10,31,304,20,44.1955,-67.56205,0,0,0,0,0,"ME",16.66
"3099",511,"FL07.83","ME",2007,10,31,304,20,44.29412,-67.50898,0,0,0,0,0,"ME",16.28
"3100",513,"FL08.6","ME",2008,10,1,275,20,42.97912,-70.37343,0,0,0,0,0,"ME",16.88
"3101",513,"FL08.21","ME",2008,10,7,281,20,43.47298,-69.95195,0,0,0,0,0,"ME",16.5
"3102",513,"FL08.22","ME",2008,10,7,281,20,43.47543,-69.88833,0,0,0,0,0,"ME",16.54
"3103",513,"FL08.23","ME",2008,10,7,281,20,43.50712,-69.88127,0,0,0,0,0,"ME",16.38
"3104",513,"FL08.28","ME",2008,10,8,282,20,43.54413,-69.69232,0,0,0,0,0,"ME",16.58
"3105",513,"FL08.42","ME",2008,10,15,289,20,43.58162,-69.08093,0,0,0,0,0,"ME",16.16
"3106",513,"FL08.43","ME",2008,10,15,289,20,43.55777,-69.05173,0,0,0,0,0,"ME",16.14
"3107",512,"FL08.60","ME",2008,10,23,297,20,43.92442,-68.13517,0,0,0,0,0,"ME",16.06
"3108",511,"FL08.69","ME",2008,10,28,302,20,44.15775,-67.7853,0,0,0,0,0,"ME",15.76
"3109",513,"FL09.12","ME",2009,10,7,280,20,43.24105,-70.1774,0,0,0,0,0,"ME",17.2
"3110",513,"FL09.13","ME",2009,10,7,280,20,43.36233,-70.10673,0,0,0,0,0,"ME",17.32
"3111",513,"FL09.14","ME",2009,10,7,280,20,43.4019,-70.13012,0,0,0,0,0,"ME",17.5
"3112",513,"FL09.21","ME",2009,10,12,285,20,43.47117,-70.02542,0,0,0,0,0,"ME",16.5
"3113",513,"FL09.22","ME",2009,10,12,285,20,43.46987,-69.94075,0,0,0,0,0,"ME",17.44
"3114",513,"FL09.23","ME",2009,10,12,285,17,43.57873,-69.80213,0,0,0,0,0,"ME",12.087
"3115",513,"FL09.38","ME",2009,10,15,288,20,43.6081,-69.5476,0,0,0,0,0,"ME",16.72
"3116",513,"FL10.8","ME",2010,10,7,280,20,42.95902,-70.4227,0,0,0,0,0,"ME",16.554
"3117",513,"FL10.19","ME",2010,10,11,284,20,43.4622,-69.83425,0,0,0,0,0,"ME",16.194
"3118",513,"FL10.38","ME",2010,10,14,287,20,43.57185,-69.63175,0,0,0,0,0,"ME",16.304
"3119",513,"FL11.15","ME",2011,10,7,280,20,43.39812,-70.04138,0,0,0,0,0,"ME",16.8
"3120",513,"FL11.31","ME",2011,10,12,285,20,43.5126,-69.7106,0,0,0,0,0,"ME",17.4
"3121",512,"FL11.56","ME",2011,10,25,298,19,44.3908,-68.40112,0,0,0,0,0,"ME",14.82
"3122",513,"FL12.37","ME",2012,10,4,278,20,43.57222,-69.56172,0,0,0,0,0,"ME",15.83
"3123",512,"FL12.64","ME",2012,10,16,290,20,44.39148,-68.40205,0,0,0,0,0,"ME",17.204
"3124",513,"FL13.4","ME",2013,9,24,267,20,42.87113,-70.47702,0,0,0,0,0,"ME",15.952
"3125",513,"FL13.14","ME",2013,9,26,269,20,43.10893,-70.25717,0,0,0,0,0,"ME",16.086
"3126",513,"FL13.18","ME",2013,9,26,269,20,43.40002,-70.04338,0,0,0,0,0,"ME",15.932
"3127",513,"FL13.26","ME",2013,10,1,274,20,43.43668,-69.91945,0,0,0,0,0,"ME",16.968
"3128",513,"FL13.39","ME",2013,10,3,276,20,43.63195,-69.47723,0,0,0,0,0,"ME",16.294
"3129",511,"FL13.91","ME",2013,10,23,296,20,44.32137,-67.36763,0,0,0,0,0,"ME",16.044
"3130",513,"FL14.17","ME",2014,10,2,275,20,43.2509,-70.19502,0,0,0,0,0,"ME",15.682
"3131",513,"SP01.1","ME",2001,4,23,113,20,42.8747,-70.7338,0,0,0,0,0,"ME",14.6
"3132",513,"SP01.33","ME",2001,5,2,122,17,43.5998,-69.7104,0,0,0,0,0,"ME",11.9
"3133",512,"SP01.50","ME",2001,5,8,128,16,44.223,-68.9207,0,0,0,0,0,"ME",14.24
"3134",512,"SP01.52","ME",2001,5,8,128,20,44.3293,-68.8605,0,0,0,0,0,"ME",16.6
"3135",512,"SP01.85","ME",2001,5,18,138,20,44.1627,-67.8787,0,0,0,0,0,"ME",17.4
"3136",511,"SP01.94","ME",2001,5,22,142,20,44.2484,-67.7988,0,0,0,0,0,"ME",17.2
"3137",511,"SP01.96","ME",2001,5,22,142,20,44.2972,-67.6049,0,0,0,0,0,"ME",17.2
"3138",511,"SP01.97","ME",2001,5,22,142,20,44.3012,-67.4991,0,0,0,0,0,"ME",17.2
"3139",511,"SP01.105","ME",2001,5,24,144,18,44.405,-67.0638,0,0,0,0,0,"ME",11.52
"3140",467,"SP01.109","ME",2001,5,25,145,20,44.7537,-66.9333,0,0,0,0,0,"ME",15.4
"3141",512,"SP02.44","ME",2002,5,22,142,20,44.21067,-68.92563,0,0,0,0,0,"ME",16.4
"3142",512,"SP02.46","ME",2002,5,22,142,20,44.275,-68.7734,0,0,0,0,0,"ME",15.2
"3143",512,"SP02.65","ME",2002,5,29,149,20,44.36998,-68.48268,0,0,0,0,0,"ME",17.6
"3144",511,"SP02.94","ME",2002,6,7,158,18,44.42567,-67.14892,0,0,0,0,0,"ME",14.22
"3145",513,"SP03.7","ME",2003,5,6,126,20,43.07997,-70.30182,0,0,0,0,0,"ME",17
"3146",513,"SP03.13","ME",2003,5,8,128,20,43.30987,-70.10923,0,0,0,0,0,"ME",15
"3147",513,"SP03.23","ME",2003,5,12,132,20,43.44523,-69.8936,0,0,0,0,0,"ME",15.4
"3148",513,"SP03.35","ME",2003,5,15,135,20,43.61542,-69.55503,0,0,0,0,0,"ME",13.2
"3149",513,"SP03.36","ME",2003,5,15,135,17,43.66207,-69.5234,0,0,0,0,0,"ME",10.37
"3150",513,"SP03.37","ME",2003,5,15,135,16,43.69855,-69.51092,0,0,0,0,0,"ME",8.16
"3151",512,"SP03.48","ME",2003,5,20,140,15,44.2792,-68.8901,0,0,0,0,0,"ME",9.75
"3152",512,"SP03.49","ME",2003,5,20,140,17,44.2975,-68.85825,0,0,0,0,0,"ME",11.56
"3153",513,"SP04.28","ME",2004,5,11,132,20,43.4805,-69.96433,0,0,0,0,0,"ME",15.2
"3154",513,"SP04.29","ME",2004,5,11,132,20,43.42833,-69.92683,0,0,0,0,0,"ME",14.6
"3155",513,"SP04.30","ME",2004,5,11,132,20,43.50633,-69.7855,0,0,0,0,0,"ME",14.8
"3156",513,"SP04.32","ME",2004,5,12,133,20,43.58717,-69.80667,0,0,0,0,0,"ME",16.4
"3157",513,"SP04.40","ME",2004,5,13,134,20,43.694,-69.5115,0,0,0,0,0,"ME",15.2
"3158",512,"SP04.52","ME",2004,5,19,140,10,44.28667,-68.8465,0,0,0,0,0,"ME",4.5
"3159",512,"SP04.53","ME",2004,5,19,140,13,44.26017,-68.80233,0,0,0,0,0,"ME",6.24
"3160",512,"SP04.68","ME",2004,5,24,145,20,43.90283,-68.52883,0,0,0,0,0,"ME",15
"3161",512,"SP04.70","ME",2004,5,25,146,20,43.9365,-68.36617,0,0,0,0,0,"ME",16.2
"3162",512,"SP04.72","ME",2004,5,25,146,20,43.96667,-68.32567,0,0,0,0,0,"ME",15.4
"3163",511,"SP04.94","ME",2004,6,2,154,20,44.29217,-67.51283,0,0,0,0,0,"ME",15
"3164",513,"SP05.7","ME",2005,5,3,123,20,42.96883,-70.39933,0,0,0,0,0,"ME",14.98
"3165",513,"SP05.23","ME",2005,5,10,130,20,43.48967,-69.92183,0,0,0,0,0,"ME",15.1
"3166",512,"SP05.51","ME",2005,5,17,137,20,44.2505,-68.72383,0,0,0,0,0,"ME",16.58
"3167",511,"SP05.97","ME",2005,6,8,159,20,44.3445,-67.28717,0,0,0,0,0,"ME",16.18
"3168",513,"SP06.19","ME",2006,5,5,125,20,43.38925,-70.0884,0,0,0,0,0,"ME",17
"3169",513,"SP06.42","ME",2006,5,11,131,21,43.64253,-69.44153,0,0,0,0,0,"ME",17.703
"3170",512,"SP06.57","ME",2006,5,16,136,20,44.2574,-68.89477,0,0,0,0,0,"ME",16.96
"3171",512,"SP06.60","ME",2006,5,17,137,18,43.67828,-68.7432,0,0,0,0,0,"ME",13.158
"3172",512,"SP06.79","ME",2006,5,24,144,20,44.31998,-68.55827,0,0,0,0,0,"ME",16.42
"3173",511,"SP06.99","ME",2006,5,30,150,20,44.3134,-67.37813,0,0,0,0,0,"ME",15.66
"3174",513,"SP07.8","ME",2007,5,8,128,20,43.05093,-70.28803,0,0,0,0,0,"ME",15.64
"3175",512,"SP07.52","ME",2007,5,22,142,20,44.21607,-68.92008,0,0,0,0,0,"ME",16.88
"3176",512,"SP07.67","ME",2007,5,25,145,15,44.26772,-68.78647,0,0,0,0,0,"ME",9.42
"3177",513,"SP08.11","ME",2008,5,7,128,20,43.18135,-70.2311,0,0,0,0,0,"ME",16.54
"3178",513,"SP08.28","ME",2008,5,13,134,20,43.4664,-69.96418,0,0,0,0,0,"ME",16.5
"3179",513,"SP08.29","ME",2008,5,13,134,20,43.48432,-69.92942,0,0,0,0,0,"ME",16.74
"3180",513,"SP08.40","ME",2008,5,15,136,20,43.81233,-69.45952,0,0,0,0,0,"ME",16.74
"3181",513,"SP08.44","ME",2008,5,16,137,18,43.66293,-69.44782,0,0,0,0,0,"ME",12.438
"3182",513,"SP08.45","ME",2008,5,16,137,20,43.6942,-69.512,0,0,0,0,0,"ME",16.74
"3183",513,"SP08.46","ME",2008,5,16,137,18,43.61165,-69.54988,0,0,0,0,0,"ME",12.582
"3184",513,"SP08.56","ME",2008,5,21,142,20,43.63522,-69.13318,0,0,0,0,0,"ME",16.54
"3185",512,"SP08.57","ME",2008,5,21,142,20,43.6067,-68.94263,0,0,0,0,0,"ME",18.58
"3186",511,"SP08.96","ME",2008,6,3,155,22,44.19575,-67.52402,0,0,0,0,0,"ME",22
"3187",513,"SP09.16","ME",2009,5,7,127,20,43.20005,-70.21537,0,0,0,0,0,"ME",16.46
"3188",512,"SP09.55","ME",2009,5,19,139,12,44.22877,-68.89115,0,0,0,0,0,"ME",5.844
"3189",511,"SP09.104","ME",2009,6,3,154,20,44.29945,-67.49808,0,0,0,0,0,"ME",16.62
"3190",513,"SP10.17","ME",2010,5,6,126,20,43.3589,-70.08503,0,0,0,0,0,"ME",12.6018
"3191",512,"SP10.63","ME",2010,5,19,139,20,44.2939,-68.75455,0,0,0,0,0,"ME",16.0002
"3192",511,"SP11.107","ME",2011,6,1,152,20,44.32555,-67.36456667,0,0,0,0,0,"ME",15.164
"3193",512,"SP12.78","ME",2012,5,22,143,20,44.39222,-68.40027,0,0,0,0,0,"ME",16.722
"3194",512,"SP12.79","ME",2012,5,22,143,20,44.38842,-68.49605,0,0,0,0,0,"ME",17.972
"3195",514,"198292.9260.1","MA",1982,9,8,251,13,41.8232,-70.4862,6,3,3,5,1,"MA",0.013
"3196",514,"198292.9270.2","MA",1982,9,8,251,15,41.9047,-70.4785,3,3,0,1,2,"MA",0.013
"3197",514,"198292.9260.3","MA",1982,9,8,251,20,41.9808,-70.5815,42,21,21,29,13,"MA",0.013
"3198",514,"198292.9250.4","MA",1982,9,8,251,13,42.0365,-70.6253,124,58,66,18,106,"MA",0.013
"3199",514,"198292.9330.5","MA",1982,9,9,252,13,42.3097,-70.805,136,70,66,111,25,"MA",0.013
"3200",514,"198292.9310.6","MA",1982,9,9,252,18,42.4558,-70.9187,27,14,13,22,5,"MA",0.013
"3201",514,"198292.9340.7","MA",1982,9,9,252,20,42.4515,-70.831,24,12,12,22,2,"MA",0.013
"3202",514,"198292.9350.8","MA",1982,9,9,252,20,42.4635,-70.7267,0,0,0,0,0,"MA",0.013
"3203",514,"198292.9350.9","MA",1982,9,9,252,20,42.51,-70.7235,5,2,3,5,0,"MA",0.013
"3204",514,"198292.9340.10","MA",1982,9,9,252,20,42.5465,-70.7368,11,3,8,10,1,"MA",0.013
"3205",514,"198292.9360.11","MA",1982,9,10,253,20,42.6185,-70.5378,2,2,0,2,0,"MA",0.013
"3206",514,"198292.9360.12","MA",1982,9,10,253,20,42.7185,-70.5758,1,1,0,1,0,"MA",0.013
"3207",514,"198292.9320.13","MA",1982,9,10,253,13,42.6853,-70.6738,2,0,2,2,0,"MA",0.013
"3208",514,"198292.9330.14","MA",1982,9,10,253,20,42.7153,-70.7168,3,3,0,3,0,"MA",0.013
"3209",514,"198292.9310.15","MA",1982,9,10,253,20,42.7083,-70.7425,51,33,18,45,6,"MA",0.013
"3210",514,"198292.9320.16","MA",1982,9,10,253,20,42.7757,-70.7877,38,23,15,37,1,"MA",0.013
"3211",514,"198292.9330.17","MA",1982,9,10,253,20,42.7683,-70.7483,0,0,0,0,0,"MA",0.013
"3212",514,"198292.9340.18","MA",1982,9,10,253,18,42.7447,-70.7168,1,0,1,1,0,"MA",0.013
"3213",514,"198292.9350.19","MA",1982,9,10,253,20,42.7182,-70.6203,2,1,1,2,0,"MA",0.013
"3214",514,"198292.9350.20","MA",1982,9,11,254,20,42.5792,-70.5967,7,3,4,7,0,"MA",0.013
"3215",514,"198292.9360.21","MA",1982,9,11,254,13.5,42.489,-70.6468,0,0,0,0,0,"MA",0.013
"3216",514,"198292.9360.22","MA",1982,9,11,254,20,42.4268,-70.6573,0,0,0,0,0,"MA",0.013
"3217",514,"198292.9300.23","MA",1982,9,12,255,20,42.0875,-70.373,0,0,0,0,0,"MA",0.013
"3218",514,"198292.9300.24","MA",1982,9,12,255,20,42.0502,-70.2948,0,0,0,0,0,"MA",0.013
"3219",514,"198292.9290.25","MA",1982,9,12,255,20,41.984,-70.3548,0,0,0,0,0,"MA",0.013
"3220",514,"198292.9280.26","MA",1982,9,13,256,20,41.8925,-70.4388,8,4,4,7,1,"MA",0.013
"3221",514,"198292.9210.27","MA",1982,9,13,256,20,42.0923,-70.2192,0,0,0,0,0,"MA",0.013
"3222",514,"198292.9200.28","MA",1982,9,15,258,13,42.1,-70.177,0,0,0,0,0,"MA",0.013
"3223",514,"198292.9210.29","MA",1982,9,15,258,13,42.0738,-70.0177,0,0,0,0,0,"MA",0.013
"3224",514,"198292.9190.30","MA",1982,9,15,258,13,42.0748,-70.0852,0,0,0,0,0,"MA",0.013
"3225",514,"198292.9260.31","MA",1982,9,16,259,15,41.7943,-70.2452,0,0,0,0,0,"MA",0.013
"3226",514,"198292.9280.32","MA",1982,9,16,259,20,41.8912,-70.2538,1,1,0,1,0,"MA",0.013
"3227",514,"198292.9280.33","MA",1982,9,16,259,13,41.9458,-70.2302,0,0,0,0,0,"MA",0.013
"3228",514,"198292.9290.34","MA",1982,9,16,259,20,41.9535,-70.302,2,1,1,2,0,"MA",0.013
"3229",514,"198292.9270.35","MA",1982,9,16,259,13,41.841,-70.4213,11,6,5,9,2,"MA",0.013
"3230",514,"198292.9270.36","MA",1982,9,17,260,20,41.7802,-70.4178,6,3,3,4,2,"MA",0.013
"3231",514,"198292.9270.37","MA",1982,9,17,260,20,41.8222,-70.2882,5,3,2,4,1,"MA",0.013
"3232",514,"198292.9280.38","MA",1982,9,17,260,20,41.9442,-70.4803,11,4,7,10,1,"MA",0.013
"3233",514,"198292.9290.39","MA",1982,9,17,260,20,41.9745,-70.4493,2,1,1,2,0,"MA",0.013
"3234",514,"198292.9290.40","MA",1982,9,17,260,20,42.026,-70.4248,1,1,0,1,0,"MA",0.013
"3235",514,"198292.9290.41","MA",1982,9,17,260,20,42.0578,-70.5068,10,4,6,9,1,"MA",0.013
"3236",514,"198292.9280.42","MA",1982,9,17,260,20,42.0008,-70.539,17,7,10,16,1,"MA",0.013
"3237",514,"198292.9260.43","MA",1982,9,18,261,14,41.7782,-70.4305,28,19,9,25,3,"MA",0.013
"3238",514,"198292.9250.44","MA",1982,9,18,261,20,41.7422,-70.3213,0,0,0,0,0,"MA",0.013
"3239",514,"198292.9260.45","MA",1982,9,18,261,20,41.8538,-70.1643,0,0,0,0,0,"MA",0.013
"3240",514,"198292.9250.46","MA",1982,9,18,261,16,41.8898,-70.1138,0,0,0,0,0,"MA",0.013
"3241",514,"198292.9270.47","MA",1982,9,18,261,20,41.9002,-70.1538,0,0,0,0,0,"MA",0.013
"3242",521,"198292.9180.55","MA",1982,9,20,263,17,41.6355,-69.901,0,0,0,0,0,"MA",0.013
"3243",521,"198292.9210.57","MA",1982,9,20,263,20,41.8217,-69.872,0,0,0,0,0,"MA",0.013
"3244",521,"198292.9170.58","MA",1982,9,20,263,13,41.5922,-69.9567,0,0,0,0,0,"MA",0.013
"3245",521,"198292.9170.70","MA",1982,9,23,266,15,41.3695,-69.9937,0,0,0,0,0,"MA",0.013
"3246",521,"198292.9170.71","MA",1982,9,23,266,20,41.3957,-69.9793,1,1,0,1,0,"MA",0.013
"3247",514,"198392.9270.3","MA",1983,9,7,250,20,41.879,-70.4548,4,3,1,1,3,"MA",0.013
"3248",514,"198392.9250.4","MA",1983,9,7,250,16,42.0157,-70.6032,229,97,132,54,175,"MA",0.013
"3249",514,"198392.9330.5","MA",1983,9,8,251,13,42.3093,-70.8052,438,245,193,210,228,"MA",0.013
"3250",514,"198392.9310.6","MA",1983,9,8,251,15,42.4413,-70.9223,135,57,78,68,67,"MA",0.013
"3251",514,"198392.9350.7","MA",1983,9,8,251,20,42.5098,-70.7203,11,3,8,10,1,"MA",0.013
"3252",514,"198392.9340.8","MA",1983,9,8,251,14,42.5423,-70.734,29,14,15,28,1,"MA",0.013
"3253",514,"198392.9350.9","MA",1983,9,8,251,20,42.5797,-70.6015,4,1,3,4,0,"MA",0.013
"3254",514,"198392.9360.10","MA",1983,9,9,252,20,42.6198,-70.5418,0,0,0,0,0,"MA",0.013
"3255",514,"198392.9340.11","MA",1983,9,9,252,20,42.6642,-70.5573,57,23,34,51,6,"MA",0.013
"3256",514,"198392.9330.12","MA",1983,9,9,252,20,42.717,-70.7097,10,6,4,10,0,"MA",0.013
"3257",514,"198392.9310.13","MA",1983,9,9,252,16,42.7082,-70.7508,38,15,23,31,7,"MA",0.013
"3258",514,"198392.9330.14","MA",1983,9,9,252,20,42.7993,-70.7738,15,8,7,14,1,"MA",0.013
"3259",514,"198392.9310.15","MA",1983,9,9,252,20,42.7923,-70.8015,39,21,18,30,9,"MA",0.013
"3260",514,"198392.9320.16","MA",1983,9,9,252,13,42.7597,-70.7792,32,20,12,32,0,"MA",0.013
"3261",514,"198392.9320.17","MA",1983,9,9,252,20,42.7272,-70.7578,45,29,16,45,0,"MA",0.013
"3262",514,"198392.9350.18","MA",1983,9,9,252,20,42.7112,-70.6255,1,0,1,1,0,"MA",0.013
"3263",514,"198392.9360.19","MA",1983,9,10,253,20,42.497,-70.6537,0,0,0,0,0,"MA",0.013
"3264",514,"198392.9360.20","MA",1983,9,10,253,20,42.473,-70.6475,0,0,0,0,0,"MA",0.013
"3265",514,"198392.9350.21","MA",1983,9,10,253,13,42.3793,-70.7017,1,0,1,1,0,"MA",0.013
"3266",514,"198392.9270.22","MA",1983,9,11,254,15,42.114,-70.5703,24,11,13,24,0,"MA",0.013
"3267",514,"198392.9290.23","MA",1983,9,11,254,20,42.1238,-70.4758,3,1,2,3,0,"MA",0.013
"3268",514,"198392.9290.24","MA",1983,9,11,254,20,42.0572,-70.509,75,33,42,72,3,"MA",0.013
"3269",514,"198392.9280.25","MA",1983,9,11,254,15,41.9745,-70.5098,44,23,21,43,1,"MA",0.013
"3270",514,"198392.9270.26","MA",1983,9,11,254,20,41.8265,-70.374,4,2,2,3,1,"MA",0.013
"3271",514,"198392.9250.27","MA",1983,9,11,254,13,41.7438,-70.3725,28,15,13,26,2,"MA",0.013
"3272",514,"198392.9290.28","MA",1983,9,13,256,20,41.9483,-70.4087,5,0,5,5,0,"MA",0.013
"3273",514,"198392.9300.29","MA",1983,9,13,256,20,42.0692,-70.3688,2,1,1,2,0,"MA",0.013
"3274",514,"198392.9290.30","MA",1983,9,13,256,20,41.9697,-70.3745,3,1,2,3,0,"MA",0.013
"3275",514,"198392.9300.44","MA",1983,9,16,259,20,42.0542,-70.2893,0,0,0,0,0,"MA",0.013
"3276",514,"198392.9170.45","MA",1983,9,16,259,20,42.0855,-70.151,0,0,0,0,0,"MA",0.013
"3277",514,"198392.9200.46","MA",1983,9,16,259,20,42.101,-70.158,0,0,0,0,0,"MA",0.013
"3278",514,"198392.9210.47","MA",1983,9,16,259,20,42.0792,-70.032,0,0,0,0,0,"MA",0.013
"3279",514,"198392.9260.49","MA",1983,9,17,260,20,41.7662,-70.353,43,22,21,38,5,"MA",0.013
"3280",514,"198392.9270.50","MA",1983,9,17,260,20,41.8647,-70.2313,0,0,0,0,0,"MA",0.013
"3281",514,"198392.9260.51","MA",1983,9,17,260,20,41.8798,-70.1457,2,1,1,2,0,"MA",0.013
"3282",514,"198392.9260.52","MA",1983,9,17,260,20,41.9437,-70.1183,6,5,1,5,1,"MA",0.013
"3283",514,"198392.9270.53","MA",1983,9,17,260,20,41.9873,-70.1328,0,0,0,0,0,"MA",0.013
"3284",514,"198392.9210.54","MA",1983,9,17,260,15,42.0965,-70.195,1,0,1,1,0,"MA",0.013
"3285",514,"198392.9280.55","MA",1983,9,18,261,20,41.885,-70.2918,0,0,0,0,0,"MA",0.013
"3286",514,"198392.9280.56","MA",1983,9,18,261,20,41.9098,-70.2333,0,0,0,0,0,"MA",0.013
"3287",514,"198392.9280.57","MA",1983,9,18,261,20,41.9547,-70.2347,0,0,0,0,0,"MA",0.013
"3288",514,"198392.9290.58","MA",1983,9,18,261,20,41.9597,-70.2733,2,2,0,2,0,"MA",0.013
"3289",514,"198392.9280.59","MA",1983,9,18,261,20,42.0177,-70.1678,1,1,0,1,0,"MA",0.013
"3290",514,"198392.9250.60","MA",1983,9,18,261,20,41.8968,-70.1138,0,0,0,0,0,"MA",0.013
"3291",514,"198392.9260.61","MA",1983,9,18,261,18,41.7932,-70.2498,4,3,1,3,1,"MA",0.013
"3292",521,"198392.9180.66","MA",1983,9,20,263,18,41.7902,-69.92,1,1,0,1,0,"MA",0.013
"3293",521,"198392.9180.67","MA",1983,9,20,263,13,41.8712,-69.9448,2,1,1,2,0,"MA",0.013
"3294",521,"198392.9170.68","MA",1983,9,20,263,19,41.8373,-69.9338,5,4,1,5,0,"MA",0.013
"3295",521,"198392.9200.69","MA",1983,9,20,263,20,41.7942,-69.8748,3,3,0,3,0,"MA",0.013
"3296",521,"198392.9170.70","MA",1983,9,20,263,20,41.7337,-69.9133,0,0,0,0,0,"MA",0.013
"3297",521,"198392.9170.72","MA",1983,9,21,264,13,41.3698,-69.9923,0,0,0,0,0,"MA",0.013
"3298",521,"198392.9180.73","MA",1983,9,21,264,20,41.4343,-69.9855,0,0,0,0,0,"MA",0.013
"3299",514,"198492.9270.1","MA",1984,9,10,254,20,41.8792,-70.4782,6,4,2,3,3,"MA",0.013
"3300",514,"198492.9280.2","MA",1984,9,10,254,17,41.9668,-70.5287,17,6,11,15,2,"MA",0.013
"3301",514,"198492.9260.3","MA",1984,9,10,254,20,41.9655,-70.585,82,48,34,64,18,"MA",0.013
"3302",514,"198492.9250.4","MA",1984,9,10,254,20,42.0677,-70.6395,884,393,491,161,723,"MA",0.013
"3303",514,"198492.9310.5","MA",1984,9,11,255,20,42.454,-70.9253,67,34,33,31,36,"MA",0.013
"3304",514,"198492.9320.6","MA",1984,9,11,255,20,42.456,-70.9167,188,95,93,128,60,"MA",0.013
"3305",514,"198492.9340.7","MA",1984,9,11,255,16,42.4312,-70.8365,156,63,93,131,25,"MA",0.013
"3306",514,"198492.9360.8","MA",1984,9,12,256,20,42.627,-70.5313,2,0,2,2,0,"MA",0.013
"3307",514,"198492.9350.9","MA",1984,9,12,256,20,42.6978,-70.5767,2,1,1,2,0,"MA",0.013
"3308",514,"198492.9350.10","MA",1984,9,12,256,20,42.727,-70.632,0,0,0,0,0,"MA",0.013
"3309",514,"198492.9330.11","MA",1984,9,12,256,20,42.693,-70.686,3,0,3,3,0,"MA",0.013
"3310",514,"198492.9310.12","MA",1984,9,12,256,13,42.6835,-70.7245,46,19,27,38,8,"MA",0.013
"3311",514,"198492.9310.13","MA",1984,9,12,256,20,42.7328,-70.7762,50,20,30,39,11,"MA",0.013
"3312",514,"198492.9320.14","MA",1984,9,12,256,20,42.7755,-70.7817,14,8,6,13,1,"MA",0.013
"3313",513,"198492.9330.15","MA",1984,9,12,256,20,42.835,-70.7735,5,5,0,5,0,"MA",0.013
"3314",513,"198492.9340.16","MA",1984,9,12,256,20,42.8405,-70.748,0,0,0,0,0,"MA",0.013
"3315",514,"198492.9350.17","MA",1984,9,13,257,20,42.588,-70.5773,0,0,0,0,0,"MA",0.013
"3316",514,"198492.9360.18","MA",1984,9,13,257,20,42.496,-70.653,6,2,4,6,0,"MA",0.013
"3317",514,"198492.9350.19","MA",1984,9,13,257,20,42.4577,-70.722,1,1,0,1,0,"MA",0.013
"3318",514,"198492.9360.20","MA",1984,9,13,257,20,42.426,-70.6623,2,1,1,2,0,"MA",0.013
"3319",514,"198492.9290.21","MA",1984,9,14,258,20,42.0697,-70.5217,30,12,18,28,2,"MA",0.013
"3320",514,"198492.9300.22","MA",1984,9,14,258,20,42.0868,-70.3885,0,0,0,0,0,"MA",0.013
"3321",514,"198492.9290.23","MA",1984,9,14,258,20,42.0395,-70.3993,2,0,2,2,0,"MA",0.013
"3322",514,"198492.9290.24","MA",1984,9,14,258,20,41.9873,-70.4142,0,0,0,0,0,"MA",0.013
"3323",514,"198492.9280.25","MA",1984,9,14,258,20,41.8968,-70.3767,5,1,4,5,0,"MA",0.013
"3324",514,"198492.9270.26","MA",1984,9,14,258,20,41.7765,-70.4208,2,0,2,1,1,"MA",0.013
"3325",514,"198492.9250.38","MA",1984,9,17,261,20,41.7438,-70.3845,0,0,0,0,0,"MA",0.013
"3326",514,"198492.9280.39","MA",1984,9,17,261,20,41.906,-70.2882,3,1,2,2,1,"MA",0.013
"3327",514,"198492.9270.40","MA",1984,9,17,261,20,41.8478,-70.2422,3,3,0,3,0,"MA",0.013
"3328",514,"198492.9250.41","MA",1984,9,17,261,20,41.8208,-70.0425,0,0,0,0,0,"MA",0.013
"3329",514,"198492.9260.42","MA",1984,9,17,261,20,41.798,-70.233,4,1,3,3,1,"MA",0.013
"3330",514,"198492.9210.43","MA",1984,9,18,262,20,42.1107,-70.1513,0,0,0,0,0,"MA",0.013
"3331",521,"198492.9170.44","MA",1984,9,18,262,20,41.9452,-69.9748,1,0,1,0,1,"MA",0.013
"3332",521,"198492.9190.45","MA",1984,9,18,262,20,41.876,-69.9277,11,7,4,10,1,"MA",0.013
"3333",521,"198492.9170.46","MA",1984,9,18,262,19,41.9222,-69.9667,1,1,0,1,0,"MA",0.013
"3334",514,"198492.9210.47","MA",1984,9,19,263,20,42.1053,-70.2045,0,0,0,0,0,"MA",0.013
"3335",514,"198492.9290.50","MA",1984,9,20,264,20,41.9443,-70.3377,3,2,1,3,0,"MA",0.013
"3336",514,"198492.9300.51","MA",1984,9,20,264,20,42.0822,-70.3172,0,0,0,0,0,"MA",0.013
"3337",514,"198492.9290.52","MA",1984,9,20,264,20,41.9703,-70.2547,0,0,0,0,0,"MA",0.013
"3338",514,"198492.9280.53","MA",1984,9,20,264,20,41.9525,-70.209,0,0,0,0,0,"MA",0.013
"3339",514,"198492.9260.54","MA",1984,9,20,264,20,41.9518,-70.1142,6,4,2,6,0,"MA",0.013
"3340",514,"198492.9270.55","MA",1984,9,20,264,20,41.9312,-70.1488,2,1,1,2,0,"MA",0.013
"3341",514,"198492.9260.56","MA",1984,9,20,264,20,41.8653,-70.1703,3,1,2,3,0,"MA",0.013
"3342",514,"198492.9280.57","MA",1984,9,21,265,20,41.9268,-70.236,1,0,1,1,0,"MA",0.013
"3343",514,"198492.9270.58","MA",1984,9,21,265,20,41.8363,-70.3107,4,1,3,4,0,"MA",0.013
"3344",514,"198492.9260.59","MA",1984,9,21,265,20,41.7603,-70.3713,6,3,3,6,0,"MA",0.013
"3345",521,"198492.9180.67","MA",1984,9,23,267,20,41.6512,-69.9157,0,0,0,0,0,"MA",0.013
"3346",521,"198492.9180.68","MA",1984,9,23,267,19,41.7427,-69.909,0,0,0,0,0,"MA",0.013
"3347",521,"198492.9200.69","MA",1984,9,23,267,20,41.7935,-69.8778,0,0,0,0,0,"MA",0.013
"3348",521,"198492.9170.70","MA",1984,9,24,268,16,41.3733,-69.9985,0,0,0,0,0,"MA",0.013
"3349",514,"198592.9270.1","MA",1985,9,3,246,20,41.8393,-70.3988,14,7,7,7,7,"MA",0.013
"3350",514,"198592.9270.2","MA",1985,9,3,246,20,41.8475,-70.3175,1,1,0,0,1,"MA",0.013
"3351",514,"198592.9260.3","MA",1985,9,4,247,13,41.8167,-70.4762,41,24,17,31,10,"MA",0.013
"3352",514,"198592.9250.5","MA",1985,9,4,247,20,42.052,-70.6367,370,170,200,81,289,"MA",0.013
"3353",514,"198592.9270.6","MA",1985,9,4,247,20,42.1165,-70.5615,23,12,11,18,5,"MA",0.013
"3354",514,"198592.9290.7","MA",1985,9,4,247,16,42.0708,-70.4822,24,9,15,22,2,"MA",0.013
"3355",514,"198592.9330.8","MA",1985,9,5,248,13,42.3123,-70.8132,766,412,354,529,237,"MA",0.013
"3356",514,"198592.9310.9","MA",1985,9,5,248,20,42.4565,-70.923,108,44,64,42,66,"MA",0.013
"3357",514,"198592.9340.10","MA",1985,9,5,248,13,42.4422,-70.8225,42,17,25,31,11,"MA",0.013
"3358",514,"198592.9350.11","MA",1985,9,5,248,20,42.5152,-70.715,3,0,3,3,0,"MA",0.013
"3359",514,"198592.9340.12","MA",1985,9,5,248,20,42.5535,-70.725,59,32,27,56,3,"MA",0.013
"3360",514,"198592.9360.13","MA",1985,9,6,249,13,42.6562,-70.5307,5,4,1,5,0,"MA",0.013
"3361",514,"198592.9360.14","MA",1985,9,6,249,20,42.7147,-70.5583,0,0,0,0,0,"MA",0.013
"3362",514,"198592.9340.15","MA",1985,9,6,249,20,42.7278,-70.6837,0,0,0,0,0,"MA",0.013
"3363",514,"198592.9320.16","MA",1985,9,6,249,20,42.7207,-70.7392,38,21,17,24,14,"MA",0.013
"3364",514,"198592.9310.17","MA",1985,9,6,249,20,42.7287,-70.7702,51,25,26,32,19,"MA",0.013
"3365",514,"198592.9320.18","MA",1985,9,6,249,13,42.7603,-70.7767,131,55,76,98,33,"MA",0.013
"3366",514,"198592.9310.19","MA",1985,9,6,249,20,42.7705,-70.7943,10,4,6,5,5,"MA",0.013
"3367",514,"198592.9330.20","MA",1985,9,6,249,20,42.7965,-70.758,7,3,4,4,3,"MA",0.013
"3368",514,"198592.9330.21","MA",1985,9,6,249,20,42.7688,-70.7562,0,0,0,0,0,"MA",0.013
"3369",514,"198592.9350.22","MA",1985,9,7,250,20,42.5845,-70.5855,10,3,7,10,0,"MA",0.013
"3370",514,"198592.9350.23","MA",1985,9,7,250,20,42.5772,-70.5962,11,6,5,11,0,"MA",0.013
"3371",514,"198592.9350.24","MA",1985,9,7,250,20,42.5262,-70.672,0,0,0,0,0,"MA",0.013
"3372",514,"198592.9360.25","MA",1985,9,7,250,20,42.4963,-70.6428,2,0,2,2,0,"MA",0.013
"3373",514,"198592.9360.26","MA",1985,9,7,250,20,42.4655,-70.6338,3,1,2,3,0,"MA",0.013
"3374",514,"198592.9280.27","MA",1985,9,8,251,20,42.0843,-70.5503,13,5,8,13,0,"MA",0.013
"3375",514,"198592.9300.28","MA",1985,9,8,251,20,42.0985,-70.3702,0,0,0,0,0,"MA",0.013
"3376",514,"198592.9290.29","MA",1985,9,8,251,20,42.0343,-70.3903,3,3,0,3,0,"MA",0.013
"3377",514,"198592.9290.30","MA",1985,9,8,251,20,42.015,-70.4575,0,0,0,0,0,"MA",0.013
"3378",514,"198592.9290.31","MA",1985,9,8,251,20,41.9622,-70.3787,0,0,0,0,0,"MA",0.013
"3379",514,"198592.9280.32","MA",1985,9,8,251,20,41.8932,-70.384,6,4,2,6,0,"MA",0.013
"3380",514,"198592.9260.33","MA",1985,9,8,251,20,41.7695,-70.3592,8,3,5,7,1,"MA",0.013
"3381",514,"198592.9250.34","MA",1985,9,9,252,20,41.7417,-70.3153,0,0,0,0,0,"MA",0.013
"3382",514,"198592.9270.35","MA",1985,9,9,252,20,41.8492,-70.2378,3,1,2,2,1,"MA",0.013
"3383",514,"198592.9280.36","MA",1985,9,9,252,13,41.92,-70.22,1,0,1,1,0,"MA",0.013
"3384",514,"198592.9270.37","MA",1985,9,9,252,20,41.9065,-70.1663,0,0,0,0,0,"MA",0.013
"3385",514,"198592.9260.38","MA",1985,9,9,252,20,41.8942,-70.1518,0,0,0,0,0,"MA",0.013
"3386",514,"198592.9250.39","MA",1985,9,9,252,20,41.881,-70.1232,1,1,0,1,0,"MA",0.013
"3387",514,"198592.9290.40","MA",1985,9,10,253,20,42.005,-70.2915,0,0,0,0,0,"MA",0.013
"3388",514,"198592.9280.41","MA",1985,9,10,253,20,41.9898,-70.1963,0,0,0,0,0,"MA",0.013
"3389",514,"198592.9260.42","MA",1985,9,10,253,20,41.9075,-70.137,0,0,0,0,0,"MA",0.013
"3390",514,"198592.9260.43","MA",1985,9,10,253,20,41.8482,-70.1967,0,0,0,0,0,"MA",0.013
"3391",521,"198592.9170.69","MA",1985,9,14,257,20,41.5257,-69.9212,0,0,0,0,0,"MA",0.013
"3392",521,"198592.9180.71","MA",1985,9,15,258,20,41.3732,-69.9568,0,0,0,0,0,"MA",0.013
"3393",514,"198592.9210.88","MA",1985,9,17,260,20,42.0758,-70.0223,0,0,0,0,0,"MA",0.013
"3394",514,"198592.9300.89","MA",1985,9,18,261,20,42.0997,-70.2838,1,1,0,1,0,"MA",0.013
"3395",514,"198592.9210.90","MA",1985,9,18,261,20,42.1025,-70.2433,1,0,1,1,0,"MA",0.013
"3396",514,"198592.9180.91","MA",1985,9,18,261,13,42.09,-70.1358,0,0,0,0,0,"MA",0.013
"3397",514,"198692.9250.1","MA",1986,9,8,251,20,41.8487,-70.5127,2,1,1,2,0,"MA",0.013
"3398",514,"198692.9270.2","MA",1986,9,8,251,20,41.8538,-70.4087,5,3,2,5,0,"MA",0.013
"3399",514,"198692.9270.3","MA",1986,9,8,251,20,41.773,-70.3987,7,3,4,6,1,"MA",0.013
"3400",514,"198692.9280.4","MA",1986,9,9,252,20,41.9215,-70.4333,5,3,2,5,0,"MA",0.013
"3401",514,"198692.9280.5","MA",1986,9,9,252,20,41.9868,-70.4787,11,2,9,9,2,"MA",0.013
"3402",514,"198692.9290.6","MA",1986,9,9,252,20,41.9708,-70.4422,12,4,8,11,1,"MA",0.013
"3403",514,"198692.9290.7","MA",1986,9,9,252,20,42.0588,-70.4052,8,3,5,8,0,"MA",0.013
"3404",514,"198692.9290.8","MA",1986,9,9,252,20,42.0758,-70.499,47,21,26,45,2,"MA",0.013
"3405",514,"198692.9280.9","MA",1986,9,9,252,20,42.0783,-70.5517,8,2,6,7,1,"MA",0.013
"3406",514,"198692.9250.10","MA",1986,9,9,252,13,42.1517,-70.6913,32,16,16,10,22,"MA",0.013
"3407",514,"198692.9350.11","MA",1986,9,10,253,13,42.4812,-70.7352,0,0,0,0,0,"MA",0.013
"3408",514,"198692.9350.12","MA",1986,9,10,253,20,42.5253,-70.715,17,6,11,15,2,"MA",0.013
"3409",514,"198692.9360.13","MA",1986,9,10,253,20,42.4655,-70.63,1,0,1,1,0,"MA",0.013
"3410",514,"198692.9360.14","MA",1986,9,10,253,20,42.5018,-70.625,3,0,3,3,0,"MA",0.013
"3411",514,"198692.9350.15","MA",1986,9,10,253,20,42.5562,-70.6143,6,1,5,5,1,"MA",0.013
"3412",514,"198692.9350.16","MA",1986,9,10,253,20,42.5887,-70.5808,17,7,10,16,1,"MA",0.013
"3413",514,"198692.9360.17","MA",1986,9,11,254,20,42.633,-70.5132,3,0,3,3,0,"MA",0.013
"3414",514,"198692.9350.18","MA",1986,9,11,254,20,42.7013,-70.5697,12,3,9,11,1,"MA",0.013
"3415",514,"198692.9360.19","MA",1986,9,11,254,20,42.7125,-70.5465,3,0,3,3,0,"MA",0.013
"3416",514,"198692.9340.20","MA",1986,9,11,254,20,42.705,-70.6615,8,3,5,8,0,"MA",0.013
"3417",514,"198692.9330.21","MA",1986,9,11,254,15,42.711,-70.715,9,6,3,6,3,"MA",0.013
"3418",514,"198692.9310.22","MA",1986,9,11,254,20,42.7702,-70.7917,45,17,28,25,20,"MA",0.013
"3419",514,"198692.9310.23","MA",1986,9,11,254,20,42.801,-70.8037,168,78,90,106,62,"MA",0.013
"3420",513,"198692.9340.24","MA",1986,9,11,254,13,42.8567,-70.7773,7,1,6,4,3,"MA",0.013
"3421",513,"198692.9330.25","MA",1986,9,11,254,13,42.8438,-70.7787,1,1,0,1,0,"MA",0.013
"3422",514,"198692.9330.26","MA",1986,9,11,254,13,42.7033,-70.7135,37,17,20,27,10,"MA",0.013
"3423",514,"198692.9320.27","MA",1986,9,11,254,13,42.718,-70.741,18,8,10,16,2,"MA",0.013
"3424",514,"198692.9350.28","MA",1986,9,12,255,20,42.5017,-70.7263,9,4,5,8,1,"MA",0.013
"3425",514,"198692.9300.29","MA",1986,9,13,256,20,42.1045,-70.4028,2,1,1,2,0,"MA",0.013
"3426",514,"198692.9260.30","MA",1986,9,13,256,16,41.8133,-70.4862,7,3,4,2,5,"MA",0.013
"3427",514,"198692.9260.31","MA",1986,9,13,256,20,41.7718,-70.41,8,3,5,6,2,"MA",0.013
"3428",514,"198692.9250.32","MA",1986,9,13,256,13,41.8295,-70.0952,0,0,0,0,0,"MA",0.013
"3429",514,"198692.9260.33","MA",1986,9,13,256,15,41.8092,-70.125,0,0,0,0,0,"MA",0.013
"3430",514,"198692.9270.38","MA",1986,9,15,258,20,41.854,-70.2627,2,1,1,1,1,"MA",0.013
"3431",514,"198692.9280.39","MA",1986,9,15,258,20,41.904,-70.285,0,0,0,0,0,"MA",0.013
"3432",514,"198692.9270.40","MA",1986,9,15,258,20,41.8772,-70.179,0,0,0,0,0,"MA",0.013
"3433",514,"198692.9260.42","MA",1986,9,15,258,13,41.9745,-70.1148,8,4,4,8,0,"MA",0.013
"3434",514,"198692.9270.43","MA",1986,9,15,258,13,42.0073,-70.1572,0,0,0,0,0,"MA",0.013
"3435",514,"198692.9280.44","MA",1986,9,15,258,20,42.0153,-70.1708,4,3,1,3,1,"MA",0.013
"3436",521,"198692.9200.86","MA",1986,9,23,266,16,41.8257,-69.8873,4,2,2,1,3,"MA",0.013
"3437",514,"198692.9190.88","MA",1986,9,23,266,15,42.025,-70.0108,2,0,2,1,1,"MA",0.013
"3438",514,"198692.9300.91","MA",1986,9,24,267,20,42.0933,-70.3268,0,0,0,0,0,"MA",0.013
"3439",514,"198692.9210.92","MA",1986,9,24,267,20,42.1092,-70.2238,1,1,0,1,0,"MA",0.013
"3440",514,"198692.9170.93","MA",1986,9,24,267,13,42.0897,-70.1705,1,1,0,1,0,"MA",0.013
"3441",514,"198692.9170.94","MA",1986,9,24,267,20,42.0882,-70.154,1,1,0,0,1,"MA",0.013
"3442",514,"198692.9200.95","MA",1986,9,24,267,13,42.0987,-70.1777,1,0,1,1,0,"MA",0.013
"3443",514,"198692.9290.96","MA",1986,9,24,267,20,42.024,-70.3095,2,1,1,2,0,"MA",0.013
"3444",514,"198792.9250.1","MA",1987,9,8,251,20,41.7482,-70.2853,1,0,1,1,0,"MA",0.013
"3445",514,"198792.9260.2","MA",1987,9,8,251,20,41.7582,-70.3545,1,1,0,1,0,"MA",0.013
"3446",514,"198792.9270.4","MA",1987,9,9,252,13,41.886,-70.477,1,0,1,0,1,"MA",0.013
"3447",514,"198792.9330.7","MA",1987,9,10,253,16,42.3085,-70.8153,38,16,22,35,3,"MA",0.013
"3448",514,"198792.9330.8","MA",1987,9,10,253,20,42.4493,-70.8773,14,6,8,11,3,"MA",0.013
"3449",514,"198792.9350.9","MA",1987,9,10,253,20,42.4742,-70.7347,0,0,0,0,0,"MA",0.013
"3450",514,"198792.9350.10","MA",1987,9,10,253,20,42.525,-70.713,2,0,2,2,0,"MA",0.013
"3451",514,"198792.9360.11","MA",1987,9,10,253,20,42.5057,-70.6368,0,0,0,0,0,"MA",0.013
"3452",514,"198792.9340.12","MA",1987,9,10,253,15,42.5507,-70.7298,6,3,3,5,1,"MA",0.013
"3453",514,"198792.9360.13","MA",1987,9,11,254,20,42.6355,-70.5212,0,0,0,0,0,"MA",0.013
"3454",514,"198792.9350.14","MA",1987,9,11,254,20,42.716,-70.6212,2,2,0,2,0,"MA",0.013
"3455",514,"198792.9330.15","MA",1987,9,11,254,20,42.7005,-70.6985,4,2,2,4,0,"MA",0.013
"3456",513,"198792.9340.16","MA",1987,9,11,254,20,42.8377,-70.7513,1,0,1,1,0,"MA",0.013
"3457",514,"198792.9320.17","MA",1987,9,11,254,19,42.7195,-70.7342,0,0,0,0,0,"MA",0.013
"3458",514,"198792.9320.18","MA",1987,9,11,254,20,42.7042,-70.7232,8,6,2,6,2,"MA",0.013
"3459",514,"198792.9360.19","MA",1987,9,11,254,20,42.7005,-70.536,2,1,1,2,0,"MA",0.013
"3460",514,"198792.9350.20","MA",1987,9,11,254,20,42.5978,-70.5688,1,0,1,1,0,"MA",0.013
"3461",514,"198792.9360.21","MA",1987,9,12,255,20,42.4622,-70.6365,2,0,2,2,0,"MA",0.013
"3462",514,"198792.9290.22","MA",1987,9,13,256,20,42.0582,-70.4582,0,0,0,0,0,"MA",0.013
"3463",514,"198792.9290.23","MA",1987,9,13,256,20,42.0137,-70.406,1,1,0,1,0,"MA",0.013
"3464",514,"198792.9280.24","MA",1987,9,13,256,20,41.9478,-70.476,3,2,1,2,1,"MA",0.013
"3465",514,"198792.9290.25","MA",1987,9,13,256,13,41.9553,-70.3417,0,0,0,0,0,"MA",0.013
"3466",514,"198792.9290.26","MA",1987,9,13,256,20,41.9853,-70.2478,0,0,0,0,0,"MA",0.013
"3467",514,"198792.9280.27","MA",1987,9,13,256,20,41.8743,-70.3773,2,2,0,2,0,"MA",0.013
"3468",514,"198792.9270.28","MA",1987,9,13,256,20,41.7977,-70.3727,1,0,1,0,1,"MA",0.013
"3469",514,"198792.9260.29","MA",1987,9,14,257,20,41.8563,-70.1918,0,0,0,0,0,"MA",0.013
"3470",514,"198792.9270.30","MA",1987,9,14,257,20,41.878,-70.1815,0,0,0,0,0,"MA",0.013
"3471",514,"198792.9250.31","MA",1987,9,14,257,15,41.9085,-70.1043,1,1,0,1,0,"MA",0.013
"3472",514,"198792.9270.32","MA",1987,9,14,257,20,41.9417,-70.1458,0,0,0,0,0,"MA",0.013
"3473",514,"198792.9260.33","MA",1987,9,14,257,20,41.9708,-70.1167,0,0,0,0,0,"MA",0.013
"3474",514,"198792.9280.34","MA",1987,9,14,257,20,41.9915,-70.1912,0,0,0,0,0,"MA",0.013
"3475",514,"198792.9280.35","MA",1987,9,14,257,20,41.928,-70.2263,0,0,0,0,0,"MA",0.013
"3476",514,"198792.9290.36","MA",1987,9,15,258,20,42.0413,-70.247,0,0,0,0,0,"MA",0.013
"3477",514,"198792.9300.37","MA",1987,9,15,258,20,42.115,-70.3412,0,0,0,0,0,"MA",0.013
"3478",514,"198792.9300.38","MA",1987,9,15,258,20,42.1075,-70.2775,0,0,0,0,0,"MA",0.013
"3479",514,"198792.9210.39","MA",1987,9,15,258,20,42.109,-70.2182,0,0,0,0,0,"MA",0.013
"3480",514,"198792.9210.40","MA",1987,9,15,258,20,42.0877,-70.0375,0,0,0,0,0,"MA",0.013
"3481",514,"198792.9200.41","MA",1987,9,15,258,20,42.0523,-70.0135,0,0,0,0,0,"MA",0.013
"3482",514,"198792.9170.42","MA",1987,9,15,258,20,42.055,-70.073,0,0,0,0,0,"MA",0.013
"3483",514,"198792.9180.43","MA",1987,9,15,258,13,42.0825,-70.1155,10,6,4,8,2,"MA",0.013
"3484",521,"198792.9170.44","MA",1987,9,16,259,20,41.9455,-69.976,3,1,2,2,1,"MA",0.013
"3485",521,"198792.9190.45","MA",1987,9,16,259,13,41.9273,-69.9498,0,0,0,0,0,"MA",0.013
"3486",521,"198792.9200.46","MA",1987,9,16,259,20,41.8223,-69.8858,0,0,0,0,0,"MA",0.013
"3487",521,"198792.9210.47","MA",1987,9,16,259,20,41.8257,-69.8755,0,0,0,0,0,"MA",0.013
"3488",521,"198792.9170.78","MA",1987,9,25,268,20,41.4,-69.9858,0,0,0,0,0,"MA",0.013
"3489",514,"198892.9260.1","MA",1988,9,6,250,20,41.7543,-70.37,3,2,1,2,1,"MA",0.013
"3490",514,"198892.9270.2","MA",1988,9,6,250,20,41.849,-70.4298,20,10,10,17,3,"MA",0.013
"3491",514,"198892.9260.3","MA",1988,9,6,250,15,41.8008,-70.4645,8,3,5,7,1,"MA",0.013
"3492",514,"198892.9280.4","MA",1988,9,7,251,13,41.9928,-70.539,53,16,37,43,10,"MA",0.013
"3493",514,"198892.9270.5","MA",1988,9,7,251,16,42.0495,-70.5758,15,5,10,13,2,"MA",0.013
"3494",514,"198892.9250.6","MA",1988,9,7,251,13,42.0645,-70.6422,755,332,423,137,618,"MA",0.013
"3495",514,"198892.9360.8","MA",1988,9,8,252,20,42.4725,-70.632,1,0,1,1,0,"MA",0.013
"3496",514,"198892.9360.9","MA",1988,9,8,252,20,42.5168,-70.6445,2,1,1,2,0,"MA",0.013
"3497",514,"198892.9360.10","MA",1988,9,9,253,20,42.627,-70.532,0,0,0,0,0,"MA",0.013
"3498",514,"198892.9330.14","MA",1988,9,9,253,20,42.7508,-70.727,3,2,1,3,0,"MA",0.013
"3499",514,"198892.9330.15","MA",1988,9,9,253,20,42.6992,-70.6988,10,2,8,10,0,"MA",0.013
"3500",514,"198892.9340.16","MA",1988,9,9,253,13,42.724,-70.6707,0,0,0,0,0,"MA",0.013
"3501",514,"198892.9320.17","MA",1988,9,9,253,20,42.6905,-70.6908,0,0,0,0,0,"MA",0.013
"3502",514,"198892.9360.18","MA",1988,9,9,253,20,42.7248,-70.5878,0,0,0,0,0,"MA",0.013
"3503",514,"198892.9350.19","MA",1988,9,9,253,20,42.5918,-70.5757,18,12,6,15,3,"MA",0.013
"3504",514,"198892.9340.20","MA",1988,9,10,254,18,42.5383,-70.7298,15,5,10,14,1,"MA",0.013
"3505",514,"198892.9350.21","MA",1988,9,10,254,20,42.3713,-70.6953,0,0,0,0,0,"MA",0.013
"3506",514,"198892.9300.23","MA",1988,9,11,255,20,42.1165,-70.4138,0,0,0,0,0,"MA",0.013
"3507",514,"198892.9280.33","MA",1988,9,12,256,13,41.9415,-70.1968,0,0,0,0,0,"MA",0.013
"3508",514,"198892.9280.34","MA",1988,9,12,256,20,41.9383,-70.2748,0,0,0,0,0,"MA",0.013
"3509",514,"198892.9290.35","MA",1988,9,12,256,20,41.932,-70.3788,2,0,2,2,0,"MA",0.013
"3510",514,"198892.9290.36","MA",1988,9,13,257,20,42.0457,-70.3572,3,3,0,3,0,"MA",0.013
"3511",514,"198892.9300.37","MA",1988,9,13,257,20,42.1033,-70.342,0,0,0,0,0,"MA",0.013
"3512",514,"198892.9290.38","MA",1988,9,13,257,20,42.0285,-70.2553,0,0,0,0,0,"MA",0.013
"3513",514,"198892.9210.39","MA",1988,9,14,258,20,42.0977,-70.2285,0,0,0,0,0,"MA",0.013
"3514",514,"198892.9210.40","MA",1988,9,14,258,20,42.0865,-70.0328,0,0,0,0,0,"MA",0.013
"3515",514,"198892.9200.41","MA",1988,9,14,258,15,42.051,-70.0098,0,0,0,0,0,"MA",0.013
"3516",514,"198892.9170.43","MA",1988,9,14,258,20,42.055,-70.0702,0,0,0,0,0,"MA",0.013
"3517",514,"198892.9200.44","MA",1988,9,14,258,20,42.1015,-70.165,0,0,0,0,0,"MA",0.013
"3518",521,"198892.9180.45","MA",1988,9,15,259,13,41.8093,-69.919,1,1,0,1,0,"MA",0.013
"3519",521,"198892.9170.46","MA",1988,9,15,259,14,41.8008,-69.926,2,1,1,2,0,"MA",0.013
"3520",521,"198892.9180.63","MA",1988,9,18,262,20,41.4242,-69.994,0,0,0,0,0,"MA",0.013
"3521",521,"198892.9170.69","MA",1988,9,19,263,20,41.3812,-69.998,0,0,0,0,0,"MA",0.013
"3522",514,"198992.9250.27","MA",1989,9,10,253,13,42.0472,-70.6335,604,312,292,114,490,"MA",0.013
"3523",514,"198992.9310.28","MA",1989,9,11,254,13,42.451,-70.9183,91,33,58,32,59,"MA",0.013
"3524",514,"198992.9350.29","MA",1989,9,11,254,20,42.4577,-70.8162,75,31,44,56,19,"MA",0.013
"3525",514,"198992.9340.30","MA",1989,9,11,254,20,42.4872,-70.7598,17,9,8,17,0,"MA",0.013
"3526",514,"198992.9350.32","MA",1989,9,11,254,20,42.5322,-70.6683,3,2,1,3,0,"MA",0.013
"3527",514,"198992.9350.33","MA",1989,9,11,254,13,42.5775,-70.5967,33,19,14,27,6,"MA",0.013
"3528",514,"198992.9350.34","MA",1989,9,11,254,20,42.5942,-70.5807,15,6,9,13,2,"MA",0.013
"3529",514,"198992.9360.35","MA",1989,9,12,255,13,42.7135,-70.5528,1,0,1,1,0,"MA",0.013
"3530",514,"198992.9310.38","MA",1989,9,12,255,13,42.7377,-70.7778,22,6,16,14,8,"MA",0.013
"3531",514,"198992.9320.39","MA",1989,9,12,255,15,42.7608,-70.7687,6,3,3,5,1,"MA",0.013
"3532",514,"198992.9330.40","MA",1989,9,12,255,20,42.7517,-70.7312,7,4,3,5,2,"MA",0.013
"3533",514,"198992.9360.42","MA",1989,9,12,255,20,42.6247,-70.5348,5,2,3,5,0,"MA",0.013
"3534",514,"198992.9360.43","MA",1989,9,13,256,13,42.5022,-70.6333,6,0,6,6,0,"MA",0.013
"3535",514,"198992.9360.44","MA",1989,9,13,256,20,42.475,-70.639,3,1,2,3,0,"MA",0.013
"3536",514,"198992.9290.48","MA",1989,9,13,256,13,42.029,-70.4348,12,4,8,12,0,"MA",0.013
"3537",514,"198992.9260.51","MA",1989,9,14,257,20,41.8105,-70.4658,7,3,4,6,1,"MA",0.013
"3538",514,"198992.9290.53","MA",1989,9,14,257,20,41.9862,-70.3413,3,0,3,3,0,"MA",0.013
"3539",514,"198992.9260.58","MA",1989,9,15,258,20,41.77,-70.424,4,1,3,2,2,"MA",0.013
"3540",514,"198992.9270.59","MA",1989,9,15,258,20,41.8418,-70.4205,22,10,12,17,5,"MA",0.013
"3541",521,"198992.9180.70","MA",1989,9,17,260,16,41.3747,-69.9572,0,0,0,0,0,"MA",0.013
"3542",514,"198992.9200.79","MA",1989,9,19,262,18,42.1017,-70.1718,1,1,0,0,1,"MA",0.013
"3543",514,"198992.9210.80","MA",1989,9,19,262,20,42.0932,-70.231,1,1,0,1,0,"MA",0.013
"3544",514,"198992.9200.83","MA",1989,9,20,263,20,42.1005,-70.183,0,0,0,0,0,"MA",0.013
"3545",514,"198992.9210.84","MA",1989,9,20,263,20,42.1103,-70.2135,0,0,0,0,0,"MA",0.013
"3546",514,"198992.9300.85","MA",1989,9,20,263,20,42.0993,-70.2798,0,0,0,0,0,"MA",0.013
"3547",514,"198992.9300.86","MA",1989,9,20,263,20,42.0802,-70.3157,1,0,1,1,0,"MA",0.013
"3548",514,"199092.9260.1","MA",1990,9,4,247,20,41.7677,-70.3963,91,50,41,65,26,"MA",0.013
"3549",514,"199092.9270.2","MA",1990,9,4,247,20,41.8475,-70.3893,21,13,8,17,4,"MA",0.013
"3550",514,"199092.9280.3","MA",1990,9,5,248,20,41.9413,-70.474,18,9,9,14,4,"MA",0.013
"3551",514,"199092.9270.4","MA",1990,9,5,248,20,42.0572,-70.5662,81,44,37,75,6,"MA",0.013
"3552",514,"199092.9250.5","MA",1990,9,5,248,13,42.0562,-70.637,1086,503,583,203,883,"MA",0.013
"3553",514,"199092.9290.6","MA",1990,9,5,248,18,42.0682,-70.515,60,36,24,47,13,"MA",0.013
"3554",514,"199092.9310.7","MA",1990,9,5,248,13,42.2917,-70.865,5136,2469,2667,845,4291,"MA",0.013
"3555",514,"199092.9330.8","MA",1990,9,6,249,19,42.4478,-70.875,91,41,50,72,19,"MA",0.013
"3556",514,"199092.9340.9","MA",1990,9,6,249,20,42.4813,-70.764,40,13,27,33,7,"MA",0.013
"3557",514,"199092.9350.10","MA",1990,9,6,249,20,42.4578,-70.7207,6,2,4,6,0,"MA",0.013
"3558",514,"199092.9350.11","MA",1990,9,6,249,13,42.4338,-70.7337,12,4,8,12,0,"MA",0.013
"3559",514,"199092.9360.12","MA",1990,9,6,249,20,42.4727,-70.6492,6,1,5,6,0,"MA",0.013
"3560",514,"199092.9350.13","MA",1990,9,6,249,20,42.597,-70.5748,35,13,22,26,9,"MA",0.013
"3561",514,"199092.9360.14","MA",1990,9,6,249,20,42.6308,-70.5253,4,1,3,4,0,"MA",0.013
"3562",514,"199092.9340.15","MA",1990,9,7,250,20,42.7078,-70.6587,14,11,3,13,1,"MA",0.013
"3563",514,"199092.9310.16","MA",1990,9,7,250,13,42.7553,-70.7878,119,41,78,82,37,"MA",0.013
"3564",514,"199092.9330.17","MA",1990,9,7,250,20,42.7748,-70.7362,2,1,1,2,0,"MA",0.013
"3565",514,"199092.9320.18","MA",1990,9,7,250,20,42.7755,-70.7818,106,46,60,94,12,"MA",0.013
"3566",514,"199092.9320.19","MA",1990,9,7,250,13,42.7755,-70.781,67,28,39,65,2,"MA",0.013
"3567",514,"199092.9330.20","MA",1990,9,7,250,20,42.7528,-70.7322,13,2,11,11,2,"MA",0.013
"3568",514,"199092.9350.21","MA",1990,9,7,250,20,42.7092,-70.629,22,14,8,17,5,"MA",0.013
"3569",514,"199092.9360.22","MA",1990,9,7,250,20,42.6252,-70.5328,8,5,3,7,1,"MA",0.013
"3570",514,"199092.9270.23","MA",1990,9,9,252,15,41.8335,-70.2882,18,6,12,8,10,"MA",0.013
"3571",514,"199092.9270.24","MA",1990,9,9,252,20,41.88,-70.177,9,3,6,8,1,"MA",0.013
"3572",514,"199092.9280.25","MA",1990,9,9,252,20,41.9352,-70.1778,4,1,3,4,0,"MA",0.013
"3573",514,"199092.9260.26","MA",1990,9,9,252,20,41.8875,-70.1398,1,0,1,1,0,"MA",0.013
"3574",514,"199092.9250.27","MA",1990,9,9,252,17,41.8888,-70.1147,0,0,0,0,0,"MA",0.013
"3575",514,"199092.9260.28","MA",1990,9,9,252,20,41.8012,-70.2467,19,14,5,18,1,"MA",0.013
"3576",514,"199092.9250.29","MA",1990,9,9,252,20,41.7417,-70.3067,0,0,0,0,0,"MA",0.013
"3577",514,"199092.9280.30","MA",1990,9,10,253,20,41.876,-70.3132,5,2,3,3,2,"MA",0.013
"3578",514,"199092.9290.31","MA",1990,9,10,253,20,41.9645,-70.4015,23,9,14,23,0,"MA",0.013
"3579",514,"199092.9290.32","MA",1990,9,10,253,20,42.0045,-70.4143,40,14,26,37,3,"MA",0.013
"3580",514,"199092.9300.33","MA",1990,9,10,253,20,42.0965,-70.3638,1,1,0,1,0,"MA",0.013
"3581",514,"199092.9290.34","MA",1990,9,10,253,20,41.9827,-70.2468,2,0,2,2,0,"MA",0.013
"3582",514,"199092.9290.35","MA",1990,9,10,253,20,41.9997,-70.2063,2,0,2,2,0,"MA",0.013
"3583",514,"199092.9280.36","MA",1990,9,10,253,20,41.9288,-70.2603,2,1,1,2,0,"MA",0.013
"3584",514,"199092.9300.37","MA",1990,9,11,254,20,42.0683,-70.3013,1,1,0,1,0,"MA",0.013
"3585",514,"199092.9210.38","MA",1990,9,11,254,20,42.1068,-70.2197,0,0,0,0,0,"MA",0.013
"3586",514,"199092.9200.39","MA",1990,9,11,254,20,42.1017,-70.1495,0,0,0,0,0,"MA",0.013
"3587",514,"199092.9200.41","MA",1990,9,11,254,15,42.0553,-70.0153,0,0,0,0,0,"MA",0.013
"3588",514,"199092.9210.42","MA",1990,9,11,254,20,42.0875,-70.0428,0,0,0,0,0,"MA",0.013
"3589",514,"199092.9170.43","MA",1990,9,12,255,17,42.0035,-70.0143,2,0,2,1,1,"MA",0.013
"3590",521,"199092.9170.44","MA",1990,9,12,255,20,41.943,-69.9738,2,0,2,2,0,"MA",0.013
"3591",521,"199092.9170.67","MA",1990,9,16,259,20,41.3885,-69.9948,0,0,0,0,0,"MA",0.013
"3592",521,"199092.9170.68","MA",1990,9,16,259,20,41.3565,-69.9795,0,0,0,0,0,"MA",0.013
"3593",514,"199192.9260.1","MA",1991,9,4,247,20,41.7718,-70.4165,96,43,53,57,39,"MA",0.013
"3594",514,"199192.9260.2","MA",1991,9,4,247,13,41.7983,-70.4907,127,64,63,79,48,"MA",0.013
"3595",514,"199192.9270.3","MA",1991,9,5,248,18,41.8873,-70.4803,21,9,12,15,6,"MA",0.013
"3596",514,"199192.9280.4","MA",1991,9,5,248,20,41.8828,-70.4188,5,3,2,5,0,"MA",0.013
"3597",514,"199192.9250.5","MA",1991,9,5,248,20,42.0517,-70.6368,969,583,386,122,847,"MA",0.013
"3598",514,"199192.9310.6","MA",1991,9,6,249,20,42.4538,-70.92,216,106,110,75,141,"MA",0.013
"3599",514,"199192.9350.7","MA",1991,9,6,249,16,42.4542,-70.718,8,4,4,8,0,"MA",0.013
"3600",514,"199192.9340.8","MA",1991,9,6,249,20,42.54,-70.735,11,2,9,10,1,"MA",0.013
"3601",514,"199192.9350.9","MA",1991,9,7,250,20,42.5837,-70.5872,28,9,19,24,4,"MA",0.013
"3602",514,"199192.9360.10","MA",1991,9,7,250,20,42.6173,-70.5362,21,5,16,20,1,"MA",0.013
"3603",514,"199192.9350.11","MA",1991,9,7,250,20,42.6998,-70.5758,4,2,2,4,0,"MA",0.013
"3604",514,"199192.9310.12","MA",1991,9,7,250,20,42.6865,-70.7282,37,19,18,21,16,"MA",0.013
"3605",514,"199192.9310.13","MA",1991,9,7,250,20,42.773,-70.7962,50,32,18,23,27,"MA",0.013
"3606",513,"199192.9330.14","MA",1991,9,7,250,20,42.8542,-70.7722,9,5,4,7,2,"MA",0.013
"3607",513,"199192.9340.15","MA",1991,9,7,250,20,42.8452,-70.7533,4,1,3,3,1,"MA",0.013
"3608",514,"199192.9330.16","MA",1991,9,7,250,20,42.7978,-70.7622,25,8,17,24,1,"MA",0.013
"3609",514,"199192.9360.17","MA",1991,9,7,250,20,42.7543,-70.6368,6,3,3,4,2,"MA",0.013
"3610",514,"199192.9350.18","MA",1991,9,8,251,20,42.5688,-70.5942,21,5,16,19,2,"MA",0.013
"3611",514,"199192.9360.19","MA",1991,9,8,251,20,42.4802,-70.6333,15,4,11,15,0,"MA",0.013
"3612",514,"199192.9360.20","MA",1991,9,8,251,20,42.4138,-70.653,22,3,19,22,0,"MA",0.013
"3613",514,"199192.9350.21","MA",1991,9,8,251,18,42.3757,-70.7022,8,1,7,8,0,"MA",0.013
"3614",514,"199192.9270.22","MA",1991,9,9,252,20,41.832,-70.3722,50,26,24,36,14,"MA",0.013
"3615",514,"199192.9290.23","MA",1991,9,9,252,20,41.9575,-70.365,8,4,4,8,0,"MA",0.013
"3616",514,"199192.9290.24","MA",1991,9,9,252,20,42.0178,-70.4273,19,7,12,19,0,"MA",0.013
"3617",514,"199192.9300.25","MA",1991,9,9,252,13,42.1088,-70.417,4,0,4,4,0,"MA",0.013
"3618",514,"199192.9300.26","MA",1991,9,9,252,20,42.0847,-70.3632,0,0,0,0,0,"MA",0.013
"3619",514,"199192.9290.27","MA",1991,9,9,252,20,42.0112,-70.2477,2,0,2,2,0,"MA",0.013
"3620",514,"199192.9290.28","MA",1991,9,9,252,20,41.9597,-70.3077,8,2,6,8,0,"MA",0.013
"3621",514,"199192.9270.30","MA",1991,9,10,253,20,41.8477,-70.226,16,13,3,12,4,"MA",0.013
"3622",514,"199192.9260.31","MA",1991,9,10,253,19,41.893,-70.1293,2,1,1,2,0,"MA",0.013
"3623",514,"199192.9250.32","MA",1991,9,10,253,20,41.9155,-70.1,0,0,0,0,0,"MA",0.013
"3624",514,"199192.9280.33","MA",1991,9,10,253,20,41.9207,-70.2277,5,1,4,5,0,"MA",0.013
"3625",514,"199192.9280.34","MA",1991,9,10,253,20,41.8782,-70.2428,2,0,2,1,1,"MA",0.013
"3626",514,"199192.9200.35","MA",1991,9,11,254,20,42.1002,-70.1357,6,2,4,3,3,"MA",0.013
"3627",514,"199192.9170.37","MA",1991,9,11,254,20,42.0578,-70.0805,0,0,0,0,0,"MA",0.013
"3628",514,"199192.9210.38","MA",1991,9,11,254,20,42.0932,-70.2142,1,0,1,1,0,"MA",0.013
"3629",514,"199192.9270.39","MA",1991,9,11,254,20,41.9688,-70.1393,4,1,3,3,1,"MA",0.013
"3630",514,"199192.9260.40","MA",1991,9,11,254,20,41.9678,-70.1183,9,6,3,8,1,"MA",0.013
"3631",514,"199192.9200.41","MA",1991,9,12,255,20,42.0527,-70.0143,0,0,0,0,0,"MA",0.013
"3632",521,"199192.9180.42","MA",1991,9,12,255,20,41.9797,-69.988,52,19,33,46,6,"MA",0.013
"3633",521,"199192.9170.43","MA",1991,9,12,255,20,41.9633,-69.9878,1,0,1,1,0,"MA",0.013
"3634",521,"199192.9210.44","MA",1991,9,12,255,20,41.8247,-69.8738,1,0,1,1,0,"MA",0.013
"3635",521,"199192.9180.45","MA",1991,9,12,255,14,41.7892,-69.9127,2,0,2,1,1,"MA",0.013
"3636",521,"199192.9170.67","MA",1991,9,15,258,13,41.3817,-69.9917,0,0,0,0,0,"MA",0.013
"3637",514,"199292.9270.1","MA",1992,9,9,253,20,41.816,-70.381,8,2,6,7,1,"MA",0.013
"3638",514,"199292.9270.2","MA",1992,9,9,253,20,41.841,-70.3128,3,1,2,3,0,"MA",0.013
"3639",514,"199292.9280.3","MA",1992,9,10,254,20,41.9538,-70.4757,4,0,4,4,0,"MA",0.013
"3640",514,"199292.9280.4","MA",1992,9,10,254,20,42.0993,-70.5382,2,2,0,2,0,"MA",0.013
"3641",514,"199292.9250.5","MA",1992,9,10,254,13,42.1537,-70.6885,361,183,178,110,251,"MA",0.013
"3642",514,"199292.9310.6","MA",1992,9,10,254,13,42.2847,-70.8552,722,378,344,156,566,"MA",0.013
"3643",514,"199292.9320.7","MA",1992,9,11,255,13,42.452,-70.9082,156,73,83,104,52,"MA",0.013
"3644",514,"199292.9330.8","MA",1992,9,11,255,20,42.4453,-70.8702,18,10,8,16,2,"MA",0.013
"3645",514,"199292.9350.9","MA",1992,9,11,255,20,42.52,-70.7158,10,2,8,9,1,"MA",0.013
"3646",514,"199292.9350.10","MA",1992,9,11,255,20,42.5843,-70.5903,5,0,5,5,0,"MA",0.013
"3647",514,"199292.9350.11","MA",1992,9,12,256,20,42.6978,-70.5703,0,0,0,0,0,"MA",0.013
"3648",514,"199292.9360.12","MA",1992,9,12,256,13,42.7063,-70.5575,0,0,0,0,0,"MA",0.013
"3649",514,"199292.9340.13","MA",1992,9,12,256,13,42.7323,-70.6765,0,0,0,0,0,"MA",0.013
"3650",514,"199292.9330.14","MA",1992,9,12,256,20,42.707,-70.715,5,2,3,5,0,"MA",0.013
"3651",514,"199292.9340.17","MA",1992,9,12,256,20,42.7043,-70.6345,3,0,3,3,0,"MA",0.013
"3652",514,"199292.9360.18","MA",1992,9,13,257,20,42.4685,-70.6422,3,1,2,3,0,"MA",0.013
"3653",514,"199292.9360.19","MA",1992,9,13,257,20,42.4237,-70.658,5,1,4,5,0,"MA",0.013
"3654",514,"199292.9350.20","MA",1992,9,13,257,20,42.3703,-70.6988,6,3,3,6,0,"MA",0.013
"3655",514,"199292.9290.21","MA",1992,9,13,257,20,42.0217,-70.4072,5,2,3,5,0,"MA",0.013
"3656",514,"199292.9260.22","MA",1992,9,14,258,13,41.7718,-70.4338,38,16,22,30,8,"MA",0.013
"3657",514,"199292.9280.23","MA",1992,9,14,258,20,41.9063,-70.3467,4,3,1,3,1,"MA",0.013
"3658",514,"199292.9280.24","MA",1992,9,14,258,20,41.944,-70.246,2,0,2,2,0,"MA",0.013
"3659",514,"199292.9290.25","MA",1992,9,14,258,20,41.963,-70.2818,0,0,0,0,0,"MA",0.013
"3660",514,"199292.9290.26","MA",1992,9,14,258,13,41.9907,-70.386,1,0,1,1,0,"MA",0.013
"3661",514,"199292.9300.27","MA",1992,9,14,258,20,42.0708,-70.3907,0,0,0,0,0,"MA",0.013
"3662",514,"199292.9260.28","MA",1992,9,15,259,20,41.8613,-70.1853,0,0,0,0,0,"MA",0.013
"3663",514,"199292.9250.29","MA",1992,9,15,259,20,41.9048,-70.1053,0,0,0,0,0,"MA",0.013
"3664",514,"199292.9270.30","MA",1992,9,15,259,20,41.9447,-70.1452,2,2,0,2,0,"MA",0.013
"3665",514,"199292.9280.31","MA",1992,9,15,259,20,41.985,-70.1918,1,1,0,1,0,"MA",0.013
"3666",514,"199292.9290.32","MA",1992,9,15,259,13,42.0448,-70.3215,1,0,1,1,0,"MA",0.013
"3667",514,"199292.9300.33","MA",1992,9,16,260,20,42.084,-70.3035,1,0,1,0,1,"MA",0.013
"3668",514,"199292.9200.35","MA",1992,9,16,260,13,42.1035,-70.1443,0,0,0,0,0,"MA",0.013
"3669",514,"199292.9170.36","MA",1992,9,16,260,20,42.0578,-70.0758,0,0,0,0,0,"MA",0.013
"3670",514,"199292.9210.38","MA",1992,9,16,260,15,42.0755,-70.0255,0,0,0,0,0,"MA",0.013
"3671",521,"199292.9180.39","MA",1992,9,17,261,15,41.974,-69.9838,28,13,15,23,5,"MA",0.013
"3672",521,"199292.9170.40","MA",1992,9,17,261,20,41.881,-69.9513,0,0,0,0,0,"MA",0.013
"3673",521,"199292.9200.41","MA",1992,9,17,261,20,41.8018,-69.8757,1,1,0,1,0,"MA",0.013
"3674",521,"199292.9180.42","MA",1992,9,17,261,13,41.7817,-69.9215,1,0,1,1,0,"MA",0.013
"3675",514,"199392.9260.1","MA",1993,9,8,251,20,41.7622,-70.3655,1,1,0,1,0,"MA",0.013
"3676",514,"199392.9260.2","MA",1993,9,9,252,20,41.8167,-70.4798,3,2,1,3,0,"MA",0.013
"3677",514,"199392.9270.3","MA",1993,9,9,252,20,41.8913,-70.4877,4,2,2,2,2,"MA",0.013
"3678",514,"199392.9250.4","MA",1993,9,9,252,20,41.9767,-70.5995,8,3,5,7,1,"MA",0.013
"3679",514,"199392.9280.5","MA",1993,9,9,252,20,42.0027,-70.5367,10,5,5,7,3,"MA",0.013
"3680",514,"199392.9270.6","MA",1993,9,9,252,20,42.0545,-70.5745,2,1,1,2,0,"MA",0.013
"3681",514,"199392.9280.7","MA",1993,9,9,252,20,42.0837,-70.5535,4,3,1,4,0,"MA",0.013
"3682",514,"199392.9310.8","MA",1993,9,10,253,20,42.2927,-70.8652,250,113,137,36,214,"MA",0.013
"3683",514,"199392.9310.9","MA",1993,9,10,253,15,42.4523,-70.9157,8,2,6,4,4,"MA",0.013
"3684",514,"199392.9320.10","MA",1993,9,10,253,13,42.4513,-70.9042,45,17,28,27,18,"MA",0.013
"3685",514,"199392.9330.11","MA",1993,9,10,253,20,42.4522,-70.8717,12,7,5,11,1,"MA",0.013
"3686",514,"199392.9340.12","MA",1993,9,10,253,20,42.5493,-70.7183,14,6,8,13,1,"MA",0.013
"3687",514,"199392.9350.13","MA",1993,9,10,253,20,42.5905,-70.5833,16,5,11,13,3,"MA",0.013
"3688",514,"199392.9360.14","MA",1993,9,11,254,20,42.6272,-70.5285,19,10,9,17,2,"MA",0.013
"3689",514,"199392.9360.15","MA",1993,9,11,254,20,42.712,-70.5457,0,0,0,0,0,"MA",0.013
"3690",514,"199392.9350.16","MA",1993,9,11,254,20,42.702,-70.6052,6,4,2,5,1,"MA",0.013
"3691",514,"199392.9340.17","MA",1993,9,11,254,20,42.7153,-70.6767,0,0,0,0,0,"MA",0.013
"3692",514,"199392.9330.18","MA",1993,9,11,254,20,42.6923,-70.6777,4,3,1,4,0,"MA",0.013
"3693",514,"199392.9320.19","MA",1993,9,11,254,20,42.7393,-70.7527,9,5,4,8,1,"MA",0.013
"3694",514,"199392.9330.20","MA",1993,9,11,254,20,42.7682,-70.7383,4,2,2,4,0,"MA",0.013
"3695",514,"199392.9360.21","MA",1993,9,12,255,18,42.475,-70.6462,18,5,13,16,2,"MA",0.013
"3696",514,"199392.9360.22","MA",1993,9,12,255,20,42.4172,-70.6543,21,7,14,21,0,"MA",0.013
"3697",514,"199392.9350.23","MA",1993,9,12,255,20,42.3732,-70.6967,4,1,3,4,0,"MA",0.013
"3698",514,"199392.9290.24","MA",1993,9,12,255,20,42.0612,-70.5118,52,24,28,43,9,"MA",0.013
"3699",514,"199392.9250.25","MA",1993,9,13,256,17,41.7525,-70.4272,20,10,10,14,6,"MA",0.013
"3700",514,"199392.9260.26","MA",1993,9,13,256,20,41.7993,-70.2282,2,0,2,2,0,"MA",0.013
"3701",514,"199392.9270.27","MA",1993,9,13,256,20,41.8648,-70.2173,1,1,0,1,0,"MA",0.013
"3702",514,"199392.9260.28","MA",1993,9,13,256,20,41.92,-70.1213,2,1,1,2,0,"MA",0.013
"3703",514,"199392.9270.30","MA",1993,9,13,256,14,41.9882,-70.134,0,0,0,0,0,"MA",0.013
"3704",514,"199392.9270.31","MA",1993,9,14,257,18,41.8442,-70.4243,4,2,2,2,2,"MA",0.013
"3705",514,"199392.9280.32","MA",1993,9,14,257,20,41.8887,-70.3885,7,0,7,6,1,"MA",0.013
"3706",514,"199392.9280.33","MA",1993,9,14,257,13,41.9303,-70.2803,0,0,0,0,0,"MA",0.013
"3707",514,"199392.9280.34","MA",1993,9,14,257,20,41.9623,-70.1832,1,0,1,1,0,"MA",0.013
"3708",514,"199392.9290.35","MA",1993,9,14,257,20,42.0348,-70.3173,0,0,0,0,0,"MA",0.013
"3709",514,"199392.9290.36","MA",1993,9,14,257,20,41.9712,-70.3202,3,0,3,3,0,"MA",0.013
"3710",514,"199392.9290.37","MA",1993,9,14,257,20,41.9387,-70.3433,1,0,1,1,0,"MA",0.013
"3711",514,"199392.9300.38","MA",1993,9,15,258,20,42.0663,-70.3333,0,0,0,0,0,"MA",0.013
"3712",514,"199392.9300.39","MA",1993,9,15,258,20,42.1042,-70.3287,0,0,0,0,0,"MA",0.013
"3713",514,"199392.9210.40","MA",1993,9,15,258,13,42.1097,-70.2177,0,0,0,0,0,"MA",0.013
"3714",514,"199392.9170.42","MA",1993,9,15,258,20,42.0835,-70.1335,1,0,1,1,0,"MA",0.013
"3715",521,"199392.9210.52","MA",1993,9,18,261,20,41.8252,-69.875,0,0,0,0,0,"MA",0.013
"3716",521,"199392.9200.53","MA",1993,9,18,261,20,41.7892,-69.8772,0,0,0,0,0,"MA",0.013
"3717",521,"199392.9180.55","MA",1993,9,19,262,20,41.4362,-69.9587,0,0,0,0,0,"MA",0.013
"3718",521,"199392.9170.56","MA",1993,9,19,262,20,41.3943,-69.987,0,0,0,0,0,"MA",0.013
"3719",514,"199492.9260.1","MA",1994,9,7,250,20,41.7652,-70.3488,7,4,3,6,1,"MA",0.013
"3720",514,"199492.9270.2","MA",1994,9,7,250,20,41.8382,-70.3242,17,8,9,16,1,"MA",0.013
"3721",514,"199492.9280.3","MA",1994,9,7,250,20,41.871,-70.4115,27,13,14,26,1,"MA",0.013
"3722",514,"199492.9270.4","MA",1994,9,7,250,20,41.8362,-70.4202,20,7,13,17,3,"MA",0.013
"3723",514,"199492.9250.5","MA",1994,9,7,250,20,41.8563,-70.5177,9,4,5,7,2,"MA",0.013
"3724",514,"199492.9260.6","MA",1994,9,8,251,20,41.8087,-70.4845,62,37,25,48,14,"MA",0.013
"3725",514,"199492.9280.7","MA",1994,9,8,251,18,42.0077,-70.5177,53,27,26,40,13,"MA",0.013
"3726",514,"199492.9270.8","MA",1994,9,8,251,20,42.0492,-70.5715,283,180,103,223,60,"MA",0.013
"3727",514,"199492.9250.9","MA",1994,9,8,251,13,42.0528,-70.6372,995,484,511,184,811,"MA",0.013
"3728",514,"199492.9260.10","MA",1994,9,8,251,13,42.1467,-70.6868,627,345,282,174,453,"MA",0.013
"3729",514,"199492.9310.11","MA",1994,9,9,252,18,42.2875,-70.8635,1806,906,900,329,1477,"MA",0.013
"3730",514,"199492.9320.12","MA",1994,9,9,252,15,42.4417,-70.9052,27,13,14,13,14,"MA",0.013
"3731",514,"199492.9330.13","MA",1994,9,9,252,20,42.4495,-70.876,231,103,128,163,68,"MA",0.013
"3732",514,"199492.9340.14","MA",1994,9,9,252,20,42.449,-70.8357,71,21,50,58,13,"MA",0.013
"3733",514,"199492.9350.15","MA",1994,9,9,252,20,42.4665,-70.7223,9,2,7,9,0,"MA",0.013
"3734",514,"199492.9350.16","MA",1994,9,9,252,20,42.5213,-70.7118,60,16,44,54,6,"MA",0.013
"3735",514,"199492.9350.17","MA",1994,9,10,253,20,42.5865,-70.5822,41,24,17,31,10,"MA",0.013
"3736",514,"199492.9360.18","MA",1994,9,10,253,20,42.7135,-70.5437,2,0,2,2,0,"MA",0.013
"3737",514,"199492.9360.19","MA",1994,9,10,253,20,42.7375,-70.6188,1,0,1,1,0,"MA",0.013
"3738",513,"199492.9330.20","MA",1994,9,10,253,20,42.8542,-70.7842,14,10,4,13,1,"MA",0.013
"3739",514,"199492.9330.21","MA",1994,9,10,253,20,42.7727,-70.758,15,8,7,13,2,"MA",0.013
"3740",514,"199492.9310.22","MA",1994,9,10,253,16,42.765,-70.7905,24,9,15,13,11,"MA",0.013
"3741",514,"199492.9310.23","MA",1994,9,10,253,20,42.7247,-70.7735,20,11,9,9,11,"MA",0.013
"3742",514,"199492.9320.24","MA",1994,9,10,253,13,42.7123,-70.7562,51,17,34,16,35,"MA",0.013
"3743",514,"199492.9340.25","MA",1994,9,10,253,20,42.7288,-70.6707,13,9,4,12,1,"MA",0.013
"3744",514,"199492.9360.26","MA",1994,9,11,254,20,42.4647,-70.6435,8,1,7,8,0,"MA",0.013
"3745",514,"199492.9360.27","MA",1994,9,11,254,19,42.421,-70.6565,22,2,20,22,0,"MA",0.013
"3746",514,"199492.9350.28","MA",1994,9,11,254,20,42.37,-70.6997,17,2,15,17,0,"MA",0.013
"3747",514,"199492.9290.29","MA",1994,9,11,254,20,42.0752,-70.5215,16,9,7,14,2,"MA",0.013
"3748",514,"199492.9290.30","MA",1994,9,11,254,20,42.0002,-70.3985,8,4,4,6,2,"MA",0.013
"3749",514,"199492.9270.31","MA",1994,9,12,255,20,41.8367,-70.2518,20,12,8,14,6,"MA",0.013
"3750",514,"199492.9280.32","MA",1994,9,12,255,20,41.8923,-70.2228,2,1,1,2,0,"MA",0.013
"3751",514,"199492.9280.33","MA",1994,9,12,255,20,41.9097,-70.2012,6,3,3,6,0,"MA",0.013
"3752",514,"199492.9260.34","MA",1994,9,12,255,20,41.891,-70.1277,1,0,1,1,0,"MA",0.013
"3753",514,"199492.9250.35","MA",1994,9,12,255,20,41.8827,-70.1157,0,0,0,0,0,"MA",0.013
"3754",514,"199492.9270.36","MA",1994,9,12,255,20,41.9342,-70.149,12,6,6,11,1,"MA",0.013
"3755",514,"199492.9260.37","MA",1994,9,12,255,20,41.8487,-70.192,9,5,4,8,1,"MA",0.013
"3756",514,"199492.9280.38","MA",1994,9,13,256,20,41.909,-70.2902,12,7,5,11,1,"MA",0.013
"3757",514,"199492.9290.39","MA",1994,9,13,256,20,42.0035,-70.2905,3,2,1,3,0,"MA",0.013
"3758",514,"199492.9290.40","MA",1994,9,13,256,20,41.9817,-70.3935,17,5,12,16,1,"MA",0.013
"3759",514,"199492.9290.41","MA",1994,9,13,256,20,42.0395,-70.3255,5,0,5,5,0,"MA",0.013
"3760",514,"199492.9300.42","MA",1994,9,13,256,20,42.0938,-70.3102,0,0,0,0,0,"MA",0.013
"3761",514,"199492.9300.43","MA",1994,9,13,256,20,42.077,-70.3657,0,0,0,0,0,"MA",0.013
"3762",514,"199492.9190.44","MA",1994,9,14,257,13,42.0265,-70.015,1,0,1,1,0,"MA",0.013
"3763",514,"199492.9210.46","MA",1994,9,14,257,13,42.0727,-70.0177,0,0,0,0,0,"MA",0.013
"3764",514,"199492.9200.47","MA",1994,9,14,257,13,42.1002,-70.151,0,0,0,0,0,"MA",0.013
"3765",514,"199492.9210.48","MA",1994,9,14,257,13,42.0992,-70.2178,0,0,0,0,0,"MA",0.013
"3766",521,"199492.9170.49","MA",1994,9,15,258,13,41.925,-69.9687,0,0,0,0,0,"MA",0.013
"3767",521,"199492.9170.50","MA",1994,9,15,258,18,41.8643,-69.9457,0,0,0,0,0,"MA",0.013
"3768",521,"199492.9180.51","MA",1994,9,15,258,13,41.715,-69.8957,0,0,0,0,0,"MA",0.013
"3769",521,"199492.9180.52","MA",1994,9,15,258,20,41.6467,-69.9198,0,0,0,0,0,"MA",0.013
"3770",521,"199492.9170.74","MA",1994,9,19,262,20,41.3985,-69.978,0,0,0,0,0,"MA",0.013
"3771",521,"199492.9170.75","MA",1994,9,19,262,20,41.367,-69.9943,0,0,0,0,0,"MA",0.013
"3772",521,"199492.9180.76","MA",1994,9,19,262,20,41.364,-69.955,1,1,0,1,0,"MA",0.013
"3773",514,"199592.9260.1","MA",1995,9,6,249,20,41.7692,-70.355,7,5,2,7,0,"MA",0.013
"3774",514,"199592.9270.2","MA",1995,9,6,249,20,41.7862,-70.3948,13,6,7,11,2,"MA",0.013
"3775",514,"199592.9280.3","MA",1995,9,6,249,20,41.8898,-70.2472,1,1,0,1,0,"MA",0.013
"3776",514,"199592.9270.4","MA",1995,9,7,250,20,41.8808,-70.4735,13,6,7,8,5,"MA",0.013
"3777",514,"199592.9270.5","MA",1995,9,7,250,13,41.9548,-70.5375,234,143,91,113,121,"MA",0.013
"3778",514,"199592.9250.6","MA",1995,9,7,250,20,41.9757,-70.6018,129,61,68,80,49,"MA",0.013
"3779",514,"199592.9260.7","MA",1995,9,7,250,20,41.9772,-70.5793,40,18,22,25,15,"MA",0.013
"3780",514,"199592.9250.8","MA",1995,9,7,250,13,42.0502,-70.6347,629,254,375,130,499,"MA",0.013
"3781",514,"199592.9280.9","MA",1995,9,7,250,20,42.0938,-70.5438,12,5,7,6,6,"MA",0.013
"3782",514,"199592.9320.10","MA",1995,9,7,250,13,42.2878,-70.856,1819,954,865,507,1312,"MA",0.013
"3783",514,"199592.9310.11","MA",1995,9,8,251,13,42.439,-70.917,247,115,132,113,134,"MA",0.013
"3784",514,"199592.9330.12","MA",1995,9,8,251,20,42.4482,-70.8793,64,18,46,53,11,"MA",0.013
"3785",514,"199592.9350.13","MA",1995,9,8,251,13,42.5037,-70.7217,8,4,4,6,2,"MA",0.013
"3786",514,"199592.9350.14","MA",1995,9,8,251,14,42.531,-70.668,6,2,4,6,0,"MA",0.013
"3787",514,"199592.9350.15","MA",1995,9,9,252,20,42.5828,-70.593,44,27,17,37,7,"MA",0.013
"3788",514,"199592.9360.16","MA",1995,9,9,252,13,42.7075,-70.5383,12,6,6,10,2,"MA",0.013
"3789",514,"199592.9350.17","MA",1995,9,9,252,20,42.709,-70.6017,21,12,9,18,3,"MA",0.013
"3790",514,"199592.9350.18","MA",1995,9,9,252,20,42.7347,-70.635,25,12,13,23,2,"MA",0.013
"3791",513,"199592.9340.19","MA",1995,9,9,252,20,42.8368,-70.7532,3,1,2,2,1,"MA",0.013
"3792",513,"199592.9340.20","MA",1995,9,9,252,20,42.844,-70.7523,5,0,5,5,0,"MA",0.013
"3793",513,"199592.9330.21","MA",1995,9,9,252,13,42.848,-70.7728,5,1,4,5,0,"MA",0.013
"3794",514,"199592.9330.22","MA",1995,9,9,252,20,42.7735,-70.7565,1,0,1,1,0,"MA",0.013
"3795",514,"199592.9320.23","MA",1995,9,9,252,20,42.7622,-70.7733,12,3,9,9,3,"MA",0.013
"3796",514,"199592.9310.24","MA",1995,9,9,252,13,42.6925,-70.7247,59,40,19,38,21,"MA",0.013
"3797",514,"199592.9310.25","MA",1995,9,9,252,13,42.689,-70.722,20,10,10,15,5,"MA",0.013
"3798",514,"199592.9320.26","MA",1995,9,9,252,13,42.6875,-70.6935,34,14,20,20,14,"MA",0.013
"3799",514,"199592.9340.27","MA",1995,9,10,253,20,42.5413,-70.7195,56,25,31,50,6,"MA",0.013
"3800",514,"199592.9360.28","MA",1995,9,10,253,13,42.5145,-70.661,54,17,37,54,0,"MA",0.013
"3801",514,"199592.9290.29","MA",1995,9,10,253,20,42.0557,-70.5147,48,22,26,44,4,"MA",0.013
"3802",514,"199592.9260.30","MA",1995,9,11,254,20,41.7958,-70.4777,26,12,14,21,5,"MA",0.013
"3803",514,"199592.9250.31","MA",1995,9,11,254,13,41.8802,-70.1227,0,0,0,0,0,"MA",0.013
"3804",514,"199592.9260.34","MA",1995,9,11,254,13,41.9222,-70.1132,22,18,4,20,2,"MA",0.013
"3805",514,"199592.9270.35","MA",1995,9,11,254,20,41.9485,-70.1482,1,0,1,1,0,"MA",0.013
"3806",514,"199592.9280.36","MA",1995,9,12,255,20,41.8658,-70.2962,19,10,9,14,5,"MA",0.013
"3807",514,"199592.9280.37","MA",1995,9,12,255,20,41.88,-70.4433,13,4,9,11,2,"MA",0.013
"3808",514,"199592.9290.38","MA",1995,9,12,255,13,41.937,-70.4168,12,4,8,12,0,"MA",0.013
"3809",514,"199592.9290.39","MA",1995,9,12,255,20,41.9762,-70.4022,7,1,6,7,0,"MA",0.013
"3810",514,"199592.9290.40","MA",1995,9,12,255,13,41.9627,-70.2657,7,1,6,7,0,"MA",0.013
"3811",514,"199592.9290.41","MA",1995,9,13,256,13,42.0068,-70.315,8,1,7,8,0,"MA",0.013
"3812",514,"199592.9300.42","MA",1995,9,13,256,20,42.0818,-70.3193,0,0,0,0,0,"MA",0.013
"3813",514,"199592.9300.43","MA",1995,9,13,256,20,42.1037,-70.2842,0,0,0,0,0,"MA",0.013
"3814",514,"199592.9210.44","MA",1995,9,13,256,20,42.1092,-70.231,0,0,0,0,0,"MA",0.013
"3815",514,"199592.9200.45","MA",1995,9,13,256,13,42.062,-70.0243,0,0,0,0,0,"MA",0.013
"3816",514,"199592.9170.47","MA",1995,9,13,256,13,42.0858,-70.1503,0,0,0,0,0,"MA",0.013
"3817",521,"199592.9180.48","MA",1995,9,14,257,20,41.9785,-69.981,4,2,2,4,0,"MA",0.013
"3818",521,"199592.9190.49","MA",1995,9,14,257,13,41.8365,-69.9175,2,1,1,2,0,"MA",0.013
"3819",521,"199592.9200.50","MA",1995,9,14,257,14,41.8208,-69.8898,1,1,0,1,0,"MA",0.013
"3820",521,"199592.9170.51","MA",1995,9,14,257,20,41.8212,-69.9288,6,6,0,6,0,"MA",0.013
"3821",521,"199592.9180.52","MA",1995,9,14,257,20,41.8015,-69.915,3,2,1,3,0,"MA",0.013
"3822",521,"199592.9170.74","MA",1995,9,18,261,13,41.391,-69.9935,0,0,0,0,0,"MA",0.013
"3823",521,"199592.9180.75","MA",1995,9,18,261,20,41.3685,-69.9558,0,0,0,0,0,"MA",0.013
"3824",514,"199692.9260.1","MA",1996,9,4,248,20,41.7707,-70.4292,44,26,18,30,14,"MA",0.013
"3825",514,"199692.9270.2","MA",1996,9,4,248,20,41.7912,-70.3815,9,5,4,6,3,"MA",0.013
"3826",514,"199692.9280.3","MA",1996,9,4,248,20,41.8653,-70.3247,11,6,5,11,0,"MA",0.013
"3827",514,"199692.9280.4","MA",1996,9,4,248,20,41.8887,-70.4343,36,14,22,32,4,"MA",0.013
"3828",514,"199692.9280.5","MA",1996,9,4,248,15,41.8997,-70.4613,6,2,4,6,0,"MA",0.013
"3829",514,"199692.9270.6","MA",1996,9,4,248,20,41.8762,-70.4725,40,23,17,18,22,"MA",0.013
"3830",514,"199692.9260.7","MA",1996,9,4,248,17,41.8413,-70.4928,30,13,17,21,9,"MA",0.013
"3831",514,"199692.9250.8","MA",1996,9,5,249,20,41.98,-70.5963,84,47,37,44,40,"MA",0.013
"3832",514,"199692.9250.9","MA",1996,9,5,249,13,42.0552,-70.6362,623,304,319,76,547,"MA",0.013
"3833",514,"199692.9270.10","MA",1996,9,5,249,20,42.1077,-70.5603,37,20,17,33,4,"MA",0.013
"3834",514,"199692.9310.11","MA",1996,9,5,249,13,42.2905,-70.864,1557,812,745,422,1135,"MA",0.013
"3835",514,"199692.9320.12","MA",1996,9,5,249,13,42.2907,-70.8598,873,488,385,290,583,"MA",0.013
"3836",514,"199692.9330.13","MA",1996,9,6,250,13,42.3827,-70.8158,158,83,75,120,38,"MA",0.013
"3837",514,"199692.9340.14","MA",1996,9,6,250,13,42.4433,-70.8573,138,59,79,89,49,"MA",0.013
"3838",514,"199692.9320.15","MA",1996,9,6,250,13,42.4525,-70.9088,266,118,148,82,184,"MA",0.013
"3839",514,"199692.9350.16","MA",1996,9,6,250,20,42.4923,-70.738,18,6,12,13,5,"MA",0.013
"3840",514,"199692.9350.17","MA",1996,9,6,250,13,42.5042,-70.7263,14,1,13,14,0,"MA",0.013
"3841",514,"199692.9350.18","MA",1996,9,6,250,15,42.5417,-70.6618,9,3,6,8,1,"MA",0.013
"3842",514,"199692.9360.19","MA",1996,9,6,250,20,42.5022,-70.6352,22,3,19,20,2,"MA",0.013
"3843",514,"199692.9350.20","MA",1996,9,6,250,13,42.5668,-70.5985,16,10,6,10,6,"MA",0.013
"3844",514,"199692.9350.21","MA",1996,9,7,251,20,42.579,-70.6032,28,11,17,22,6,"MA",0.013
"3845",514,"199692.9360.22","MA",1996,9,7,251,20,42.618,-70.5388,22,8,14,19,3,"MA",0.013
"3846",514,"199692.9350.23","MA",1996,9,7,251,20,42.6968,-70.5747,18,9,9,17,1,"MA",0.013
"3847",514,"199692.9350.24","MA",1996,9,7,251,20,42.7123,-70.6077,12,2,10,12,0,"MA",0.013
"3848",514,"199692.9340.25","MA",1996,9,7,251,20,42.7167,-70.6572,4,3,1,3,1,"MA",0.013
"3849",514,"199692.9320.26","MA",1996,9,7,251,19.7,42.7482,-70.7682,78,43,35,60,18,"MA",0.013
"3850",514,"199692.9330.27","MA",1996,9,7,251,20,42.7492,-70.7508,8,4,4,7,1,"MA",0.013
"3851",514,"199692.9330.28","MA",1996,9,7,251,20,42.7668,-70.7458,14,4,10,11,3,"MA",0.013
"3852",514,"199692.9310.29","MA",1996,9,7,251,20,42.7627,-70.7937,9,3,6,5,4,"MA",0.013
"3853",514,"199692.9310.30","MA",1996,9,7,251,20,42.7308,-70.7743,2,1,1,1,1,"MA",0.013
"3854",514,"199692.9290.31","MA",1996,9,8,252,20,41.9667,-70.3877,5,1,4,5,0,"MA",0.013
"3855",514,"199692.9290.32","MA",1996,9,8,252,13,41.9485,-70.3923,1,0,1,1,0,"MA",0.013
"3856",514,"199692.9290.33","MA",1996,9,8,252,13,42.008,-70.385,5,1,4,5,0,"MA",0.013
"3857",514,"199692.9290.34","MA",1996,9,8,252,20,41.981,-70.3037,8,2,6,7,1,"MA",0.013
"3858",514,"199692.9260.35","MA",1996,9,9,253,20,41.76,-70.3527,14,4,10,14,0,"MA",0.013
"3859",514,"199692.9260.36","MA",1996,9,9,253,20,41.8395,-70.2022,3,2,1,2,1,"MA",0.013
"3860",514,"199692.9270.37","MA",1996,9,9,253,13,41.8478,-70.2435,1,1,0,1,0,"MA",0.013
"3861",514,"199692.9250.39","MA",1996,9,9,253,13,41.943,-70.0957,1,1,0,0,1,"MA",0.013
"3862",514,"199692.9280.40","MA",1996,9,10,254,13,41.9263,-70.2845,0,0,0,0,0,"MA",0.013
"3863",514,"199692.9280.41","MA",1996,9,10,254,13,41.9105,-70.2413,1,1,0,1,0,"MA",0.013
"3864",514,"199692.9270.42","MA",1996,9,10,254,13,41.9987,-70.1595,1,0,1,1,0,"MA",0.013
"3865",514,"199692.9290.43","MA",1996,9,10,254,20,42.0123,-70.2288,3,1,2,3,0,"MA",0.013
"3866",514,"199692.9300.44","MA",1996,9,10,254,20,42.0712,-70.303,0,0,0,0,0,"MA",0.013
"3867",514,"199692.9300.45","MA",1996,9,10,254,20,42.0852,-70.369,2,1,1,2,0,"MA",0.013
"3868",514,"199692.9210.46","MA",1996,9,11,255,20,42.1075,-70.2263,1,0,1,1,0,"MA",0.013
"3869",514,"199692.9170.47","MA",1996,9,11,255,13,42.0857,-70.1488,0,0,0,0,0,"MA",0.013
"3870",514,"199692.9180.48","MA",1996,9,11,255,20,42.0823,-70.1112,1,0,1,1,0,"MA",0.013
"3871",514,"199692.9200.49","MA",1996,9,11,255,20,42.0587,-70.025,1,0,1,1,0,"MA",0.013
"3872",514,"199692.9170.50","MA",1996,9,11,255,20,41.9957,-70.0085,1,0,1,1,0,"MA",0.013
"3873",514,"199692.9210.51","MA",1996,9,11,255,20,42.0792,-70.0272,0,0,0,0,0,"MA",0.013
"3874",521,"199692.9190.52","MA",1996,9,12,256,20,41.831,-69.9142,4,0,4,4,0,"MA",0.013
"3875",521,"199692.9200.53","MA",1996,9,12,256,20,41.833,-69.8952,7,3,4,3,4,"MA",0.013
"3876",521,"199692.9180.54","MA",1996,9,12,256,13,41.746,-69.9107,12,4,8,10,2,"MA",0.013
"3877",521,"199692.9170.77","MA",1996,9,16,260,13,41.376,-69.9932,0,0,0,0,0,"MA",0.013
"3878",514,"199792.9270.1","MA",1997,9,9,252,20,41.7907,-70.429,16,11,5,15,1,"MA",0.013
"3879",514,"199792.9260.2","MA",1997,9,9,252,20,41.7518,-70.3705,53,25,28,49,4,"MA",0.013
"3880",514,"199792.9250.3","MA",1997,9,9,252,20,41.7502,-70.2855,0,0,0,0,0,"MA",0.013
"3881",514,"199792.9260.4","MA",1997,9,9,252,20,41.794,-70.2538,15,10,5,14,1,"MA",0.013
"3882",514,"199792.9260.5","MA",1997,9,9,252,13,41.8262,-70.1352,0,0,0,0,0,"MA",0.013
"3883",514,"199792.9270.6","MA",1997,9,9,252,20,41.8218,-70.3687,16,9,7,15,1,"MA",0.013
"3884",514,"199792.9260.7","MA",1997,9,10,253,20,41.8077,-70.4888,71,33,38,61,10,"MA",0.013
"3885",514,"199792.9280.8","MA",1997,9,10,253,20,41.9112,-70.4657,7,4,3,7,0,"MA",0.013
"3886",514,"199792.9270.9","MA",1997,9,10,253,20,42.0385,-70.572,30,21,9,27,3,"MA",0.013
"3887",514,"199792.9250.10","MA",1997,9,10,253,13,42.057,-70.6382,109,47,62,20,89,"MA",0.013
"3888",514,"199792.9310.11","MA",1997,9,10,253,13,42.2893,-70.8635,117,57,60,36,81,"MA",0.013
"3889",514,"199792.9330.12","MA",1997,9,11,254,14,42.4515,-70.8732,14,7,7,8,6,"MA",0.013
"3890",514,"199792.9340.13","MA",1997,9,11,254,13,42.4337,-70.8538,24,10,14,16,8,"MA",0.013
"3891",514,"199792.9350.14","MA",1997,9,11,254,20,42.5132,-70.7008,3,1,2,1,2,"MA",0.013
"3892",514,"199792.9350.15","MA",1997,9,12,255,13,42.5732,-70.6045,21,8,13,11,10,"MA",0.013
"3893",514,"199792.9360.16","MA",1997,9,12,255,20,42.6265,-70.5362,22,9,13,19,3,"MA",0.013
"3894",514,"199792.9360.17","MA",1997,9,12,255,20,42.6708,-70.5192,9,2,7,7,2,"MA",0.013
"3895",514,"199792.9340.18","MA",1997,9,12,255,20,42.7297,-70.6768,5,2,3,5,0,"MA",0.013
"3896",514,"199792.9320.20","MA",1997,9,12,255,13,42.7423,-70.7633,83,39,44,71,12,"MA",0.013
"3897",514,"199792.9310.21","MA",1997,9,12,255,20,42.7678,-70.7945,1,1,0,1,0,"MA",0.013
"3898",514,"199792.9310.23","MA",1997,9,12,255,20,42.7218,-70.7728,1,0,1,0,1,"MA",0.013
"3899",514,"199792.9290.24","MA",1997,9,13,256,20,42.0607,-70.5287,18,13,5,14,4,"MA",0.013
"3900",514,"199792.9290.25","MA",1997,9,13,256,20,42.1055,-70.5055,6,2,4,6,0,"MA",0.013
"3901",514,"199792.9300.26","MA",1997,9,13,256,20,42.1073,-70.4182,9,5,4,9,0,"MA",0.013
"3902",514,"199792.9290.27","MA",1997,9,13,256,13,41.9727,-70.4712,1,1,0,0,1,"MA",0.013
"3903",514,"199792.9280.28","MA",1997,9,14,257,20,41.862,-70.335,0,0,0,0,0,"MA",0.013
"3904",514,"199792.9280.29","MA",1997,9,14,257,20,41.8792,-70.2918,3,2,1,3,0,"MA",0.013
"3905",514,"199792.9290.30","MA",1997,9,14,257,20,42.0222,-70.3568,7,3,4,7,0,"MA",0.013
"3906",514,"199792.9300.31","MA",1997,9,14,257,20,42.1063,-70.3465,6,2,4,5,1,"MA",0.013
"3907",514,"199792.9280.32","MA",1997,9,14,257,13,41.9783,-70.1787,0,0,0,0,0,"MA",0.013
"3908",514,"199792.9280.33","MA",1997,9,14,257,20,41.9308,-70.1975,1,0,1,1,0,"MA",0.013
"3909",514,"199792.9270.34","MA",1997,9,15,258,20,41.9243,-70.1578,3,2,1,3,0,"MA",0.013
"3910",514,"199792.9270.35","MA",1997,9,15,258,20,41.9255,-70.1635,3,2,1,3,0,"MA",0.013
"3911",514,"199792.9250.36","MA",1997,9,15,258,19,41.9228,-70.0993,0,0,0,0,0,"MA",0.013
"3912",514,"199792.9260.37","MA",1997,9,15,258,13,41.8822,-70.1478,8,2,6,8,0,"MA",0.013
"3913",514,"199792.9290.38","MA",1997,9,16,259,20,42.0135,-70.2987,1,1,0,1,0,"MA",0.013
"3914",514,"199792.9170.39","MA",1997,9,16,259,17,42.0817,-70.127,0,0,0,0,0,"MA",0.013
"3915",514,"199792.9210.40","MA",1997,9,16,259,20,42.0907,-70.0485,0,0,0,0,0,"MA",0.013
"3916",514,"199792.9190.41","MA",1997,9,16,259,13,42.0365,-70.0287,0,0,0,0,0,"MA",0.013
"3917",514,"199792.9200.42","MA",1997,9,17,260,20,42.0732,-70.0363,0,0,0,0,0,"MA",0.013
"3918",521,"199792.9180.43","MA",1997,9,17,260,13,41.9342,-69.968,1,1,0,1,0,"MA",0.013
"3919",521,"199792.9170.44","MA",1997,9,17,260,13,41.8968,-69.957,0,0,0,0,0,"MA",0.013
"3920",521,"199792.9210.45","MA",1997,9,17,260,20,41.822,-69.873,0,0,0,0,0,"MA",0.013
"3921",521,"199792.9200.46","MA",1997,9,17,260,20,41.7893,-69.8758,0,0,0,0,0,"MA",0.013
"3922",521,"199792.9180.47","MA",1997,9,17,260,18,41.7488,-69.9145,2,1,1,2,0,"MA",0.013
"3923",521,"199792.9170.70","MA",1997,9,21,264,20,41.3602,-69.9842,0,0,0,0,0,"MA",0.013
"3924",514,"199892.9270.1","MA",1998,9,10,253,18,41.876,-70.4723,2,1,1,2,0,"MA",0.013
"3925",514,"199892.9280.2","MA",1998,9,10,253,20,41.9162,-70.4102,8,3,5,7,1,"MA",0.013
"3926",514,"199892.9270.3","MA",1998,9,10,253,20,42.0308,-70.58,4,3,1,3,1,"MA",0.013
"3927",514,"199892.9250.4","MA",1998,9,10,253,13,42.0368,-70.626,65,39,26,15,50,"MA",0.013
"3928",514,"199892.9310.5","MA",1998,9,10,253,13,42.284,-70.8553,1103,494,609,481,622,"MA",0.013
"3929",514,"199892.9340.6","MA",1998,9,11,254,13,42.3822,-70.8183,34,12,22,24,10,"MA",0.013
"3930",514,"199892.9320.7","MA",1998,9,11,254,13,42.45,-70.9037,38,13,25,26,12,"MA",0.013
"3931",514,"199892.9340.8","MA",1998,9,11,254,20,42.4377,-70.849,2,1,1,2,0,"MA",0.013
"3932",514,"199892.9350.9","MA",1998,9,11,254,20,42.5097,-70.7237,0,0,0,0,0,"MA",0.013
"3933",514,"199892.9350.10","MA",1998,9,12,255,20,42.5947,-70.5737,17,8,9,17,0,"MA",0.013
"3934",514,"199892.9360.11","MA",1998,9,12,255,20,42.6243,-70.5348,5,2,3,5,0,"MA",0.013
"3935",514,"199892.9360.12","MA",1998,9,12,255,20,42.7227,-70.58,0,0,0,0,0,"MA",0.013
"3936",514,"199892.9350.13","MA",1998,9,12,255,20,42.7375,-70.6378,6,3,3,5,1,"MA",0.013
"3937",514,"199892.9330.14","MA",1998,9,12,255,20,42.7012,-70.6852,3,0,3,3,0,"MA",0.013
"3938",514,"199892.9320.15","MA",1998,9,12,255,20,42.7212,-70.7383,0,0,0,0,0,"MA",0.013
"3939",514,"199892.9310.16","MA",1998,9,12,255,13,42.763,-70.7905,32,21,11,28,4,"MA",0.013
"3940",514,"199892.9330.17","MA",1998,9,12,255,20,42.8003,-70.7595,1,1,0,1,0,"MA",0.013
"3941",513,"199892.9340.18","MA",1998,9,12,255,20,42.8375,-70.7502,0,0,0,0,0,"MA",0.013
"3942",514,"199892.9350.19","MA",1998,9,12,255,18,42.7257,-70.6453,1,1,0,1,0,"MA",0.013
"3943",514,"199892.9350.20","MA",1998,9,13,256,13,42.3868,-70.6902,10,4,6,10,0,"MA",0.013
"3944",514,"199892.9280.21","MA",1998,9,13,256,20,42.0882,-70.548,0,0,0,0,0,"MA",0.013
"3945",514,"199892.9290.22","MA",1998,9,13,256,20,42.0222,-70.5102,6,3,3,4,2,"MA",0.013
"3946",514,"199892.9300.23","MA",1998,9,13,256,20,42.0702,-70.3805,2,0,2,2,0,"MA",0.013
"3947",514,"199892.9290.24","MA",1998,9,13,256,20,42.0402,-70.361,5,0,5,5,0,"MA",0.013
"3948",514,"199892.9250.25","MA",1998,9,14,257,13,41.7473,-70.3915,42,16,26,40,2,"MA",0.013
"3949",514,"199892.9270.26","MA",1998,9,14,257,20,41.7862,-70.3407,1,0,1,1,0,"MA",0.013
"3950",514,"199892.9270.28","MA",1998,9,14,257,20,41.9195,-70.1667,0,0,0,0,0,"MA",0.013
"3951",514,"199892.9260.29","MA",1998,9,14,257,20,41.9182,-70.1382,1,1,0,1,0,"MA",0.013
"3952",514,"199892.9270.30","MA",1998,9,14,257,15,41.9357,-70.155,0,0,0,0,0,"MA",0.013
"3953",514,"199892.9260.31","MA",1998,9,15,258,13,41.8065,-70.4788,4,0,4,2,2,"MA",0.013
"3954",514,"199892.9280.32","MA",1998,9,15,258,20,41.9087,-70.245,0,0,0,0,0,"MA",0.013
"3955",514,"199892.9290.33","MA",1998,9,15,258,20,41.9663,-70.2573,0,0,0,0,0,"MA",0.013
"3956",514,"199892.9290.34","MA",1998,9,15,258,14,41.9288,-70.3998,2,1,1,2,0,"MA",0.013
"3957",514,"199892.9260.35","MA",1998,9,15,258,17,41.8518,-70.489,0,0,0,0,0,"MA",0.013
"3958",521,"199892.9170.59","MA",1998,9,23,266,13,41.3787,-69.999,0,0,0,0,0,"MA",0.013
"3959",521,"199892.9200.79","MA",1998,9,26,269,13,41.7702,-69.8653,0,0,0,0,0,"MA",0.013
"3960",521,"199892.9170.80","MA",1998,9,26,269,20,41.8365,-69.9343,1,1,0,1,0,"MA",0.013
"3961",521,"199892.9200.81","MA",1998,9,26,269,20,41.8283,-69.8862,0,0,0,0,0,"MA",0.013
"3962",521,"199892.9180.82","MA",1998,9,26,269,20,41.9125,-69.9585,1,1,0,1,0,"MA",0.013
"3963",521,"199892.9190.83","MA",1998,9,26,269,13,41.968,-69.9753,0,0,0,0,0,"MA",0.013
"3964",514,"199892.9180.84","MA",1998,9,26,269,13,41.999,-70.0058,0,0,0,0,0,"MA",0.013
"3965",514,"199892.9210.85","MA",1998,9,27,270,20,42.0768,-70.0175,0,0,0,0,0,"MA",0.013
"3966",514,"199892.9210.86","MA",1998,9,27,270,20,42.0953,-70.2278,3,1,2,3,0,"MA",0.013
"3967",514,"199892.9300.87","MA",1998,9,27,270,20,42.0577,-70.2765,0,0,0,0,0,"MA",0.013
"3968",514,"199992.9260.1","MA",1999,9,8,251,20,41.8277,-70.497,27,12,15,22,5,"MA",0.013
"3969",514,"199992.9250.2","MA",1999,9,8,251,20,41.7423,-70.3695,167,77,90,132,35,"MA",0.013
"3970",514,"199992.9260.3","MA",1999,9,8,251,20,41.7682,-70.3282,6,5,1,4,2,"MA",0.013
"3971",514,"199992.9260.4","MA",1999,9,8,251,20,41.799,-70.2543,0,0,0,0,0,"MA",0.013
"3972",514,"199992.9250.5","MA",1999,9,8,251,20,41.8395,-70.1635,3,1,2,3,0,"MA",0.013
"3973",514,"199992.9250.6","MA",1999,9,9,252,20,41.852,-70.5157,29,14,15,23,6,"MA",0.013
"3974",514,"199992.9280.7","MA",1999,9,9,252,20,41.9128,-70.4568,0,0,0,0,0,"MA",0.013
"3975",514,"199992.9280.8","MA",1999,9,9,252,20,41.9523,-70.4808,3,2,1,2,1,"MA",0.013
"3976",514,"199992.9290.9","MA",1999,9,9,252,20,41.9745,-70.4582,3,1,2,3,0,"MA",0.013
"3977",514,"199992.9270.10","MA",1999,9,9,252,20,41.976,-70.554,1,1,0,1,0,"MA",0.013
"3978",514,"199992.9270.11","MA",1999,9,9,252,13,42.1213,-70.5618,8,0,8,8,0,"MA",0.013
"3979",514,"199992.9320.12","MA",1999,9,9,252,13,42.284,-70.8003,79,31,48,44,35,"MA",0.013
"3980",514,"199992.9310.13","MA",1999,9,9,252,13,42.2925,-70.8645,626,292,334,332,294,"MA",0.013
"3981",514,"199992.9330.14","MA",1999,9,10,253,20,42.3918,-70.8232,26,8,18,20,6,"MA",0.013
"3982",514,"199992.9320.15","MA",1999,9,10,253,16,42.4097,-70.9468,164,68,96,110,54,"MA",0.013
"3983",514,"199992.9340.16","MA",1999,9,10,253,20,42.439,-70.8675,7,2,5,7,0,"MA",0.013
"3984",514,"199992.9350.17","MA",1999,9,10,253,13,42.5147,-70.7163,16,4,12,14,2,"MA",0.013
"3985",514,"199992.9340.18","MA",1999,9,10,253,13,42.5465,-70.7303,8,4,4,6,2,"MA",0.013
"3986",514,"199992.9350.19","MA",1999,9,10,253,13,42.5707,-70.6087,16,8,8,10,6,"MA",0.013
"3987",514,"199992.9350.20","MA",1999,9,11,254,20,42.5932,-70.575,12,2,10,9,3,"MA",0.013
"3988",514,"199992.9360.21","MA",1999,9,11,254,20,42.7113,-70.558,2,1,1,2,0,"MA",0.013
"3989",514,"199992.9350.22","MA",1999,9,11,254,20,42.7097,-70.6057,4,2,2,4,0,"MA",0.013
"3990",514,"199992.9350.23","MA",1999,9,11,254,20,42.7255,-70.6368,1,1,0,1,0,"MA",0.013
"3991",514,"199992.9310.24","MA",1999,9,11,254,20,42.6972,-70.7313,56,25,31,53,3,"MA",0.013
"3992",514,"199992.9330.25","MA",1999,9,11,254,20,42.7782,-70.7555,2,2,0,1,1,"MA",0.013
"3993",513,"199992.9310.26","MA",1999,9,11,254,13,42.8463,-70.8113,165,76,89,116,49,"MA",0.013
"3994",513,"199992.9340.27","MA",1999,9,11,254,18,42.8605,-70.751,7,3,4,5,2,"MA",0.013
"3995",514,"199992.9320.28","MA",1999,9,11,254,16,42.7737,-70.7792,12,9,3,12,0,"MA",0.013
"3996",514,"199992.9330.29","MA",1999,9,11,254,20,42.7007,-70.7002,8,4,4,7,1,"MA",0.013
"3997",514,"199992.9360.30","MA",1999,9,12,255,20,42.5057,-70.635,21,8,13,20,1,"MA",0.013
"3998",514,"199992.9350.31","MA",1999,9,12,255,13,42.3713,-70.6962,5,5,0,5,0,"MA",0.013
"3999",514,"199992.9350.32","MA",1999,9,12,255,17,42.3182,-70.6997,11,5,6,10,1,"MA",0.013
"4000",514,"199992.9290.33","MA",1999,9,12,255,20,42.0303,-70.4593,6,5,1,6,0,"MA",0.013
"4001",514,"199992.9290.34","MA",1999,9,12,255,20,41.9845,-70.4598,7,1,6,7,0,"MA",0.013
"4002",514,"199992.9280.35","MA",1999,9,12,255,15,41.895,-70.4107,1,1,0,0,1,"MA",0.013
"4003",514,"199992.9270.36","MA",1999,9,13,256,20,41.8475,-70.2298,1,0,1,1,0,"MA",0.013
"4004",514,"199992.9280.37","MA",1999,9,13,256,20,41.9333,-70.2433,0,0,0,0,0,"MA",0.013
"4005",514,"199992.9290.38","MA",1999,9,13,256,20,42.0265,-70.2568,3,0,3,3,0,"MA",0.013
"4006",514,"199992.9300.39","MA",1999,9,13,256,20,42.0967,-70.365,5,2,3,5,0,"MA",0.013
"4007",514,"199992.9290.40","MA",1999,9,13,256,20,42.0272,-70.3115,3,0,3,3,0,"MA",0.013
"4008",514,"199992.9270.41","MA",1999,9,14,257,18.5,41.7957,-70.4158,6,3,3,5,1,"MA",0.013
"4009",514,"199992.9270.42","MA",1999,9,14,257,20,41.8685,-70.2217,3,0,3,3,0,"MA",0.013
"4010",514,"199992.9280.44","MA",1999,9,14,257,20,41.9003,-70.2128,1,1,0,1,0,"MA",0.013
"4011",514,"199992.9300.45","MA",1999,9,14,257,20,42.0612,-70.2643,0,0,0,0,0,"MA",0.013
"4012",514,"199992.9210.46","MA",1999,9,15,258,13,42.1237,-70.2157,2,1,1,2,0,"MA",0.013
"4013",514,"199992.9170.48","MA",1999,9,15,258,13,42.0855,-70.1455,0,0,0,0,0,"MA",0.013
"4014",514,"199992.9210.49","MA",1999,9,15,258,20,42.0875,-70.0357,0,0,0,0,0,"MA",0.013
"4015",514,"199992.9200.50","MA",1999,9,15,258,20,42.0688,-70.0283,0,0,0,0,0,"MA",0.013
"4016",514,"199992.9170.51","MA",1999,9,15,258,13,42.0573,-70.0732,1,1,0,1,0,"MA",0.013
"4017",521,"199992.9190.52","MA",1999,9,15,258,20,41.8113,-69.9015,0,0,0,0,0,"MA",0.013
"4018",521,"199992.9180.53","MA",1999,9,15,258,20,41.7833,-69.9145,1,0,1,1,0,"MA",0.013
"4019",521,"199992.9180.69","MA",1999,9,20,263,20,41.4375,-69.9757,0,0,0,0,0,"MA",0.013
"4020",521,"199992.9170.70","MA",1999,9,20,263,13,41.389,-69.9953,0,0,0,0,0,"MA",0.013
"4021",514,"200092.9250.1","MA",2000,9,6,250,14,41.8175,-70.525,58,25,33,46,12,"MA",0.013
"4022",514,"200092.9270.2","MA",2000,9,6,250,20,41.8452,-70.4125,13,7,6,12,1,"MA",0.013
"4023",514,"200092.9270.3","MA",2000,9,6,250,20,41.8035,-70.386,22,10,12,17,5,"MA",0.013
"4024",514,"200092.9260.4","MA",2000,9,6,250,20,41.748,-70.3285,1,1,0,1,0,"MA",0.013
"4025",514,"200092.9260.5","MA",2000,9,6,250,20,41.7998,-70.4817,76,37,39,66,10,"MA",0.013
"4026",514,"200092.9280.6","MA",2000,9,7,251,20,41.9685,-70.5105,5,2,3,2,3,"MA",0.013
"4027",514,"200092.9250.7","MA",2000,9,7,251,20,41.9802,-70.6068,43,20,23,22,21,"MA",0.013
"4028",514,"200092.9270.8","MA",2000,9,7,251,16,42.1135,-70.5665,7,1,6,4,3,"MA",0.013
"4029",514,"200092.9320.9","MA",2000,9,7,251,13,42.3,-70.8493,645,338,307,346,299,"MA",0.013
"4030",514,"200092.9310.10","MA",2000,9,8,252,20,42.4498,-70.9185,80,32,48,32,48,"MA",0.013
"4031",514,"200092.9320.11","MA",2000,9,8,252,20,42.4512,-70.9107,384,181,203,111,273,"MA",0.013
"4032",514,"200092.9350.12","MA",2000,9,8,252,20,42.4848,-70.7627,14,8,6,10,4,"MA",0.013
"4033",514,"200092.9350.13","MA",2000,9,8,252,20,42.5037,-70.7213,5,2,3,5,0,"MA",0.013
"4034",514,"200092.9340.14","MA",2000,9,8,252,20,42.5467,-70.7342,14,8,6,11,3,"MA",0.013
"4035",514,"200092.9350.15","MA",2000,9,8,252,20,42.567,-70.598,6,4,2,5,1,"MA",0.013
"4036",514,"200092.9350.16","MA",2000,9,8,252,16,42.5813,-70.595,33,23,10,25,8,"MA",0.013
"4037",514,"200092.9360.17","MA",2000,9,9,253,13,42.6312,-70.5262,15,1,14,15,0,"MA",0.013
"4038",514,"200092.9350.18","MA",2000,9,9,253,13,42.685,-70.5588,37,11,26,26,11,"MA",0.013
"4039",514,"200092.9320.19","MA",2000,9,9,253,20,42.6977,-70.7102,19,8,11,14,5,"MA",0.013
"4040",514,"200092.9310.20","MA",2000,9,9,253,20,42.6798,-70.7072,87,41,46,60,27,"MA",0.013
"4041",514,"200092.9340.21","MA",2000,9,9,253,20,42.718,-70.6787,23,16,7,17,6,"MA",0.013
"4042",514,"200092.9310.22","MA",2000,9,9,253,15,42.7018,-70.7397,38,16,22,35,3,"MA",0.013
"4043",514,"200092.9330.23","MA",2000,9,9,253,20,42.7852,-70.764,7,2,5,6,1,"MA",0.013
"4044",513,"200092.9330.24","MA",2000,9,9,253,15,42.8502,-70.7775,2,1,1,2,0,"MA",0.013
"4045",514,"200092.9350.25","MA",2000,9,9,253,15,42.732,-70.649,9,3,6,8,1,"MA",0.013
"4046",514,"200092.9360.26","MA",2000,9,10,254,20,42.5072,-70.6365,14,4,10,12,2,"MA",0.013
"4047",514,"200092.9350.27","MA",2000,9,10,254,20,42.3758,-70.6978,1,1,0,1,0,"MA",0.013
"4048",514,"200092.9290.28","MA",2000,9,10,254,20,42.12,-70.4722,5,3,2,5,0,"MA",0.013
"4049",514,"200092.9290.29","MA",2000,9,10,254,15,42.0665,-70.4655,3,2,1,3,0,"MA",0.013
"4050",514,"200092.9290.30","MA",2000,9,10,254,20,42.0258,-70.3365,9,3,6,9,0,"MA",0.013
"4051",514,"200092.9290.31","MA",2000,9,10,254,17,41.9327,-70.3803,3,2,1,3,0,"MA",0.013
"4052",514,"200092.9260.32","MA",2000,9,11,255,20,41.7902,-70.2702,45,20,25,43,2,"MA",0.013
"4053",514,"200092.9260.33","MA",2000,9,11,255,20,41.831,-70.1232,3,1,2,2,1,"MA",0.013
"4054",514,"200092.9260.34","MA",2000,9,11,255,20,41.9003,-70.1322,1,1,0,1,0,"MA",0.013
"4055",514,"200092.9250.35","MA",2000,9,11,255,20,41.9485,-70.0952,15,5,10,13,2,"MA",0.013
"4056",514,"200092.9270.36","MA",2000,9,11,255,20,41.879,-70.1948,2,0,2,2,0,"MA",0.013
"4057",514,"200092.9280.37","MA",2000,9,12,256,20,41.8945,-70.4142,20,12,8,19,1,"MA",0.013
"4058",514,"200092.9280.38","MA",2000,9,12,256,20,41.8955,-70.3508,0,0,0,0,0,"MA",0.013
"4059",514,"200092.9280.39","MA",2000,9,12,256,20,41.9207,-70.273,3,2,1,3,0,"MA",0.013
"4060",514,"200092.9280.40","MA",2000,9,12,256,20,41.949,-70.2175,5,2,3,5,0,"MA",0.013
"4061",514,"200092.9270.41","MA",2000,9,12,256,20,41.9803,-70.1378,26,10,16,24,2,"MA",0.013
"4062",514,"200092.9290.42","MA",2000,9,13,257,20,41.9937,-70.2187,7,4,3,7,0,"MA",0.013
"4063",514,"200092.9300.43","MA",2000,9,13,257,20,42.057,-70.2647,2,1,1,2,0,"MA",0.013
"4064",514,"200092.9300.44","MA",2000,9,13,257,16,42.1098,-70.3028,1,1,0,1,0,"MA",0.013
"4065",514,"200092.9210.45","MA",2000,9,13,257,20,42.1287,-70.1655,2,2,0,2,0,"MA",0.013
"4066",514,"200092.9210.46","MA",2000,9,13,257,20,42.079,-70.0238,0,0,0,0,0,"MA",0.013
"4067",514,"200092.9200.47","MA",2000,9,13,257,15,42.062,-70.0232,0,0,0,0,0,"MA",0.013
"4068",521,"200092.9180.49","MA",2000,9,14,258,13,41.915,-69.96,24,12,12,18,6,"MA",0.013
"4069",521,"200092.9170.50","MA",2000,9,14,258,19,41.9097,-69.9628,0,0,0,0,0,"MA",0.013
"4070",521,"200092.9170.51","MA",2000,9,14,258,13,41.8793,-69.9503,9,8,1,7,2,"MA",0.013
"4071",521,"200092.9200.52","MA",2000,9,14,258,20,41.8175,-69.888,3,0,3,2,1,"MA",0.013
"4072",514,"200192.9270.1","MA",2001,9,5,248,20,41.7852,-70.343,1,0,1,1,0,"MA",0.013
"4073",514,"200192.9250.2","MA",2001,9,5,248,20,41.742,-70.3333,2,1,1,2,0,"MA",0.013
"4074",514,"200192.9260.3","MA",2001,9,5,248,20,41.8362,-70.1922,0,0,0,0,0,"MA",0.013
"4075",514,"200192.9270.4","MA",2001,9,5,248,14,41.8353,-70.2642,1,0,1,1,0,"MA",0.013
"4076",514,"200192.9260.5","MA",2001,9,5,248,13,41.7677,-70.3523,0,0,0,0,0,"MA",0.013
"4077",514,"200192.9250.6","MA",2001,9,6,249,19,41.8297,-70.5118,1,0,1,1,0,"MA",0.013
"4078",514,"200192.9260.7","MA",2001,9,6,249,16,41.8502,-70.489,0,0,0,0,0,"MA",0.013
"4079",514,"200192.9270.8","MA",2001,9,6,249,13,42.048,-70.5725,0,0,0,0,0,"MA",0.013
"4080",514,"200192.9260.9","MA",2001,9,6,249,20,42.1403,-70.6713,53,26,27,40,13,"MA",0.013
"4081",514,"200192.9330.10","MA",2001,9,6,249,20,42.308,-70.8133,3,3,0,3,0,"MA",0.013
"4082",514,"200192.9320.11","MA",2001,9,6,249,20,42.3037,-70.8342,2,2,0,1,1,"MA",0.013
"4083",514,"200192.9310.12","MA",2001,9,7,250,20,42.4153,-70.9588,2,0,2,1,1,"MA",0.013
"4084",514,"200192.9320.13","MA",2001,9,7,250,13,42.4492,-70.9018,2,1,1,2,0,"MA",0.013
"4085",514,"200192.9340.14","MA",2001,9,7,250,20,42.4477,-70.8347,0,0,0,0,0,"MA",0.013
"4086",514,"200192.9340.15","MA",2001,9,7,250,20,42.4912,-70.7692,1,1,0,1,0,"MA",0.013
"4087",514,"200192.9350.16","MA",2001,9,7,250,20,42.5125,-70.7128,0,0,0,0,0,"MA",0.013
"4088",514,"200192.9350.17","MA",2001,9,7,250,15,42.565,-70.6182,0,0,0,0,0,"MA",0.013
"4089",514,"200192.9350.18","MA",2001,9,7,250,20,42.5893,-70.5808,5,1,4,5,0,"MA",0.013
"4090",514,"200192.9360.19","MA",2001,9,8,251,20,42.6308,-70.5222,15,7,8,15,0,"MA",0.013
"4091",514,"200192.9350.20","MA",2001,9,8,251,20,42.695,-70.5708,12,4,8,8,4,"MA",0.013
"4092",514,"200192.9350.21","MA",2001,9,8,251,20,42.715,-70.614,7,5,2,7,0,"MA",0.013
"4093",514,"200192.9340.22","MA",2001,9,8,251,20,42.7282,-70.6732,2,1,1,2,0,"MA",0.013
"4094",514,"200192.9330.23","MA",2001,9,8,251,20,42.704,-70.7038,4,2,2,4,0,"MA",0.013
"4095",514,"200192.9320.24","MA",2001,9,8,251,20,42.7128,-70.7303,5,4,1,4,1,"MA",0.013
"4096",514,"200192.9310.25","MA",2001,9,8,251,20,42.68,-70.7097,14,3,11,13,1,"MA",0.013
"4097",514,"200192.9310.26","MA",2001,9,8,251,13.5,42.7568,-70.7917,39,16,23,36,3,"MA",0.013
"4098",514,"200192.9330.27","MA",2001,9,8,251,20,42.7743,-70.755,0,0,0,0,0,"MA",0.013
"4099",514,"200192.9360.28","MA",2001,9,9,252,20,42.4727,-70.6437,1,0,1,1,0,"MA",0.013
"4100",514,"200192.9350.29","MA",2001,9,9,252,13,42.3837,-70.6962,0,0,0,0,0,"MA",0.013
"4101",514,"200192.9350.30","MA",2001,9,9,252,13,42.3238,-70.7115,0,0,0,0,0,"MA",0.013
"4102",514,"200192.9290.31","MA",2001,9,9,252,20,42.1112,-70.4585,0,0,0,0,0,"MA",0.013
"4103",514,"200192.9280.32","MA",2001,9,9,252,20,41.9952,-70.5288,0,0,0,0,0,"MA",0.013
"4104",514,"200192.9290.33","MA",2001,9,10,253,13,41.9883,-70.4117,5,4,1,5,0,"MA",0.013
"4105",514,"200192.9290.34","MA",2001,9,10,253,19,42.0267,-70.4747,3,3,0,3,0,"MA",0.013
"4106",514,"200192.9300.35","MA",2001,9,10,253,20,42.0693,-70.3307,4,0,4,4,0,"MA",0.013
"4107",514,"200192.9290.36","MA",2001,9,10,253,20,42.0368,-70.324,1,0,1,1,0,"MA",0.013
"4108",514,"200192.9290.37","MA",2001,9,10,253,20,41.9922,-70.2975,1,1,0,1,0,"MA",0.013
"4109",514,"200192.9280.38","MA",2001,9,10,253,20,41.884,-70.433,0,0,0,0,0,"MA",0.013
"4110",514,"200192.9270.39","MA",2001,9,11,254,13,41.868,-70.2122,1,1,0,0,1,"MA",0.013
"4111",514,"200192.9270.40","MA",2001,9,11,254,20,41.8958,-70.169,1,1,0,1,0,"MA",0.013
"4112",514,"200192.9260.41","MA",2001,9,11,254,20,41.942,-70.1195,2,0,2,1,1,"MA",0.013
"4113",514,"200192.9250.42","MA",2001,9,11,254,15,41.967,-70.0933,6,4,2,5,1,"MA",0.013
"4114",514,"200192.9280.43","MA",2001,9,11,254,14,42.0113,-70.1677,1,0,1,1,0,"MA",0.013
"4115",514,"200192.9280.44","MA",2001,9,11,254,13,41.9653,-70.2102,7,1,6,7,0,"MA",0.013
"4116",514,"200192.9280.45","MA",2001,9,11,254,20,41.8882,-70.3488,1,1,0,1,0,"MA",0.013
"4117",514,"200192.9300.46","MA",2001,9,12,255,20,42.0698,-70.283,1,0,1,1,0,"MA",0.013
"4118",514,"200192.9210.47","MA",2001,9,12,255,20,42.0978,-70.2135,1,0,1,1,0,"MA",0.013
"4119",514,"200192.9190.48","MA",2001,9,12,255,13,42.0965,-70.1735,0,0,0,0,0,"MA",0.013
"4120",514,"200192.9210.49","MA",2001,9,12,255,20,42.096,-70.2062,2,1,1,2,0,"MA",0.013
"4121",514,"200192.9200.50","MA",2001,9,12,255,13,42.0668,-70.027,1,1,0,1,0,"MA",0.013
"4122",521,"200192.9180.54","MA",2001,9,13,256,13,41.8207,-69.9218,5,5,0,5,0,"MA",0.013
"4123",521,"200192.9170.77","MA",2001,9,17,260,20,41.4068,-69.9655,0,0,0,0,0,"MA",0.013
"4124",521,"200192.9180.78","MA",2001,9,17,260,20,41.3628,-69.9522,0,0,0,0,0,"MA",0.013
"4125",514,"200292.9250.1","MA",2002,9,4,247,17,41.7528,-70.426,27,12,15,18,9,"MA",0.013
"4126",514,"200292.9260.2","MA",2002,9,4,247,20,41.766,-70.3435,5,2,3,3,2,"MA",0.013
"4127",514,"200292.9270.3","MA",2002,9,4,247,20,41.8373,-70.3282,0,0,0,0,0,"MA",0.013
"4128",514,"200292.9270.4","MA",2002,9,4,247,20,41.8348,-70.3728,0,0,0,0,0,"MA",0.013
"4129",514,"200292.9270.5","MA",2002,9,4,247,20,41.8108,-70.3813,0,0,0,0,0,"MA",0.013
"4130",514,"200292.9280.6","MA",2002,9,4,247,20,41.885,-70.38,0,0,0,0,0,"MA",0.013
"4131",514,"200292.9250.7","MA",2002,9,5,248,20,41.9765,-70.6038,34,19,15,18,16,"MA",0.013
"4132",514,"200292.9260.8","MA",2002,9,5,248,19,41.979,-70.5858,76,40,36,50,26,"MA",0.013
"4133",514,"200292.9320.10","MA",2002,9,5,248,13,42.2342,-70.7422,331,168,163,107,224,"MA",0.013
"4134",514,"200292.9330.11","MA",2002,9,5,248,13,42.3123,-70.8032,253,154,99,140,113,"MA",0.013
"4135",514,"200292.9310.12","MA",2002,9,5,248,13,42.2842,-70.8537,321,166,155,89,232,"MA",0.013
"4136",514,"200292.9320.13","MA",2002,9,6,249,15,42.442,-70.9152,280,153,127,94,186,"MA",0.013
"4137",514,"200292.9340.14","MA",2002,9,6,249,20,42.4392,-70.8505,19,8,11,14,5,"MA",0.013
"4138",514,"200292.9340.15","MA",2002,9,6,249,20,42.4793,-70.7632,7,1,6,7,0,"MA",0.013
"4139",514,"200292.9350.16","MA",2002,9,6,249,13,42.4628,-70.7173,1,0,1,1,0,"MA",0.013
"4140",514,"200292.9350.17","MA",2002,9,6,249,20,42.5297,-70.6685,2,0,2,2,0,"MA",0.013
"4141",514,"200292.9350.18","MA",2002,9,6,249,13,42.562,-70.6018,1,0,1,1,0,"MA",0.013
"4142",514,"200292.9350.19","MA",2002,9,6,249,20,42.5993,-70.5733,5,0,5,4,1,"MA",0.013
"4143",514,"200292.9350.20","MA",2002,9,7,250,20,42.5872,-70.5778,9,3,6,7,2,"MA",0.013
"4144",514,"200292.9360.21","MA",2002,9,7,250,20,42.6672,-70.52,6,2,4,6,0,"MA",0.013
"4145",514,"200292.9310.23","MA",2002,9,7,250,20,42.6882,-70.729,3,2,1,2,1,"MA",0.013
"4146",514,"200292.9330.24","MA",2002,9,7,250,20,42.7813,-70.7595,0,0,0,0,0,"MA",0.013
"4147",514,"200292.9330.25","MA",2002,9,7,250,15.5,42.7937,-70.7645,1,0,1,0,1,"MA",0.013
"4148",514,"200292.9320.26","MA",2002,9,7,250,17,42.7622,-70.7887,49,21,28,29,20,"MA",0.013
"4149",513,"200292.9340.27","MA",2002,9,7,250,20,42.8343,-70.7482,1,0,1,1,0,"MA",0.013
"4150",513,"200292.9310.28","MA",2002,9,7,250,13,42.8395,-70.8102,195,87,108,77,118,"MA",0.013
"4151",514,"200292.9360.29","MA",2002,9,8,251,13,42.4177,-70.6455,8,4,4,2,6,"MA",0.013
"4152",514,"200292.9290.30","MA",2002,9,8,251,13,41.9702,-70.4203,0,0,0,0,0,"MA",0.013
"4153",514,"200292.9280.31","MA",2002,9,8,251,20,41.8783,-70.289,4,3,1,4,0,"MA",0.013
"4154",514,"200292.9260.32","MA",2002,9,9,252,13,41.755,-70.2918,9,1,8,7,2,"MA",0.013
"4155",514,"200292.9250.33","MA",2002,9,9,252,20,41.8185,-70.0877,0,0,0,0,0,"MA",0.013
"4156",514,"200292.9260.34","MA",2002,9,9,252,20,41.8668,-70.1477,0,0,0,0,0,"MA",0.013
"4157",514,"200292.9270.35","MA",2002,9,9,252,20,41.8588,-70.234,0,0,0,0,0,"MA",0.013
"4158",514,"200292.9290.37","MA",2002,9,9,252,13,41.9275,-70.3815,23,14,9,23,0,"MA",0.013
"4159",514,"200292.9260.38","MA",2002,9,10,253,18,41.9223,-70.1135,0,0,0,0,0,"MA",0.013
"4160",514,"200292.9270.39","MA",2002,9,10,253,16,41.9788,-70.1378,1,1,0,1,0,"MA",0.013
"4161",514,"200292.9290.41","MA",2002,9,10,253,19,41.9817,-70.2673,1,1,0,1,0,"MA",0.013
"4162",514,"200292.9290.42","MA",2002,9,10,253,15,41.9635,-70.3833,3,2,1,2,1,"MA",0.013
"4163",514,"200292.9300.43","MA",2002,9,10,253,20,42.0848,-70.3538,6,3,3,6,0,"MA",0.013
"4164",514,"200292.9290.44","MA",2002,9,10,253,15,42.034,-70.3123,3,0,3,3,0,"MA",0.013
"4165",514,"200292.9300.45","MA",2002,9,11,254,20,42.1113,-70.3032,0,0,0,0,0,"MA",0.013
"4166",514,"200292.9210.46","MA",2002,9,11,254,20,42.1117,-70.2193,1,0,1,1,0,"MA",0.013
"4167",514,"200292.9170.47","MA",2002,9,11,254,20,42.0672,-70.0933,0,0,0,0,0,"MA",0.013
"4168",521,"200292.9200.84","MA",2002,9,18,261,20,41.7665,-69.8638,1,0,1,1,0,"MA",0.013
"4169",521,"200292.9210.85","MA",2002,9,18,261,20,41.8097,-69.8708,0,0,0,0,0,"MA",0.013
"4170",521,"200292.9180.86","MA",2002,9,18,261,13,41.8068,-69.9175,0,0,0,0,0,"MA",0.013
"4171",521,"200292.9170.88","MA",2002,9,19,262,20,41.3788,-69.9918,0,0,0,0,0,"MA",0.013
"4172",521,"200292.9170.89","MA",2002,9,19,262,20,41.3593,-69.9778,0,0,0,0,0,"MA",0.013
"4173",514,"200392.9270.1","MA",2003,9,3,246,20,41.8553,-70.4097,1,0,1,1,0,"MA",0.013
"4174",514,"200392.9270.2","MA",2003,9,3,246,20,41.8243,-70.3798,0,0,0,0,0,"MA",0.013
"4175",514,"200392.9250.3","MA",2003,9,3,246,20,41.7463,-70.2878,0,0,0,0,0,"MA",0.013
"4176",514,"200392.9260.4","MA",2003,9,3,246,20,41.7562,-70.3958,2,0,2,2,0,"MA",0.013
"4177",514,"200392.9260.5","MA",2003,9,3,246,20,41.764,-70.4033,0,0,0,0,0,"MA",0.013
"4178",514,"200392.9260.6","MA",2003,9,4,247,20,41.8548,-70.4922,0,0,0,0,0,"MA",0.013
"4179",514,"200392.9250.7","MA",2003,9,4,247,20,41.9538,-70.6167,0,0,0,0,0,"MA",0.013
"4180",514,"200392.9340.8","MA",2003,9,4,247,20,42.3137,-70.723,0,0,0,0,0,"MA",0.013
"4181",514,"200392.9320.9","MA",2003,9,4,247,13,42.3052,-70.815,0,0,0,0,0,"MA",0.013
"4182",514,"200392.9330.10","MA",2003,9,4,247,13,42.3102,-70.8087,0,0,0,0,0,"MA",0.013
"4183",514,"200392.9310.11","MA",2003,9,5,248,20,42.4025,-70.9623,6,3,3,4,2,"MA",0.013
"4184",514,"200392.9320.12","MA",2003,9,5,248,13,42.4083,-70.9347,9,5,4,5,4,"MA",0.013
"4185",514,"200392.9350.13","MA",2003,9,5,248,13,42.4615,-70.7253,0,0,0,0,0,"MA",0.013
"4186",514,"200392.9360.14","MA",2003,9,5,248,20,42.499,-70.6325,1,0,1,1,0,"MA",0.013
"4187",514,"200392.9350.15","MA",2003,9,5,248,16,42.4968,-70.7337,0,0,0,0,0,"MA",0.013
"4188",514,"200392.9350.16","MA",2003,9,5,248,20,42.5303,-70.6718,0,0,0,0,0,"MA",0.013
"4189",514,"200392.9340.17","MA",2003,9,5,248,19,42.5423,-70.7317,3,0,3,3,0,"MA",0.013
"4190",514,"200392.9350.18","MA",2003,9,6,249,20,42.5872,-70.588,5,2,3,3,2,"MA",0.013
"4191",514,"200392.9360.19","MA",2003,9,6,249,20,42.6302,-70.5213,3,0,3,3,0,"MA",0.013
"4192",514,"200392.9350.20","MA",2003,9,6,249,20,42.6975,-70.5748,8,4,4,8,0,"MA",0.013
"4193",514,"200392.9340.21","MA",2003,9,6,249,20,42.7043,-70.6343,2,2,0,2,0,"MA",0.013
"4194",514,"200392.9310.22","MA",2003,9,6,249,13,42.6753,-70.6892,9,5,4,9,0,"MA",0.013
"4195",514,"200392.9330.23","MA",2003,9,6,249,20,42.7025,-70.7018,2,2,0,2,0,"MA",0.013
"4196",514,"200392.9320.24","MA",2003,9,6,249,20,42.7495,-70.7702,3,0,3,3,0,"MA",0.013
"4197",514,"200392.9310.25","MA",2003,9,6,249,20,42.7598,-70.7915,13,8,5,12,1,"MA",0.013
"4198",514,"200392.9350.26","MA",2003,9,7,250,20,42.3653,-70.6997,2,1,1,2,0,"MA",0.013
"4199",514,"200392.9290.27","MA",2003,9,7,250,20,42.0557,-70.505,1,0,1,1,0,"MA",0.013
"4200",514,"200392.9270.28","MA",2003,9,7,250,20,42.0378,-70.5772,0,0,0,0,0,"MA",0.013
"4201",514,"200392.9290.29","MA",2003,9,7,250,20,41.9903,-70.4113,0,0,0,0,0,"MA",0.013
"4202",514,"200392.9280.30","MA",2003,9,7,250,20,41.9133,-70.4118,0,0,0,0,0,"MA",0.013
"4203",514,"200392.9280.31","MA",2003,9,7,250,15,41.88,-70.3985,0,0,0,0,0,"MA",0.013
"4204",514,"200392.9280.32","MA",2003,9,8,251,20,41.868,-70.2997,0,0,0,0,0,"MA",0.013
"4205",514,"200392.9280.33","MA",2003,9,8,251,20,41.919,-70.235,1,1,0,1,0,"MA",0.013
"4206",514,"200392.9280.34","MA",2003,9,8,251,20,41.9107,-70.1987,0,0,0,0,0,"MA",0.013
"4207",514,"200392.9270.35","MA",2003,9,8,251,20,41.9562,-70.1452,1,1,0,1,0,"MA",0.013
"4208",514,"200392.9260.36","MA",2003,9,8,251,13,41.8337,-70.1718,0,0,0,0,0,"MA",0.013
"4209",514,"200392.9250.37","MA",2003,9,8,251,20,41.8073,-70.0705,1,1,0,1,0,"MA",0.013
"4210",514,"200392.9290.38","MA",2003,9,10,253,16,42.0155,-70.3087,1,0,1,1,0,"MA",0.013
"4211",514,"200392.9300.39","MA",2003,9,10,253,20,42.0965,-70.389,1,0,1,1,0,"MA",0.013
"4212",514,"200392.9300.40","MA",2003,9,10,253,20,42.0562,-70.2932,3,0,3,3,0,"MA",0.013
"4213",514,"200392.9210.41","MA",2003,9,10,253,13,42.0913,-70.2225,0,0,0,0,0,"MA",0.013
"4214",514,"200392.9170.42","MA",2003,9,10,253,20,42.083,-70.1302,2,2,0,2,0,"MA",0.013
"4215",514,"200392.9200.43","MA",2003,9,10,253,13,42.0998,-70.137,2,1,1,2,0,"MA",0.013
"4216",514,"200392.9210.44","MA",2003,9,11,254,13,42.1278,-70.1617,0,0,0,0,0,"MA",0.013
"4217",521,"200392.9190.47","MA",2003,9,11,254,13,41.8173,-69.9062,1,1,0,1,0,"MA",0.013
"4218",521,"200392.9200.48","MA",2003,9,11,254,13,41.8265,-69.8833,0,0,0,0,0,"MA",0.013
"4219",521,"200392.9180.49","MA",2003,9,11,254,13,41.8172,-69.9207,1,1,0,1,0,"MA",0.013
"4220",521,"200392.9170.71","MA",2003,9,15,258,20,41.3953,-69.9853,0,0,0,0,0,"MA",0.013
"4221",521,"200392.9180.72","MA",2003,9,15,258,20,41.3758,-69.9595,0,0,0,0,0,"MA",0.013
"4222",514,"200492.9270.1","MA",2004,9,7,251,18.2,41.9045,-70.4867,0,0,0,0,0,"MA",0.013
"4223",514,"200492.9280.2","MA",2004,9,7,251,20,41.9397,-70.482,0,0,0,0,0,"MA",0.013
"4224",514,"200492.9250.3","MA",2004,9,7,251,15,42.0388,-70.6255,41,11,30,9,32,"MA",0.013
"4225",514,"200492.9250.4","MA",2004,9,7,251,20,41.8402,-70.5188,3,0,3,1,2,"MA",0.013
"4226",514,"200492.9260.5","MA",2004,9,8,252,16,41.8043,-70.476,2,0,2,2,0,"MA",0.013
"4227",514,"200492.9270.6","MA",2004,9,8,252,20,41.78,-70.4195,0,0,0,0,0,"MA",0.013
"4228",514,"200492.9260.8","MA",2004,9,8,252,13,41.7872,-70.3033,0,0,0,0,0,"MA",0.013
"4229",514,"200492.9260.9","MA",2004,9,8,252,13,41.8253,-70.2115,0,0,0,0,0,"MA",0.013
"4230",514,"200492.9280.10","MA",2004,9,8,252,13,41.8975,-70.3598,0,0,0,0,0,"MA",0.013
"4231",514,"200492.9270.11","MA",2004,9,8,252,20,41.8462,-70.4245,1,1,0,1,0,"MA",0.013
"4232",514,"200492.9290.12","MA",2004,9,9,253,20,41.9558,-70.3415,0,0,0,0,0,"MA",0.013
"4233",514,"200492.9290.13","MA",2004,9,9,253,20,41.9602,-70.3068,0,0,0,0,0,"MA",0.013
"4234",514,"200492.9290.14","MA",2004,9,9,253,16,42.1045,-70.5063,1,0,1,1,0,"MA",0.013
"4235",514,"200492.9280.15","MA",2004,9,9,253,20,42.1247,-70.5227,1,0,1,1,0,"MA",0.013
"4236",514,"200492.9340.16","MA",2004,9,9,253,14,42.3088,-70.7132,0,0,0,0,0,"MA",0.013
"4237",514,"200492.9310.17","MA",2004,9,10,254,15,42.4328,-70.9125,38,14,24,5,33,"MA",0.013
"4238",514,"200492.9320.18","MA",2004,9,10,254,14,42.4512,-70.905,14,1,13,11,3,"MA",0.013
"4239",514,"200492.9330.19","MA",2004,9,10,254,20,42.4515,-70.8712,3,2,1,2,1,"MA",0.013
"4240",514,"200492.9350.20","MA",2004,9,10,254,20,42.37,-70.705,0,0,0,0,0,"MA",0.013
"4241",514,"200492.9360.21","MA",2004,9,10,254,13,42.4117,-70.664,1,1,0,1,0,"MA",0.013
"4242",514,"200492.9350.22","MA",2004,9,10,254,20,42.314,-70.7053,4,1,3,4,0,"MA",0.013
"4243",514,"200492.9320.23","MA",2004,9,11,255,13,42.2992,-70.8487,125,63,62,62,63,"MA",0.013
"4244",514,"200492.9350.24","MA",2004,9,11,255,20,42.4637,-70.7242,0,0,0,0,0,"MA",0.013
"4245",514,"200492.9350.25","MA",2004,9,11,255,20,42.5168,-70.7102,1,0,1,1,0,"MA",0.013
"4246",514,"200492.9340.26","MA",2004,9,11,255,20,42.5457,-70.737,2,1,1,2,0,"MA",0.013
"4247",514,"200492.9350.27","MA",2004,9,11,255,20,42.5892,-70.5852,9,5,4,5,4,"MA",0.013
"4248",514,"200492.9360.28","MA",2004,9,12,256,20,42.716,-70.5638,6,2,4,4,2,"MA",0.013
"4249",514,"200492.9330.29","MA",2004,9,12,256,20,42.7795,-70.7508,0,0,0,0,0,"MA",0.013
"4250",513,"200492.9340.30","MA",2004,9,12,256,17,42.8383,-70.7472,0,0,0,0,0,"MA",0.013
"4251",514,"200492.9310.31","MA",2004,9,12,256,20,42.763,-70.7935,2,0,2,2,0,"MA",0.013
"4252",514,"200492.9310.32","MA",2004,9,12,256,17,42.7145,-70.7602,4,1,3,3,1,"MA",0.013
"4253",514,"200492.9320.33","MA",2004,9,12,256,20,42.6968,-70.7125,1,1,0,1,0,"MA",0.013
"4254",514,"200492.9330.34","MA",2004,9,12,256,20,42.6978,-70.6503,7,2,5,6,1,"MA",0.013
"4255",514,"200492.9350.35","MA",2004,9,12,256,20,42.7327,-70.632,3,1,2,3,0,"MA",0.013
"4256",514,"200492.9350.36","MA",2004,9,12,256,18,42.706,-70.5965,7,3,4,7,0,"MA",0.013
"4257",514,"200492.9300.37","MA",2004,9,13,257,20,42.1112,-70.3692,0,0,0,0,0,"MA",0.013
"4258",514,"200492.9300.38","MA",2004,9,13,257,20,42.0723,-70.3573,0,0,0,0,0,"MA",0.013
"4259",514,"200492.9280.39","MA",2004,9,13,257,13,41.928,-70.2173,0,0,0,0,0,"MA",0.013
"4260",514,"200492.9280.40","MA",2004,9,13,257,13,41.9205,-70.2773,0,0,0,0,0,"MA",0.013
"4261",514,"200492.9170.45","MA",2004,9,15,259,20,42.0895,-70.1873,0,0,0,0,0,"MA",0.013
"4262",514,"200492.9210.46","MA",2004,9,15,259,20,42.0797,-70.0228,0,0,0,0,0,"MA",0.013
"4263",514,"200492.9200.47","MA",2004,9,15,259,16,42.0525,-70.0212,2,2,0,2,0,"MA",0.013
"4264",521,"200492.9170.48","MA",2004,9,15,259,20,41.9685,-69.991,1,1,0,1,0,"MA",0.013
"4265",521,"200492.9200.51","MA",2004,9,16,260,18,41.8395,-69.8923,2,0,2,2,0,"MA",0.013
"4266",521,"200492.9210.52","MA",2004,9,16,260,20,41.8052,-69.8673,0,0,0,0,0,"MA",0.013
"4267",521,"200492.9190.54","MA",2004,9,16,260,13,41.7165,-69.875,0,0,0,0,0,"MA",0.013
"4268",521,"200492.9170.70","MA",2004,10,4,278,20,41.3997,-69.986,0,0,0,0,0,"MA",0.013
"4269",514,"200592.9250.1","MA",2005,9,6,249,20,41.8393,-70.5105,2,2,0,2,0,"MA",0.013
"4270",514,"200592.9270.2","MA",2005,9,6,249,15,41.9123,-70.4858,2,0,2,1,1,"MA",0.013
"4271",514,"200592.9280.3","MA",2005,9,6,249,20,41.9552,-70.4793,0,0,0,0,0,"MA",0.013
"4272",514,"200592.9250.4","MA",2005,9,6,249,20,41.9552,-70.6138,10,4,6,4,6,"MA",0.013
"4273",514,"200592.9280.5","MA",2005,9,6,249,20,41.884,-70.4512,0,0,0,0,0,"MA",0.013
"4274",514,"200592.9260.6","MA",2005,9,7,250,20,41.8078,-70.4763,0,0,0,0,0,"MA",0.013
"4275",514,"200592.9270.7","MA",2005,9,7,250,20,41.7757,-70.3905,0,0,0,0,0,"MA",0.013
"4276",514,"200592.9260.8","MA",2005,9,7,250,20,41.7558,-70.3143,1,0,1,1,0,"MA",0.013
"4277",514,"200592.9260.9","MA",2005,9,7,250,13,41.791,-70.2612,0,0,0,0,0,"MA",0.013
"4278",514,"200592.9260.10","MA",2005,9,7,250,13,41.83,-70.1902,1,0,1,1,0,"MA",0.013
"4279",514,"200592.9250.11","MA",2005,9,7,250,13,41.8333,-70.162,2,1,1,2,0,"MA",0.013
"4280",514,"200592.9270.12","MA",2005,9,7,250,13,41.8665,-70.2247,0,0,0,0,0,"MA",0.013
"4281",514,"200592.9290.13","MA",2005,9,8,251,20,42.071,-70.5287,1,0,1,1,0,"MA",0.013
"4282",514,"200592.9290.14","MA",2005,9,8,251,20,42.0698,-70.5003,0,0,0,0,0,"MA",0.013
"4283",514,"200592.9320.15","MA",2005,9,8,251,14.5,42.2902,-70.8615,213,117,96,81,132,"MA",0.013
"4284",514,"200592.9310.16","MA",2005,9,8,251,16,42.2903,-70.8633,276,146,130,120,156,"MA",0.013
"4285",514,"200592.9330.17","MA",2005,9,8,251,13,42.309,-70.8005,5,4,1,4,1,"MA",0.013
"4286",514,"200592.9320.18","MA",2005,9,9,252,20,42.4132,-70.9465,97,42,55,50,47,"MA",0.013
"4287",514,"200592.9330.19","MA",2005,9,9,252,20,42.4513,-70.8712,2,2,0,2,0,"MA",0.013
"4288",514,"200592.9350.20","MA",2005,9,9,252,13,42.4722,-70.7728,2,2,0,2,0,"MA",0.013
"4289",514,"200592.9340.21","MA",2005,9,9,252,20,42.5442,-70.7343,1,0,1,1,0,"MA",0.013
"4290",514,"200592.9350.22","MA",2005,9,9,252,13,42.3752,-70.6967,1,0,1,1,0,"MA",0.013
"4291",514,"200592.9340.23","MA",2005,9,9,252,20,42.318,-70.724,0,0,0,0,0,"MA",0.013
"4292",514,"200592.9360.24","MA",2005,9,10,253,20,42.479,-70.6488,2,0,2,2,0,"MA",0.013
"4293",514,"200592.9350.25","MA",2005,9,10,253,17,42.5478,-70.6133,3,1,2,3,0,"MA",0.013
"4294",514,"200592.9350.26","MA",2005,9,10,253,20,42.5895,-70.5813,3,1,2,3,0,"MA",0.013
"4295",514,"200592.9360.27","MA",2005,9,10,253,20,42.7122,-70.5473,2,2,0,2,0,"MA",0.013
"4296",514,"200592.9350.28","MA",2005,9,10,253,20,42.6895,-70.5637,4,0,4,3,1,"MA",0.013
"4297",514,"200592.9340.29","MA",2005,9,11,254,20,42.7015,-70.6512,4,2,2,4,0,"MA",0.013
"4298",514,"200592.9330.30","MA",2005,9,11,254,20,42.7685,-70.7527,0,0,0,0,0,"MA",0.013
"4299",514,"200592.9310.32","MA",2005,9,11,254,13,42.7115,-70.7485,5,1,4,5,0,"MA",0.013
"4300",514,"200592.9320.33","MA",2005,9,11,254,13,42.7292,-70.7513,3,2,1,3,0,"MA",0.013
"4301",514,"200592.9330.34","MA",2005,9,11,254,13,42.71,-70.7127,1,1,0,1,0,"MA",0.013
"4302",514,"200592.9310.35","MA",2005,9,11,254,13,42.6788,-70.7077,16,6,10,14,2,"MA",0.013
"4303",514,"200592.9300.36","MA",2005,9,12,255,16.5,42.114,-70.43,0,0,0,0,0,"MA",0.013
"4304",514,"200592.9290.37","MA",2005,9,12,255,20,42.0535,-70.4153,0,0,0,0,0,"MA",0.013
"4305",514,"200592.9300.38","MA",2005,9,12,255,20,42.0692,-70.37,1,0,1,1,0,"MA",0.013
"4306",514,"200592.9280.39","MA",2005,9,12,255,20,41.9122,-70.2997,0,0,0,0,0,"MA",0.013
"4307",514,"200592.9280.40","MA",2005,9,12,255,20,41.877,-70.3618,1,1,0,1,0,"MA",0.013
"4308",514,"200592.9210.41","MA",2005,9,13,256,20,42.1002,-70.215,2,1,1,2,0,"MA",0.013
"4309",514,"200592.9210.42","MA",2005,9,13,256,14,42.1287,-70.1658,0,0,0,0,0,"MA",0.013
"4310",514,"200592.9200.43","MA",2005,9,13,256,15,42.0562,-70.0195,3,1,2,3,0,"MA",0.013
"4311",521,"200592.9170.45","MA",2005,9,13,256,13,41.9775,-69.9923,3,3,0,3,0,"MA",0.013
"4312",514,"200592.9270.46","MA",2005,9,14,257,13,42.006,-70.157,1,1,0,1,0,"MA",0.013
"4313",514,"200592.9290.47","MA",2005,9,14,257,20,42.0122,-70.2168,0,0,0,0,0,"MA",0.013
"4314",514,"200592.9290.48","MA",2005,9,14,257,20,42.0287,-70.2607,1,0,1,1,0,"MA",0.013
"4315",514,"200592.9280.49","MA",2005,9,14,257,20,41.9513,-70.2118,1,1,0,1,0,"MA",0.013
"4316",514,"200592.9260.50","MA",2005,9,14,257,13,41.9198,-70.136,0,0,0,0,0,"MA",0.013
"4317",514,"200592.9250.51","MA",2005,9,14,257,20,41.9338,-70.0973,6,6,0,6,0,"MA",0.013
"4318",514,"200592.9270.52","MA",2005,9,14,257,13,41.7855,-70.426,0,0,0,0,0,"MA",0.013
"4319",521,"200592.9170.75","MA",2005,9,19,262,20,41.3915,-69.9953,0,0,0,0,0,"MA",0.013
"4320",521,"200592.9200.89","MA",2005,9,21,264,13,41.7917,-69.8782,0,0,0,0,0,"MA",0.013
"4321",521,"200592.9170.90","MA",2005,9,21,264,13,41.8252,-69.9298,0,0,0,0,0,"MA",0.013
"4322",514,"200692.9270.1","MA",2006,9,5,248,20,41.7805,-70.4153,1,0,1,1,0,"MA",0.013
"4323",514,"200692.9260.2","MA",2006,9,5,248,20,41.7695,-70.3512,1,0,1,1,0,"MA",0.013
"4324",514,"200692.9260.3","MA",2006,9,5,248,20,41.792,-70.2647,1,1,0,1,0,"MA",0.013
"4325",514,"200692.9270.4","MA",2006,9,5,248,20,41.8392,-70.3317,2,1,1,2,0,"MA",0.013
"4326",514,"200692.9270.5","MA",2006,9,5,248,20,41.8108,-70.3978,1,0,1,1,0,"MA",0.013
"4327",514,"200692.9250.6","MA",2006,9,5,248,20,41.8152,-70.5185,6,2,4,3,3,"MA",0.013
"4328",514,"200692.9250.7","MA",2006,9,6,249,20,41.8401,-70.5083,13,5,8,11,2,"MA",0.013
"4329",514,"200692.9260.8","MA",2006,9,6,249,20,41.8348,-70.492,10,2,8,8,2,"MA",0.013
"4330",514,"200692.9250.9","MA",2006,9,6,249,20,41.809,-70.0602,0,0,0,0,0,"MA",0.013
"4331",514,"200692.9280.11","MA",2006,9,7,250,13,41.9398,-70.4788,4,0,4,0,4,"MA",0.013
"4332",514,"200692.9280.12","MA",2006,9,7,250,13,41.964,-70.504,5,1,4,5,0,"MA",0.013
"4333",514,"200692.9290.13","MA",2006,9,7,250,20,42.0225,-70.5098,3,2,1,0,3,"MA",0.013
"4334",514,"200692.9310.14","MA",2006,9,7,250,13,42.2892,-70.8637,584,262,322,219,365,"MA",0.013
"4335",514,"200692.9320.15","MA",2006,9,7,250,13,42.2918,-70.8615,522,290,232,247,275,"MA",0.013
"4336",514,"200692.9330.16","MA",2006,9,8,251,13,42.3127,-70.8065,77,50,27,63,14,"MA",0.013
"4337",514,"200692.9350.17","MA",2006,9,8,251,13,42.3725,-70.7034,1,0,1,1,0,"MA",0.013
"4338",514,"200692.9340.18","MA",2006,9,8,251,13,42.3917,-70.8221,14,4,10,12,2,"MA",0.013
"4339",514,"200692.9330.19","MA",2006,9,8,251,13,42.4528,-70.87,52,32,20,48,4,"MA",0.013
"4340",514,"200692.9310.20","MA",2006,9,8,251,20,42.453,-70.916,181,94,87,76,105,"MA",0.013
"4341",514,"200692.9320.21","MA",2006,9,8,251,13,42.41,-70.9333,94,55,39,54,40,"MA",0.013
"4342",514,"200692.9350.22","MA",2006,9,9,252,20,42.4707,-70.7353,1,0,1,1,0,"MA",0.013
"4343",514,"200692.9360.23","MA",2006,9,9,252,20,42.4985,-70.6195,7,0,7,7,0,"MA",0.013
"4344",514,"200692.9350.24","MA",2006,9,9,252,20,42.5307,-70.6685,4,2,2,4,0,"MA",0.013
"4345",514,"200692.9350.25","MA",2006,9,9,252,20,42.5942,-70.5722,6,2,4,5,1,"MA",0.013
"4346",514,"200692.9360.26","MA",2006,9,10,253,17,42.7198,-70.5748,5,3,2,5,0,"MA",0.013
"4347",514,"200692.9340.28","MA",2006,9,14,257,15,42.7087,-70.6583,7,4,3,5,2,"MA",0.013
"4348",514,"200692.9310.29","MA",2006,9,14,257,20,42.6815,-70.7062,30,17,13,23,7,"MA",0.013
"4349",514,"200692.9320.30","MA",2006,9,14,257,20,42.7198,-70.7362,12,7,5,11,1,"MA",0.013
"4350",514,"200692.9330.31","MA",2006,9,14,257,20,42.7451,-70.7483,5,2,3,5,0,"MA",0.013
"4351",514,"200692.9330.32","MA",2006,9,14,257,20,42.7683,-70.7655,8,4,4,7,1,"MA",0.013
"4352",514,"200692.9300.34","MA",2006,9,15,258,15,42.1102,-70.3994,3,3,0,3,0,"MA",0.013
"4353",514,"200692.9300.35","MA",2006,9,15,258,13,42.0802,-70.3948,4,0,4,4,0,"MA",0.013
"4354",514,"200692.9290.36","MA",2006,9,15,258,13,41.9599,-70.4395,2,1,1,2,0,"MA",0.013
"4355",514,"200692.9280.37","MA",2006,9,15,258,20,41.898,-70.325,1,0,1,1,0,"MA",0.013
"4356",514,"200692.9280.38","MA",2006,9,16,259,13,41.8682,-70.2688,0,0,0,0,0,"MA",0.013
"4357",514,"200692.9270.39","MA",2006,9,16,259,13,41.8717,-70.1978,2,1,1,2,0,"MA",0.013
"4358",514,"200692.9260.40","MA",2006,9,16,259,13,41.8922,-70.136,1,0,1,1,0,"MA",0.013
"4359",514,"200692.9250.41","MA",2006,9,16,259,20,41.923,-70.1003,1,0,1,1,0,"MA",0.013
"4360",514,"200692.9280.42","MA",2006,9,16,259,14,41.9395,-70.2367,0,0,0,0,0,"MA",0.013
"4361",514,"200692.9290.43","MA",2006,9,16,259,13,41.9868,-70.293,0,0,0,0,0,"MA",0.013
"4362",514,"200692.9290.44","MA",2006,9,16,259,13,42.02,-70.3243,0,0,0,0,0,"MA",0.013
"4363",514,"200692.9270.45","MA",2006,9,16,259,13,41.9878,-70.1565,1,1,0,1,0,"MA",0.013
"4364",514,"200692.9210.46","MA",2006,9,17,260,13,42.1168,-70.2318,1,0,1,1,0,"MA",0.013
"4365",514,"200692.9170.47","MA",2006,9,17,260,13,42.0795,-70.1192,0,0,0,0,0,"MA",0.013
"4366",514,"200692.9210.48","MA",2006,9,17,260,14,42.0838,-70.0328,0,0,0,0,0,"MA",0.013
"4367",514,"200692.9200.49","MA",2006,9,17,260,15,42.0542,-70.0173,0,0,0,0,0,"MA",0.013
"4368",521,"200692.9170.50","MA",2006,9,17,260,20,41.9073,-69.9573,78,49,29,64,14,"MA",0.013
"4369",521,"200692.9190.51","MA",2006,9,17,260,20,41.8335,-69.9158,1,1,0,1,0,"MA",0.013
"4370",521,"200692.9180.53","MA",2006,9,18,261,16,41.7255,-69.895,2,2,0,1,1,"MA",0.013
"4371",521,"200692.9180.54","MA",2006,9,18,261,20,41.6477,-69.9147,3,3,0,3,0,"MA",0.013
"4372",521,"200692.9170.57","MA",2006,9,18,261,20,41.3923,-69.9897,0,0,0,0,0,"MA",0.013
"4373",514,"200792.9260.1","MA",2007,9,4,247,20,41.8107,-70.468,10,6,4,8,2,"MA",0.013
"4374",514,"200792.9250.2","MA",2007,9,4,247,20,41.8272,-70.515,0,0,0,0,0,"MA",0.013
"4375",514,"200792.9270.3","MA",2007,9,4,247,20,41.7793,-70.3685,1,1,0,0,1,"MA",0.013
"4376",514,"200792.9260.4","MA",2007,9,4,247,13,41.7692,-70.3523,0,0,0,0,0,"MA",0.013
"4377",514,"200792.9260.5","MA",2007,9,4,247,20,41.7665,-70.3088,0,0,0,0,0,"MA",0.013
"4378",514,"200792.9250.6","MA",2007,9,4,247,13,41.748,-70.2947,0,0,0,0,0,"MA",0.013
"4379",514,"200792.9260.7","MA",2007,9,5,248,13,41.776,-70.2135,1,1,0,1,0,"MA",0.013
"4380",514,"200792.9250.8","MA",2007,9,5,248,18,41.8092,-70.0815,0,0,0,0,0,"MA",0.013
"4381",514,"200792.9260.9","MA",2007,9,5,248,13,41.8243,-70.1943,0,0,0,0,0,"MA",0.013
"4382",514,"200792.9250.10","MA",2007,9,5,248,13,41.9212,-70.1007,0,0,0,0,0,"MA",0.013
"4383",514,"200792.9270.11","MA",2007,9,5,248,13,41.9038,-70.166,1,1,0,1,0,"MA",0.013
"4384",514,"200792.9270.12","MA",2007,9,5,248,13,41.8632,-70.2188,0,0,0,0,0,"MA",0.013
"4385",514,"200792.9280.13","MA",2007,9,5,248,20,41.8657,-70.2525,0,0,0,0,0,"MA",0.013
"4386",514,"200792.9280.14","MA",2007,9,5,248,20,41.923,-70.3043,0,0,0,0,0,"MA",0.013
"4387",514,"200792.9270.15","MA",2007,9,6,249,20,41.9563,-70.5335,3,2,1,3,0,"MA",0.013
"4388",514,"200792.9280.16","MA",2007,9,6,249,20,41.9975,-70.538,1,1,0,1,0,"MA",0.013
"4389",514,"200792.9270.17","MA",2007,9,6,249,20,42.0468,-70.5755,0,0,0,0,0,"MA",0.013
"4390",514,"200792.9340.18","MA",2007,9,6,249,13,42.3128,-70.7203,4,0,4,4,0,"MA",0.013
"4391",514,"200792.9320.19","MA",2007,9,6,249,13,42.3047,-70.8233,49,20,29,43,6,"MA",0.013
"4392",514,"200792.9330.20","MA",2007,9,6,249,13.3,42.3117,-70.7992,0,0,0,0,0,"MA",0.013
"4393",514,"200792.9320.21","MA",2007,9,7,250,17,42.4128,-70.9412,119,65,54,57,62,"MA",0.013
"4394",514,"200792.9310.22","MA",2007,9,7,250,15,42.4148,-70.9555,55,19,36,25,30,"MA",0.013
"4395",514,"200792.9340.23","MA",2007,9,7,250,18.8,42.4408,-70.848,4,2,2,2,2,"MA",0.013
"4396",514,"200792.9330.24","MA",2007,9,7,250,20,42.4502,-70.876,9,4,5,6,3,"MA",0.013
"4397",514,"200792.9350.25","MA",2007,9,7,250,20,42.46,-70.72,1,0,1,1,0,"MA",0.013
"4398",514,"200792.9350.26","MA",2007,9,7,250,20,42.5192,-70.7125,0,0,0,0,0,"MA",0.013
"4399",514,"200792.9360.27","MA",2007,9,7,250,13,42.488,-70.6245,4,0,4,4,0,"MA",0.013
"4400",514,"200792.9340.28","MA",2007,9,8,251,15,42.551,-70.7192,2,0,2,2,0,"MA",0.013
"4401",514,"200792.9350.29","MA",2007,9,8,251,13,42.5455,-70.6125,1,0,1,1,0,"MA",0.013
"4402",514,"200792.9350.30","MA",2007,9,8,251,20,42.5917,-70.5753,0,0,0,0,0,"MA",0.013
"4403",514,"200792.9360.31","MA",2007,9,8,251,20,42.6693,-70.523,5,2,3,5,0,"MA",0.013
"4404",514,"200792.9350.32","MA",2007,9,8,251,20,42.717,-70.615,0,0,0,0,0,"MA",0.013
"4405",514,"200792.9340.33","MA",2007,9,8,251,20,42.7035,-70.6317,3,2,1,3,0,"MA",0.013
"4406",514,"200792.9330.34","MA",2007,9,8,251,20,42.6932,-70.67,2,0,2,2,0,"MA",0.013
"4407",514,"200792.9310.35","MA",2007,9,9,252,20,42.698,-70.7357,5,1,4,4,1,"MA",0.013
"4408",514,"200792.9320.36","MA",2007,9,9,252,15,42.7625,-70.7755,2,2,0,1,1,"MA",0.013
"4409",514,"200792.9330.37","MA",2007,9,9,252,18.5,42.7793,-70.7708,0,0,0,0,0,"MA",0.013
"4410",514,"200792.9310.38","MA",2007,9,9,252,13,42.7507,-70.7838,33,7,26,27,6,"MA",0.013
"4411",514,"200792.9340.39","MA",2007,9,9,252,20,42.7127,-70.6843,2,2,0,2,0,"MA",0.013
"4412",514,"200792.9290.40","MA",2007,9,10,253,20,42.1168,-70.486,0,0,0,0,0,"MA",0.013
"4413",514,"200792.9290.41","MA",2007,9,10,253,20,42.0758,-70.5068,0,0,0,0,0,"MA",0.013
"4414",514,"200792.9280.42","MA",2007,9,10,253,20,41.994,-70.4863,4,1,3,4,0,"MA",0.013
"4415",514,"200792.9280.43","MA",2007,9,10,253,20,41.9523,-70.4702,0,0,0,0,0,"MA",0.013
"4416",514,"200792.9290.44","MA",2007,9,10,253,15,41.9692,-70.315,0,0,0,0,0,"MA",0.013
"4417",514,"200792.9290.45","MA",2007,9,10,253,15,41.9553,-70.3463,0,0,0,0,0,"MA",0.013
"4418",514,"200792.9290.46","MA",2007,9,11,254,20,41.968,-70.2535,1,1,0,1,0,"MA",0.013
"4419",514,"200792.9300.47","MA",2007,9,11,254,20,42.0637,-70.3128,1,1,0,1,0,"MA",0.013
"4420",514,"200792.9300.48","MA",2007,9,11,254,20,42.0853,-70.3155,0,0,0,0,0,"MA",0.013
"4421",514,"200792.9210.50","MA",2007,9,12,255,13,42.0812,-70.0243,0,0,0,0,0,"MA",0.013
"4422",514,"200792.9170.51","MA",2007,9,12,255,13,42.0002,-70.0102,0,0,0,0,0,"MA",0.013
"4423",521,"200792.9170.52","MA",2007,9,12,255,13,41.9698,-69.99,5,1,4,5,0,"MA",0.013
"4424",521,"200792.9180.56","MA",2007,9,13,256,13,41.7502,-69.9117,8,4,4,6,2,"MA",0.013
"4425",521,"200792.9180.57","MA",2007,9,13,256,13,41.7255,-69.9042,1,0,1,1,0,"MA",0.013
"4426",521,"200792.9190.58","MA",2007,9,13,256,13,41.7215,-69.883,1,1,0,1,0,"MA",0.013
"4427",521,"200792.9170.66","MA",2007,9,14,257,20,41.3962,-69.991,1,1,0,1,0,"MA",0.013
"4428",521,"200792.9180.67","MA",2007,9,14,257,20,41.4413,-69.9857,2,2,0,2,0,"MA",0.013
"4429",514,"200892.9260.1","MA",2008,9,2,246,19,41.8003,-70.4735,15,9,6,13,2,"MA",0.013
"4430",514,"200892.9280.2","MA",2008,9,2,246,20,41.8955,-70.4382,0,0,0,0,0,"MA",0.013
"4431",514,"200892.9280.3","MA",2008,9,2,246,20,41.9923,-70.5387,0,0,0,0,0,"MA",0.013
"4432",514,"200892.9270.4","MA",2008,9,2,246,20,42.0502,-70.575,8,5,3,6,2,"MA",0.013
"4433",514,"200892.9290.5","MA",2008,9,2,246,20,42.0413,-70.5082,2,1,1,2,0,"MA",0.013
"4434",514,"200892.9260.6","MA",2008,9,3,247,20,41.7625,-70.3522,0,0,0,0,0,"MA",0.013
"4435",514,"200892.9260.7","MA",2008,9,3,247,20,41.7665,-70.3013,2,1,1,0,2,"MA",0.013
"4436",514,"200892.9250.8","MA",2008,9,3,247,16,41.7492,-70.2987,0,0,0,0,0,"MA",0.013
"4437",514,"200892.9260.9","MA",2008,9,3,247,19,41.825,-70.118,3,1,2,3,0,"MA",0.013
"4438",514,"200892.9250.10","MA",2008,9,3,247,20,41.8292,-70.1695,0,0,0,0,0,"MA",0.013
"4439",514,"200892.9260.11","MA",2008,9,3,247,20,41.8228,-70.2113,0,0,0,0,0,"MA",0.013
"4440",514,"200892.9270.12","MA",2008,9,3,247,20,41.8432,-70.2233,3,2,1,3,0,"MA",0.013
"4441",514,"200892.9270.13","MA",2008,9,3,247,13,41.8597,-70.2478,5,1,4,1,4,"MA",0.013
"4442",514,"200892.9280.14","MA",2008,9,4,248,20,41.9513,-70.4805,6,4,2,6,0,"MA",0.013
"4443",514,"200892.9250.15","MA",2008,9,4,248,20,42.0392,-70.6265,392,174,218,85,307,"MA",0.013
"4444",514,"200892.9320.16","MA",2008,9,4,248,13,42.2358,-70.7445,562,250,312,210,352,"MA",0.013
"4445",514,"200892.9340.17","MA",2008,9,4,248,20,42.3205,-70.7272,9,3,6,6,3,"MA",0.013
"4446",514,"200892.9330.18","MA",2008,9,4,248,20,42.3103,-70.8093,52,37,15,48,4,"MA",0.013
"4447",514,"200892.9310.19","MA",2008,9,4,248,20,42.2882,-70.863,758,337,421,211,547,"MA",0.013
"4448",514,"200892.9330.20","MA",2008,9,5,249,13,42.4547,-70.8757,293,161,132,167,126,"MA",0.013
"4449",514,"200892.9350.21","MA",2008,9,5,249,13,42.4508,-70.8007,10,1,9,8,2,"MA",0.013
"4450",514,"200892.9350.22","MA",2008,9,5,249,20,42.455,-70.7103,1,0,1,1,0,"MA",0.013
"4451",514,"200892.9350.23","MA",2008,9,5,249,20,42.5977,-70.5702,15,7,8,9,6,"MA",0.013
"4452",514,"200892.9360.24","MA",2008,9,5,249,20,42.667,-70.5227,9,2,7,8,1,"MA",0.013
"4453",514,"200892.9340.25","MA",2008,9,6,250,20,42.722,-70.663,8,6,2,6,2,"MA",0.013
"4454",514,"200892.9310.26","MA",2008,9,6,250,18,42.6755,-70.6908,21,9,12,19,2,"MA",0.013
"4455",514,"200892.9320.27","MA",2008,9,6,250,20,42.7025,-70.7193,8,6,2,8,0,"MA",0.013
"4456",514,"200892.9310.28","MA",2008,9,6,250,20,42.7137,-70.7543,21,5,16,18,3,"MA",0.013
"4457",514,"200892.9330.29","MA",2008,9,6,250,17,42.7498,-70.751,2,2,0,2,0,"MA",0.013
"4458",514,"200892.9320.30","MA",2008,9,6,250,20,42.7655,-70.7748,12,5,7,12,0,"MA",0.013
"4459",514,"200892.9330.31","MA",2008,9,6,250,20,42.7962,-70.7647,0,0,0,0,0,"MA",0.013
"4460",514,"200892.9350.32","MA",2008,9,6,250,20,42.7128,-70.6373,15,9,6,15,0,"MA",0.013
"4461",514,"200892.9360.33","MA",2008,9,8,252,20,42.4283,-70.6655,7,2,5,7,0,"MA",0.013
"4462",514,"200892.9290.34","MA",2008,9,8,252,13,42.114,-70.4897,0,0,0,0,0,"MA",0.013
"4463",514,"200892.9300.35","MA",2008,9,8,252,20,42.1038,-70.341,0,0,0,0,0,"MA",0.013
"4464",514,"200892.9300.36","MA",2008,9,8,252,20,42.0655,-70.3802,3,1,2,3,0,"MA",0.013
"4465",514,"200892.9290.37","MA",2008,9,8,252,20,42.0437,-70.4352,5,1,4,5,0,"MA",0.013
"4466",514,"200892.9290.38","MA",2008,9,8,252,20,41.966,-70.3003,0,0,0,0,0,"MA",0.013
"4467",514,"200892.9270.39","MA",2008,9,9,253,13,41.7767,-70.394,9,1,8,9,0,"MA",0.013
"4468",514,"200892.9270.40","MA",2008,9,9,253,20,41.8403,-70.328,2,1,1,2,0,"MA",0.013
"4469",514,"200892.9280.41","MA",2008,9,9,253,20,41.8808,-70.2413,1,1,0,1,0,"MA",0.013
"4470",514,"200892.9290.42","MA",2008,9,9,253,20,41.9913,-70.282,0,0,0,0,0,"MA",0.013
"4471",514,"200892.9280.43","MA",2008,9,9,253,20,41.947,-70.2172,1,0,1,1,0,"MA",0.013
"4472",514,"200892.9250.44","MA",2008,9,9,253,20,41.9628,-70.0932,2,0,2,2,0,"MA",0.013
"4473",514,"200892.9210.45","MA",2008,9,11,255,15,42.1203,-70.2375,1,0,1,1,0,"MA",0.013
"4474",514,"200892.9170.47","MA",2008,9,11,255,20,42.083,-70.129,0,0,0,0,0,"MA",0.013
"4475",514,"200892.9210.48","MA",2008,9,11,255,13,42.0673,-70.0082,0,0,0,0,0,"MA",0.013
"4476",521,"200892.9180.49","MA",2008,9,11,255,13,41.9868,-69.9882,2,1,1,2,0,"MA",0.013
"4477",521,"200892.9180.51","MA",2008,9,11,255,15,41.8918,-69.9493,5,2,3,4,1,"MA",0.013
"4478",521,"200892.9170.52","MA",2008,9,12,256,20,41.8467,-69.937,12,10,2,12,0,"MA",0.013
"4479",521,"200892.9200.53","MA",2008,9,12,256,13,41.8347,-69.888,1,0,1,1,0,"MA",0.013
"4480",521,"200892.9200.54","MA",2008,9,12,256,13,41.8047,-69.8797,0,0,0,0,0,"MA",0.013
"4481",521,"200892.9190.55","MA",2008,9,12,256,13,41.7193,-69.8755,0,0,0,0,0,"MA",0.013
"4482",514,"200992.9260.1","MA",2009,9,8,251,20,41.8057,-70.4653,68,44,24,42,26,"MA",0.013
"4483",514,"200992.9270.2","MA",2009,9,8,251,20,41.8595,-70.4458,3,2,1,3,0,"MA",0.013
"4484",514,"200992.9260.3","MA",2009,9,8,251,20,41.8458,-70.4978,26,11,15,19,7,"MA",0.013
"4485",514,"200992.9280.4","MA",2009,9,8,251,20,41.9103,-70.4525,1,0,1,0,1,"MA",0.013
"4486",514,"200992.9250.5","MA",2009,9,8,251,20,41.9618,-70.6048,49,23,26,38,11,"MA",0.013
"4487",514,"200992.9290.6","MA",2009,9,8,251,20,41.9575,-70.4408,3,1,2,3,0,"MA",0.013
"4488",514,"200992.9270.7","MA",2009,9,8,251,20,41.8332,-70.366,2,1,1,1,1,"MA",0.013
"4489",514,"200992.9250.8","MA",2009,9,9,252,14,41.7555,-70.4348,7,3,4,6,1,"MA",0.013
"4490",514,"200992.9260.9","MA",2009,9,9,252,20,41.7497,-70.3787,39,17,22,26,13,"MA",0.013
"4491",514,"200992.9270.10","MA",2009,9,9,252,16,41.8147,-70.2938,0,0,0,0,0,"MA",0.013
"4492",514,"200992.9320.11","MA",2009,9,11,254,14,42.291,-70.8615,504,303,201,239,265,"MA",0.013
"4493",514,"200992.9310.12","MA",2009,9,11,254,20,42.2892,-70.8625,454,225,229,174,280,"MA",0.013
"4494",514,"200992.9350.13","MA",2009,9,11,254,13.5,42.3317,-70.7108,5,2,3,4,1,"MA",0.013
"4495",514,"200992.9340.14","MA",2009,9,11,254,13.5,42.3952,-70.8242,19,14,5,18,1,"MA",0.013
"4496",514,"200992.9340.15","MA",2009,9,12,255,20,42.5457,-70.7298,37,12,25,29,8,"MA",0.013
"4497",514,"200992.9350.16","MA",2009,9,12,255,18,42.4658,-70.7278,2,2,0,2,0,"MA",0.013
"4498",514,"200992.9350.17","MA",2009,9,12,255,20,42.4725,-70.7702,15,7,8,14,1,"MA",0.013
"4499",514,"200992.9330.18","MA",2009,9,12,255,20,42.4455,-70.8785,264,131,133,161,103,"MA",0.013
"4500",514,"200992.9320.19","MA",2009,9,12,255,13,42.4462,-70.9128,136,47,89,81,55,"MA",0.013
"4501",514,"200992.9330.20","MA",2009,9,12,255,17,42.3938,-70.9072,268,153,115,153,115,"MA",0.013
"4502",514,"200992.9360.21","MA",2009,9,13,256,20,42.7048,-70.5387,5,2,3,3,2,"MA",0.013
"4503",514,"200992.9350.22","MA",2009,9,13,256,18,42.7213,-70.6215,7,6,1,7,0,"MA",0.013
"4504",514,"200992.9330.23","MA",2009,9,13,256,13,42.7065,-70.6862,28,13,15,28,0,"MA",0.013
"4505",514,"200992.9310.24","MA",2009,9,13,256,20,42.6875,-70.7165,22,8,14,19,3,"MA",0.013
"4506",514,"200992.9320.25","MA",2009,9,13,256,20,42.7005,-70.7227,43,19,24,27,16,"MA",0.013
"4507",514,"200992.9330.26","MA",2009,9,13,256,17.5,42.7367,-70.736,11,8,3,8,3,"MA",0.013
"4508",514,"200992.9340.27","MA",2009,9,13,256,20,42.7488,-70.7213,14,6,8,12,2,"MA",0.013
"4509",513,"200992.9340.28","MA",2009,9,13,256,20,42.8475,-70.7545,10,4,6,9,1,"MA",0.013
"4510",513,"200992.9310.29","MA",2009,9,13,256,20,42.8422,-70.8092,68,33,35,34,34,"MA",0.013
"4511",514,"200992.9350.30","MA",2009,9,14,257,20,42.5818,-70.592,16,8,8,10,6,"MA",0.013
"4512",514,"200992.9360.31","MA",2009,9,14,257,20,42.4693,-70.6398,23,6,17,20,3,"MA",0.013
"4513",514,"200992.9300.32","MA",2009,9,14,257,20,42.1063,-70.3328,0,0,0,0,0,"MA",0.013
"4514",514,"200992.9300.33","MA",2009,9,14,257,20,42.1195,-70.3775,0,0,0,0,0,"MA",0.013
"4515",514,"200992.9290.34","MA",2009,9,14,257,20,42.01,-70.4252,2,1,1,2,0,"MA",0.013
"4516",514,"200992.9280.35","MA",2009,9,14,257,20,41.8918,-70.3357,2,2,0,2,0,"MA",0.013
"4517",514,"200992.9290.36","MA",2009,9,15,258,13,42.0392,-70.2452,7,1,6,7,0,"MA",0.013
"4518",514,"200992.9210.37","MA",2009,9,15,258,16,42.105,-70.2363,2,2,0,2,0,"MA",0.013
"4519",514,"200992.9170.38","MA",2009,9,15,258,17,42.0883,-70.1557,1,1,0,1,0,"MA",0.013
"4520",514,"200992.9170.40","MA",2009,9,15,258,20,42.0708,-70.1008,0,0,0,0,0,"MA",0.013
"4521",514,"200992.9210.41","MA",2009,9,15,258,13,42.088,-70.0405,3,3,0,3,0,"MA",0.013
"4522",514,"200992.9250.42","MA",2009,9,16,259,20,42.028,-70.1027,25,11,14,19,6,"MA",0.013
"4523",514,"200992.9260.43","MA",2009,9,16,259,16,42.0067,-70.1127,12,2,10,10,2,"MA",0.013
"4524",514,"200992.9270.44","MA",2009,9,16,259,18,42.0038,-70.1567,10,5,5,10,0,"MA",0.013
"4525",514,"200992.9290.45","MA",2009,9,16,259,13,42.009,-70.2198,1,1,0,1,0,"MA",0.013
"4526",514,"200992.9280.46","MA",2009,9,16,259,13,41.9365,-70.2125,1,0,1,1,0,"MA",0.013
"4527",514,"200992.9280.47","MA",2009,9,16,259,13,41.888,-70.2357,0,0,0,0,0,"MA",0.013
"4528",514,"200992.9260.48","MA",2009,9,16,259,20,41.9008,-70.1417,15,10,5,14,1,"MA",0.013
"4529",514,"200992.9250.49","MA",2009,9,16,259,20,41.827,-70.1643,0,0,0,0,0,"MA",0.013
"4530",514,"200992.9270.50","MA",2009,9,16,259,15,41.857,-70.2577,0,0,0,0,0,"MA",0.013
"4531",521,"200992.9170.73","MA",2009,9,20,263,20,41.3593,-69.9818,0,0,0,0,0,"MA",0.013
"4532",521,"200992.9170.74","MA",2009,9,20,263,20,41.4035,-69.9733,1,1,0,1,0,"MA",0.013
"4533",521,"200992.9180.77","MA",2009,9,21,264,13,41.754,-69.9173,28,24,4,26,2,"MA",0.013
"4534",521,"200992.9180.78","MA",2009,9,21,264,20,41.6045,-69.9147,0,0,0,0,0,"MA",0.013
"4535",514,"201092.9270.1","MA",2010,9,7,250,20.3,41.7784,-70.4084,10,3,7,6,4,"MA",0.013195
"4536",514,"201092.9260.4","MA",2010,9,7,250,18.3,41.7684,-70.2897,5,3,2,4,1,"MA",0.013
"4537",514,"201092.9270.5","MA",2010,9,7,250,20.1,41.8047,-70.3016,3,1,2,1,2,"MA",0.013065
"4538",514,"201092.9270.6","MA",2010,9,7,250,20.2,41.8229,-70.2842,5,4,1,2,3,"MA",0.01313
"4539",514,"201092.9260.7","MA",2010,9,7,250,20,41.8461,-70.1928,3,2,1,3,0,"MA",0.013
"4540",514,"201092.9270.8","MA",2010,9,7,250,20.1,41.8656,-70.2173,1,0,1,1,0,"MA",0.013065
"4541",514,"201092.9260.9","MA",2010,9,8,251,20.3,41.8101,-70.475,17,7,10,12,5,"MA",0.013195
"4542",514,"201092.9260.10","MA",2010,9,8,251,20.1,41.8569,-70.494,9,4,5,5,4,"MA",0.013065
"4543",514,"201092.9280.11","MA",2010,9,8,251,20,41.9277,-70.4648,2,1,1,1,1,"MA",0.013
"4544",514,"201092.9250.12","MA",2010,9,8,251,20.1,41.9748,-70.5956,36,23,13,24,12,"MA",0.013065
"4545",514,"201092.9280.13","MA",2010,9,8,251,20.1,41.9743,-70.5129,1,1,0,0,1,"MA",0.013065
"4546",514,"201092.9280.14","MA",2010,9,8,251,20,41.9086,-70.4228,0,0,0,0,0,"MA",0.013
"4547",514,"201092.9290.15","MA",2010,9,9,252,20.1,42.0372,-70.4729,3,1,2,3,0,"MA",0.013065
"4548",514,"201092.9290.16","MA",2010,9,9,252,20.2,42.0572,-70.4352,1,0,1,1,0,"MA",0.01313
"4549",514,"201092.9250.17","MA",2010,9,9,252,20.2,42.1489,-70.6883,464,235,229,161,303,"MA",0.01313
"4550",514,"201092.9320.18","MA",2010,9,9,252,13.1,42.2887,-70.8143,53,24,29,26,27,"MA",0.013
"4551",514,"201092.9320.20","MA",2010,9,9,252,13.1,42.3038,-70.8311,281,138,143,140,141,"MA",0.013
"4552",514,"201092.9310.21","MA",2010,9,10,253,20,42.4021,-70.9604,283,138,145,110,173,"MA",0.013
"4553",514,"201092.9340.22","MA",2010,9,10,253,18.1,42.39,-70.8186,58,28,30,34,24,"MA",0.013
"4554",514,"201092.9350.23","MA",2010,9,10,253,13.1,42.4515,-70.795,39,14,25,33,6,"MA",0.013
"4555",514,"201092.9350.26","MA",2010,9,11,254,13,42.5314,-70.6685,14,6,8,14,0,"MA",0.013
"4556",514,"201092.9350.27","MA",2010,9,11,254,13.1,42.5656,-70.601,15,6,9,11,4,"MA",0.013
"4557",514,"201092.9360.30","MA",2010,9,11,254,13.1,42.6239,-70.5333,28,13,15,26,2,"MA",0.013
"4558",514,"201092.9350.31","MA",2010,9,11,254,20.1,42.7082,-70.6258,23,9,14,18,5,"MA",0.013065
"4559",514,"201092.9350.32","MA",2010,9,11,254,19.1,42.591,-70.5819,80,42,38,60,20,"MA",0.013
"4560",514,"201092.9320.33","MA",2010,9,12,255,17,42.6921,-70.6961,16,9,7,14,2,"MA",0.013
"4561",514,"201092.9310.34","MA",2010,9,12,255,20.1,42.6916,-70.7276,42,24,18,36,6,"MA",0.013065
"4562",514,"201092.9330.35","MA",2010,9,12,255,20,42.7139,-70.7175,6,3,3,4,2,"MA",0.013
"4563",514,"201092.9330.36","MA",2010,9,12,255,20.1,42.7421,-70.7403,6,2,4,6,0,"MA",0.013065
"4564",513,"201092.9340.37","MA",2010,9,12,255,20,42.8354,-70.7494,10,5,5,7,3,"MA",0.013
"4565",513,"201092.9340.38","MA",2010,9,12,255,20,42.8543,-70.7591,19,9,10,16,3,"MA",0.013
"4566",513,"201092.9310.39","MA",2010,9,12,255,19.9,42.8448,-70.8086,672,343,329,437,235,"MA",0.013
"4567",514,"201092.9360.40","MA",2010,9,13,256,20.1,42.433,-70.6686,6,1,5,4,2,"MA",0.013065
"4568",514,"201092.9300.41","MA",2010,9,13,256,20,42.0873,-70.3317,2,1,1,2,0,"MA",0.013
"4569",514,"201092.9300.42","MA",2010,9,13,256,20.1,42.0623,-70.3535,1,0,1,1,0,"MA",0.013065
"4570",514,"201092.9290.43","MA",2010,9,13,256,20.1,41.9962,-70.2923,4,2,2,4,0,"MA",0.013065
"4571",514,"201092.9280.44","MA",2010,9,14,257,20.1,41.8759,-70.2481,1,0,1,1,0,"MA",0.013065
"4572",514,"201092.9280.45","MA",2010,9,14,257,20,41.9336,-70.2094,3,1,2,2,1,"MA",0.013
"4573",514,"201092.9290.46","MA",2010,9,14,257,20,41.9619,-70.2606,4,1,3,4,0,"MA",0.013
"4574",514,"201092.9270.47","MA",2010,9,14,257,20.1,41.9139,-70.1591,5,2,3,5,0,"MA",0.013065
"4575",514,"201092.9260.48","MA",2010,9,14,257,20.1,41.9176,-70.1217,9,4,5,8,1,"MA",0.013065
"4576",514,"201092.9250.49","MA",2010,9,14,257,20,41.9184,-70.101,2,1,1,2,0,"MA",0.013
"4577",514,"201092.9250.50","MA",2010,9,14,257,20,41.9187,-70.0979,3,2,1,3,0,"MA",0.013
"4578",514,"201092.9210.51","MA",2010,9,15,258,20.1,42.1009,-70.2122,11,2,9,11,0,"MA",0.013065
"4579",514,"201092.9170.53","MA",2010,9,15,258,13.8,42.0411,-70.0481,1,1,0,1,0,"MA",0.013
"4580",514,"201092.9210.54","MA",2010,9,15,258,13,42.0748,-70.0208,0,0,0,0,0,"MA",0.013
"4581",514,"201092.9200.55","MA",2010,9,15,258,13.1,42.0613,-70.0241,0,0,0,0,0,"MA",0.013
"4582",521,"201092.9180.56","MA",2010,9,15,258,13.1,41.9159,-69.9602,67,45,22,65,2,"MA",0.013
"4583",521,"201092.9200.57","MA",2010,9,16,259,13.1,41.8242,-69.8882,0,0,0,0,0,"MA",0.013
"4584",521,"201092.9170.60","MA",2010,9,16,259,13.1,41.601,-69.9364,6,6,0,6,0,"MA",0.013
"4585",514,"201192.9250.2","MA",2011,9,7,250,20,41.7481,-70.2989,4,1,3,3,1,"MA",0.013
"4586",514,"201192.9270.3","MA",2011,9,7,250,12.9,41.7985,-70.3224,0,0,0,0,0,"MA",0.013
"4587",514,"201192.9270.4","MA",2011,9,7,250,13.1,41.8228,-70.294,7,1,6,7,0,"MA",0.013
"4588",514,"201192.9270.5","MA",2011,9,7,250,20,41.8445,-70.2431,2,2,0,1,1,"MA",0.013
"4589",514,"201192.9250.6","MA",2011,9,7,250,20,41.8155,-70.0916,0,0,0,0,0,"MA",0.013
"4590",514,"201192.9260.7","MA",2011,9,7,250,20.1,41.8202,-70.1409,17,7,10,14,3,"MA",0.013065
"4591",514,"201192.9250.8","MA",2011,9,7,250,20,41.8331,-70.1614,8,3,5,8,0,"MA",0.013
"4592",514,"201192.9260.10","MA",2011,9,8,251,13,41.7733,-70.4395,39,13,26,23,16,"MA",0.013
"4593",514,"201192.9280.11","MA",2011,9,8,251,13,41.9385,-70.4832,11,7,4,7,4,"MA",0.013
"4594",514,"201192.9250.12","MA",2011,9,8,251,20,41.9592,-70.6099,62,32,30,37,25,"MA",0.013
"4595",514,"201192.9260.13","MA",2011,9,8,251,13.1,42.1405,-70.6718,288,151,137,127,161,"MA",0.013
"4596",514,"201192.9320.16","MA",2011,9,9,252,13,42.2916,-70.8598,774,443,331,323,451,"MA",0.013
"4597",514,"201192.9330.17","MA",2011,9,9,252,13,42.3132,-70.8098,339,194,145,178,161,"MA",0.013
"4598",514,"201192.9310.18","MA",2011,9,9,252,20.2,42.4031,-70.9601,286,154,132,207,79,"MA",0.01313
"4599",514,"201192.9320.19","MA",2011,9,9,252,13.2,42.4111,-70.9283,384,214,170,190,194,"MA",0.013
"4600",514,"201192.9340.22","MA",2011,9,9,252,18,42.4366,-70.8623,323,180,143,210,113,"MA",0.013
"4601",514,"201192.9350.23","MA",2011,9,10,253,13.1,42.4727,-70.7456,68,30,38,64,4,"MA",0.013
"4602",514,"201192.9350.24","MA",2011,9,10,253,13.1,42.3714,-70.6887,4,1,3,4,0,"MA",0.013
"4603",514,"201192.9350.25","MA",2011,9,10,253,13.1,42.5467,-70.6117,50,23,27,43,7,"MA",0.013
"4604",514,"201192.9350.26","MA",2011,9,10,253,15.4,42.5866,-70.5844,77,32,45,58,19,"MA",0.013
"4605",514,"201192.9360.27","MA",2011,9,10,253,20.1,42.7204,-70.5503,7,1,6,6,1,"MA",0.013065
"4606",514,"201192.9340.28","MA",2011,9,11,254,16.7,42.7226,-70.6679,43,25,18,38,5,"MA",0.013
"4607",514,"201192.9310.29","MA",2011,9,11,254,20,42.6877,-70.7253,7,1,6,2,5,"MA",0.013
"4608",514,"201192.9320.30","MA",2011,9,11,254,20.1,42.7054,-70.7297,72,32,40,45,27,"MA",0.013065
"4609",514,"201192.9330.31","MA",2011,9,11,254,20.1,42.7432,-70.7446,44,26,18,40,4,"MA",0.013065
"4610",514,"201192.9330.32","MA",2011,9,11,254,20,42.778,-70.7579,7,3,4,7,0,"MA",0.013
"4611",514,"201192.9310.33","MA",2011,9,11,254,20.1,42.7902,-70.7994,8,2,6,7,1,"MA",0.013065
"4612",514,"201192.9350.34","MA",2011,9,11,254,16.2,42.7333,-70.6317,4,3,1,4,0,"MA",0.013
"4613",514,"201192.9360.35","MA",2011,9,12,255,12.9,42.4986,-70.6429,29,6,23,27,2,"MA",0.013
"4614",514,"201192.9300.36","MA",2011,9,12,255,20,42.116,-70.4232,1,0,1,1,0,"MA",0.013
"4615",514,"201192.9290.37","MA",2011,9,12,255,13.1,42.0735,-70.5193,10,4,6,6,4,"MA",0.013
"4616",514,"201192.9290.38","MA",2011,9,12,255,13.1,42.0688,-70.4387,1,1,0,1,0,"MA",0.013
"4617",514,"201192.9290.39","MA",2011,9,12,255,13.1,41.9858,-70.4117,0,0,0,0,0,"MA",0.013
"4618",514,"201192.9280.40","MA",2011,9,12,255,20.3,41.9145,-70.3354,7,1,6,6,1,"MA",0.013195
"4619",514,"201192.9270.41","MA",2011,9,13,256,16.1,41.8619,-70.2407,0,0,0,0,0,"MA",0.013
"4620",514,"201192.9260.42","MA",2011,9,13,256,13.1,41.8544,-70.1729,30,8,22,30,0,"MA",0.013
"4621",514,"201192.9280.43","MA",2011,9,13,256,20.2,41.8775,-70.2262,0,0,0,0,0,"MA",0.01313
"4622",514,"201192.9280.44","MA",2011,9,13,256,13,41.8933,-70.2578,0,0,0,0,0,"MA",0.013
"4623",514,"201192.9290.45","MA",2011,9,13,256,20,41.9758,-70.2965,3,0,3,2,1,"MA",0.013
"4624",514,"201192.9290.46","MA",2011,9,13,256,20,42.0134,-70.3025,4,1,3,4,0,"MA",0.013
"4625",514,"201192.9300.47","MA",2011,9,13,256,20,42.0638,-70.2893,2,0,2,2,0,"MA",0.013
"4626",514,"201192.9210.48","MA",2011,9,14,257,20.1,42.1223,-70.1939,9,5,4,9,0,"MA",0.013065
"4627",514,"201192.9200.49","MA",2011,9,14,257,13,42.1014,-70.1774,12,4,8,10,2,"MA",0.013
"4628",514,"201192.9180.50","MA",2011,9,14,257,13,42.0896,-70.1448,0,0,0,0,0,"MA",0.013
"4629",514,"201192.9190.51","MA",2011,9,14,257,13.1,42.096,-70.1646,15,8,7,15,0,"MA",0.013
"4630",514,"201192.9170.52","MA",2011,9,14,257,13.1,42.0901,-70.1669,0,0,0,0,0,"MA",0.013
"4631",514,"201192.9210.53","MA",2011,9,14,257,13.1,42.0754,-70.0194,5,4,1,5,0,"MA",0.013
"4632",521,"201192.9170.55","MA",2011,9,15,258,13.2,41.8991,-69.9546,44,33,11,44,0,"MA",0.013
"4633",521,"201192.9170.60","MA",2011,9,15,258,20,41.3913,-69.9925,1,1,0,1,0,"MA",0.013
"4634",514,"201292.9250.4","MA",2012,9,4,248,13,41.748,-70.2981,0,0,0,0,0,"MA",0.013
"4635",514,"201292.9270.5","MA",2012,9,4,248,13,41.8087,-70.2724,13,2,11,9,4,"MA",0.013
"4636",514,"201292.9260.7","MA",2012,9,5,249,13,41.8564,-70.4932,42,22,20,36,6,"MA",0.013
"4637",514,"201292.9270.8","MA",2012,9,5,249,13,41.8586,-70.4442,22,12,10,8,14,"MA",0.013
"4638",514,"201292.9280.10","MA",2012,9,5,249,19.9,41.9631,-70.5034,10,3,7,7,3,"MA",0.013
"4639",514,"201292.9250.11","MA",2012,9,5,249,20,41.971,-70.6002,12,8,4,11,1,"MA",0.013
"4640",514,"201292.9290.12","MA",2012,9,5,249,20.2,41.9718,-70.4464,2,1,1,2,0,"MA",0.01313
"4641",514,"201292.9280.13","MA",2012,9,5,249,20.1,41.9027,-70.4291,2,0,2,2,0,"MA",0.013065
"4642",514,"201292.9350.14","MA",2012,9,6,250,15.3,42.3271,-70.7082,8,4,4,7,1,"MA",0.013
"4643",514,"201292.9340.15","MA",2012,9,6,250,13.2,42.3075,-70.7182,71,43,28,38,33,"MA",0.013
"4644",514,"201292.9320.18","MA",2012,9,6,250,12.9,42.2918,-70.8607,462,231,231,211,251,"MA",0.013
"4645",514,"201292.9310.19","MA",2012,9,6,250,13.1,42.2886,-70.8637,455,247,208,225,230,"MA",0.013
"4646",514,"201292.9320.20","MA",2012,9,7,251,13,42.2984,-70.8205,185,78,107,131,54,"MA",0.013
"4647",514,"201292.9330.22","MA",2012,9,7,251,13,42.3959,-70.9108,183,105,78,97,86,"MA",0.013
"4648",514,"201292.9340.23","MA",2012,9,7,251,13,42.4471,-70.8352,226,124,102,160,66,"MA",0.013
"4649",514,"201292.9350.24","MA",2012,9,7,251,18,42.4839,-70.7474,111,65,46,88,23,"MA",0.013
"4650",514,"201292.9350.25","MA",2012,9,7,251,13,42.4678,-70.7299,64,30,34,53,11,"MA",0.013
"4651",514,"201292.9350.26","MA",2012,9,8,252,20,42.5956,-70.574,87,38,49,47,40,"MA",0.013
"4652",514,"201292.9360.27","MA",2012,9,8,252,20,42.5821,-70.5641,24,9,15,14,10,"MA",0.013
"4653",514,"201292.9340.28","MA",2012,9,8,252,13,42.7031,-70.6441,114,56,58,91,23,"MA",0.013
"4654",514,"201292.9350.29","MA",2012,9,8,252,20,42.7372,-70.6571,23,10,13,19,4,"MA",0.013
"4655",514,"201292.9340.30","MA",2012,9,8,252,20,42.7297,-70.6755,46,15,31,42,4,"MA",0.013
"4656",514,"201292.9330.31","MA",2012,9,9,253,20,42.7173,-70.7101,22,13,9,19,3,"MA",0.013
"4657",514,"201292.9310.32","MA",2012,9,9,253,20,42.6836,-70.7072,36,12,24,35,1,"MA",0.013
"4658",514,"201292.9320.33","MA",2012,9,9,253,20,42.7003,-70.7222,47,19,28,44,3,"MA",0.013
"4659",514,"201292.9330.34","MA",2012,9,9,253,20,42.7807,-70.7656,12,7,5,12,0,"MA",0.013
"4660",514,"201292.9310.35","MA",2012,9,9,253,20.1,42.7858,-70.7985,121,60,61,110,11,"MA",0.013065
"4661",514,"201292.9360.36","MA",2012,9,9,253,17.5,42.5092,-70.6548,18,2,16,16,2,"MA",0.013
"4662",514,"201292.9290.37","MA",2012,9,10,254,20.1,41.9888,-70.2201,3,2,1,3,0,"MA",0.013065
"4663",514,"201292.9280.38","MA",2012,9,10,254,13,41.9101,-70.2024,0,0,0,0,0,"MA",0.013
"4664",514,"201292.9260.39","MA",2012,9,10,254,19.9,41.8901,-70.128,1,0,1,1,0,"MA",0.013
"4665",514,"201292.9270.40","MA",2012,9,10,254,20,41.9085,-70.1661,22,9,13,21,1,"MA",0.013
"4666",514,"201292.9280.41","MA",2012,9,11,255,20,41.9588,-70.1821,2,2,0,2,0,"MA",0.013
"4667",514,"201292.9270.42","MA",2012,9,11,255,20,41.9942,-70.1516,3,2,1,2,1,"MA",0.013
"4668",514,"201292.9250.43","MA",2012,9,11,255,19.9,42.0333,-70.108,2,2,0,2,0,"MA",0.013
"4669",514,"201292.9250.44","MA",2012,9,11,255,20.1,41.9321,-70.098,2,2,0,2,0,"MA",0.013065
"4670",514,"201292.9290.45","MA",2012,9,11,255,20,41.9659,-70.2543,3,2,1,3,0,"MA",0.013
"4671",514,"201292.9290.46","MA",2012,9,11,255,20,41.9732,-70.3944,5,2,3,5,0,"MA",0.013
"4672",514,"201292.9300.47","MA",2012,9,12,256,20,42.0644,-70.3504,2,0,2,2,0,"MA",0.013
"4673",514,"201292.9300.48","MA",2012,9,12,256,20,42.0903,-70.3177,2,0,2,2,0,"MA",0.013
"4674",514,"201292.9210.49","MA",2012,9,12,256,20,42.1195,-70.2326,23,10,13,22,1,"MA",0.013
"4675",514,"201292.9210.50","MA",2012,9,12,256,15.4,42.0977,-70.2239,32,12,20,32,0,"MA",0.013
"4676",514,"201292.9200.51","MA",2012,9,12,256,20.1,42.1015,-70.1566,9,5,4,9,0,"MA",0.013065
"4677",514,"201292.9170.52","MA",2012,9,12,256,20,42.0708,-70.1002,1,1,0,1,0,"MA",0.013
"4678",521,"201292.9170.54","MA",2012,9,13,257,13,41.9325,-69.9692,10,10,0,10,0,"MA",0.013
"4679",521,"201292.9200.58","MA",2012,9,13,257,20.1,41.8289,-69.8878,0,0,0,0,0,"MA",0.013065
"4680",521,"201292.9170.59","MA",2012,9,13,257,20,41.4023,-69.9748,0,0,0,0,0,"MA",0.013
"4681",514,"201392.9260.3","MA",2013,9,3,246,13.1,41.776,-70.1684,8,6,2,6,2,"MA",0.013
"4682",514,"201392.9250.4","MA",2013,9,3,246,20,41.8125,-70.0687,0,0,0,0,0,"MA",0.013
"4683",514,"201392.9260.5","MA",2013,9,3,246,13,41.8139,-70.2151,10,4,6,8,2,"MA",0.013
"4684",514,"201392.9260.6","MA",2013,9,3,246,13,41.7952,-70.2493,10,6,4,10,0,"MA",0.013
"4685",514,"201392.9270.7","MA",2013,9,3,246,15.1,41.8025,-70.3641,3,0,3,2,1,"MA",0.013
"4686",514,"201392.9250.8","MA",2013,9,4,247,18.1,41.8123,-70.5163,73,34,39,54,19,"MA",0.013
"4687",514,"201392.9250.9","MA",2013,9,4,247,20.1,41.8344,-70.5208,51,25,26,43,8,"MA",0.013065
"4688",514,"201392.9270.10","MA",2013,9,4,247,20,41.8427,-70.4117,9,4,5,4,5,"MA",0.013
"4689",514,"201392.9270.11","MA",2013,9,4,247,20.2,41.8474,-70.3249,3,1,2,3,0,"MA",0.01313
"4690",514,"201392.9280.12","MA",2013,9,4,247,20.1,41.8764,-70.3115,4,1,3,4,0,"MA",0.013065
"4691",514,"201392.9280.13","MA",2013,9,4,247,20,41.8983,-70.3501,6,2,4,6,0,"MA",0.013
"4692",514,"201392.9290.14","MA",2013,9,4,247,20,41.9279,-70.3995,6,4,2,5,1,"MA",0.013
"4693",514,"201392.9280.15","MA",2013,9,5,248,19.6,41.9712,-70.5106,8,1,7,5,3,"MA",0.013
"4694",514,"201392.9260.16","MA",2013,9,5,248,15,41.9759,-70.5817,97,59,38,87,10,"MA",0.013
"4695",514,"201392.9290.17","MA",2013,9,5,248,19.4,42.0301,-70.4978,3,0,3,3,0,"MA",0.013
"4696",514,"201392.9310.18","MA",2013,9,6,249,20,42.2869,-70.8614,348,161,187,126,222,"MA",0.013
"4697",514,"201392.9330.20","MA",2013,9,6,249,13,42.3868,-70.907,163,88,75,113,50,"MA",0.013
"4698",514,"201392.9320.21","MA",2013,9,6,249,14.5,42.4531,-70.9102,135,66,69,61,74,"MA",0.013
"4699",514,"201392.9330.22","MA",2013,9,6,249,20.1,42.446,-70.8746,309,160,149,121,188,"MA",0.013065
"4700",514,"201392.9340.24","MA",2013,9,6,249,20,42.4305,-70.8547,148,83,65,92,56,"MA",0.013
"4701",514,"201392.9360.25","MA",2013,9,7,250,12.9,42.5306,-70.6271,42,16,26,34,8,"MA",0.013
"4702",514,"201392.9350.26","MA",2013,9,7,250,13,42.546,-70.6101,30,11,19,22,8,"MA",0.013
"4703",514,"201392.9350.28","MA",2013,9,7,250,18.2,42.5672,-70.5975,42,19,23,26,16,"MA",0.013
"4704",514,"201392.9350.29","MA",2013,9,7,250,20,42.589,-70.5807,113,65,48,62,51,"MA",0.013
"4705",514,"201392.9340.30","MA",2013,9,7,250,20,42.6676,-70.5524,402,211,191,161,241,"MA",0.013
"4706",514,"201392.9360.31","MA",2013,9,7,250,20,42.7064,-70.5395,29,12,17,21,8,"MA",0.013
"4707",514,"201392.9350.32","MA",2013,9,8,251,15.2,42.7248,-70.6218,47,27,20,41,6,"MA",0.013
"4708",514,"201392.9340.33","MA",2013,9,8,251,20,42.721,-70.6622,39,21,18,35,4,"MA",0.013
"4709",514,"201392.9330.34","MA",2013,9,8,251,20,42.6964,-70.6781,26,8,18,25,1,"MA",0.013
"4710",514,"201392.9310.35","MA",2013,9,8,251,20.1,42.6813,-70.7017,88,39,49,71,17,"MA",0.013065
"4711",514,"201392.9320.36","MA",2013,9,8,251,20.1,42.6971,-70.716,15,7,8,13,2,"MA",0.013065
"4712",514,"201392.9310.37","MA",2013,9,8,251,20,42.7301,-70.7739,96,53,43,81,15,"MA",0.013
"4713",514,"201392.9330.38","MA",2013,9,8,251,20,42.7662,-70.7498,33,19,14,33,0,"MA",0.013
"4714",514,"201392.9350.39","MA",2013,9,9,252,13,42.514,-70.7103,182,88,94,126,56,"MA",0.013
"4715",514,"201392.9300.40","MA",2013,9,9,252,20,42.1075,-70.4181,3,2,1,2,1,"MA",0.013
"4716",514,"201392.9290.41","MA",2013,9,9,252,20,42.067,-70.4443,4,2,2,3,1,"MA",0.013
"4717",514,"201392.9300.42","MA",2013,9,9,252,20,42.0675,-70.3833,1,1,0,1,0,"MA",0.013
"4718",514,"201392.9290.43","MA",2013,9,9,252,15.3,42.0494,-70.3881,3,2,1,2,1,"MA",0.013
"4719",514,"201392.9290.44","MA",2013,9,9,252,13.1,41.9598,-70.3047,4,2,2,4,0,"MA",0.013
"4720",514,"201392.9270.45","MA",2013,9,10,253,20,41.8618,-70.2438,0,0,0,0,0,"MA",0.013
"4721",514,"201392.9270.46","MA",2013,9,10,253,20,41.8816,-70.2052,1,1,0,1,0,"MA",0.013
"4722",514,"201392.9280.47","MA",2013,9,10,253,19.8,41.912,-70.1949,2,0,2,2,0,"MA",0.013
"4723",514,"201392.9250.48","MA",2013,9,10,253,20,41.944,-70.0952,17,14,3,15,2,"MA",0.013
"4724",514,"201392.9280.49","MA",2013,9,10,253,20,41.9615,-70.18,1,0,1,1,0,"MA",0.013
"4725",514,"201392.9210.50","MA",2013,9,11,254,14.2,42.1326,-70.1845,6,0,6,6,0,"MA",0.013
"4726",514,"201392.9170.51","MA",2013,9,11,254,13,42.0921,-70.191,4,4,0,4,0,"MA",0.013
"4727",514,"201392.9210.52","MA",2013,9,11,254,20,42.085,-70.0351,5,2,3,5,0,"MA",0.013
"4728",514,"201392.9170.53","MA",2013,9,11,254,20,42.0568,-70.0713,6,5,1,6,0,"MA",0.013
"4729",514,"201392.9200.54","MA",2013,9,11,254,20,42.0625,-70.0257,6,3,3,6,0,"MA",0.013
"4730",514,"201392.9190.55","MA",2013,9,11,254,13,42.0357,-70.0169,6,4,2,6,0,"MA",0.013
"4731",521,"201392.9200.56","MA",2013,9,11,254,19.5,41.8234,-69.8848,1,0,1,1,0,"MA",0.013
"4732",521,"201392.9180.57","MA",2013,9,12,255,14,41.715,-69.896,0,0,0,0,0,"MA",0.013
"4733",521,"201392.9180.58","MA",2013,9,12,255,20,41.692,-69.8754,0,0,0,0,0,"MA",0.013
"4734",521,"201392.9170.61","MA",2013,9,12,255,15.2,41.4048,-69.9696,0,0,0,0,0,"MA",0.013
"4735",526,"201392.9170.62","MA",2013,9,12,255,13,41.3329,-69.9796,0,0,0,0,0,"MA",0.013
"4736",514,"201492.9270.1","MA",2014,9,2,245,20,41.7982,-70.3201,3,2,1,3,0,"MA",0.013
"4737",514,"201492.9270.2","MA",2014,9,2,245,20,41.821,-70.3067,2,1,1,2,0,"MA",0.013
"4738",514,"201492.9260.3","MA",2014,9,2,245,20.1,41.7986,-70.2469,27,13,14,27,0,"MA",0.013065
"4739",514,"201492.9260.4","MA",2014,9,2,245,20,41.8228,-70.116,2,0,2,2,0,"MA",0.013
"4740",514,"201492.9250.5","MA",2014,9,2,245,13,41.816,-70.052,1,0,1,1,0,"MA",0.013
"4741",514,"201492.9250.6","MA",2014,9,2,245,13.1,41.8242,-70.1014,0,0,0,0,0,"MA",0.013
"4742",514,"201492.9250.7","MA",2014,9,2,245,20,41.7482,-70.2908,3,2,1,3,0,"MA",0.013
"4743",514,"201492.9260.8","MA",2014,9,2,245,13,41.7628,-70.397,6,0,6,2,4,"MA",0.013
"4744",514,"201492.9260.9","MA",2014,9,3,246,20,41.8011,-70.4844,5,1,4,5,0,"MA",0.013
"4745",514,"201492.9270.10","MA",2014,9,3,246,20,41.8323,-70.4551,8,7,1,6,2,"MA",0.013
"4746",514,"201492.9250.11","MA",2014,9,3,246,13,41.8543,-70.5141,115,65,50,81,34,"MA",0.013
"4747",514,"201492.9280.12","MA",2014,9,3,246,20,41.8802,-70.4471,0,0,0,0,0,"MA",0.013
"4748",514,"201492.9280.13","MA",2014,9,3,246,20,41.9167,-70.4146,20,7,13,18,2,"MA",0.013
"4749",514,"201492.9290.14","MA",2014,9,3,246,20,41.9928,-70.4456,9,4,5,8,1,"MA",0.013
"4750",514,"201492.9290.15","MA",2014,9,3,246,20,42.0227,-70.4645,5,2,3,5,0,"MA",0.013
"4751",514,"201492.9280.16","MA",2014,9,3,246,20,42.0021,-70.5239,5,2,3,4,1,"MA",0.013
"4752",514,"201492.9290.17","MA",2014,9,4,247,20,42.0613,-70.5294,10,5,5,9,1,"MA",0.013
"4753",514,"201492.9320.18","MA",2014,9,4,247,15,42.2267,-70.7368,325,156,169,148,177,"MA",0.013
"4754",514,"201492.9340.19","MA",2014,9,4,247,20,42.3153,-70.7247,14,2,12,10,4,"MA",0.013
"4755",514,"201492.9350.20","MA",2014,9,4,247,20.1,42.3187,-70.7166,10,6,4,9,1,"MA",0.013065
"4756",514,"201492.9330.21","MA",2014,9,4,247,15,42.3066,-70.8062,2,2,0,1,1,"MA",0.013
"4757",514,"201492.9320.22","MA",2014,9,4,247,16,42.2935,-70.8576,198,77,121,99,99,"MA",0.013
"4758",514,"201492.9310.23","MA",2014,9,5,248,15.6,42.288,-70.8623,90,28,62,55,35,"MA",0.013
"4759",514,"201492.9340.24","MA",2014,9,5,248,15,42.4359,-70.8497,82,41,41,58,24,"MA",0.013
"4760",514,"201492.9330.25","MA",2014,9,5,248,13,42.4466,-70.8817,163,88,75,101,62,"MA",0.013
"4761",514,"201492.9350.27","MA",2014,9,5,248,20,42.4607,-70.7171,17,5,12,17,0,"MA",0.013
"4762",514,"201492.9350.28","MA",2014,9,5,248,18,42.5079,-70.7246,31,10,21,18,13,"MA",0.013
"4763",514,"201492.9340.29","MA",2014,9,6,249,20,42.697,-70.6002,51,22,29,45,6,"MA",0.013
"4764",514,"201492.9310.30","MA",2014,9,6,249,20,42.6862,-70.7169,58,27,31,41,17,"MA",0.013
"4765",514,"201492.9320.31","MA",2014,9,6,249,20,42.6945,-70.7083,31,16,15,28,3,"MA",0.013
"4766",514,"201492.9310.32","MA",2014,9,6,249,20,42.7025,-70.7377,22,5,17,18,4,"MA",0.013
"4767",514,"201492.9330.33","MA",2014,9,6,249,20,42.7523,-70.7405,24,14,10,24,0,"MA",0.013
"4768",513,"201492.9340.34","MA",2014,9,6,249,13.1,42.8672,-70.7569,25,10,15,23,2,"MA",0.013
"4769",514,"201492.9350.35","MA",2014,9,7,250,13,42.5858,-70.6138,65,28,37,41,24,"MA",0.013
"4770",514,"201492.9350.36","MA",2014,9,7,250,20,42.5829,-70.5805,15,11,4,12,3,"MA",0.013
"4771",514,"201492.9360.38","MA",2014,9,7,250,20,42.7251,-70.5964,6,2,4,5,1,"MA",0.013
"4772",514,"201492.9360.39","MA",2014,9,7,250,20,42.5195,-70.6595,20,4,16,17,3,"MA",0.013
"4773",514,"201492.9300.40","MA",2014,9,8,251,20,42.0889,-70.3886,2,1,1,1,1,"MA",0.013
"4774",514,"201492.9300.41","MA",2014,9,8,251,20.1,42.1163,-70.331,4,2,2,4,0,"MA",0.013065
"4775",514,"201492.9290.42","MA",2014,9,8,251,18,42.0296,-70.2608,6,2,4,6,0,"MA",0.013
"4776",514,"201492.9290.43","MA",2014,9,9,252,20,41.96,-70.3395,2,1,1,2,0,"MA",0.013
"4777",514,"201492.9280.44","MA",2014,9,9,252,20,41.9379,-70.243,4,0,4,3,1,"MA",0.013
"4778",514,"201492.9280.45","MA",2014,9,9,252,20,41.9037,-70.2094,5,2,3,5,0,"MA",0.013
"4779",514,"201492.9270.46","MA",2014,9,9,252,20,41.8939,-70.1709,23,8,15,21,2,"MA",0.013
"4780",514,"201492.9260.47","MA",2014,9,9,252,20,41.8666,-70.185,15,6,9,15,0,"MA",0.013
"4781",514,"201492.9270.48","MA",2014,9,9,252,20,41.8659,-70.2252,8,3,5,8,0,"MA",0.013
"4782",521,"201492.9180.91","MA",2014,9,16,259,20,41.3737,-69.9574,1,1,0,1,0,"MA",0.013
"4783",521,"201492.9170.92","MA",2014,9,16,259,20,41.3604,-69.9821,0,0,0,0,0,"MA",0.013
"4784",521,"201492.9170.94","MA",2014,9,16,259,20,41.5847,-69.94,3,3,0,3,0,"MA",0.013
"4785",521,"201492.9180.95","MA",2014,9,16,259,20,41.7432,-69.901,0,0,0,0,0,"MA",0.013
"4786",521,"201492.9190.97","MA",2014,9,17,260,13,41.9619,-69.9698,27,19,8,27,0,"MA",0.013
"4787",514,"201492.9180.98","MA",2014,9,17,260,18,42.0064,-70.0046,10,7,3,9,1,"MA",0.013
"4788",514,"201492.9210.99","MA",2014,9,17,260,13,42.0874,-70.0386,4,4,0,4,0,"MA",0.013
"4789",514,"201492.9200.100","MA",2014,9,17,260,13,42.0975,-70.1083,22,2,20,22,0,"MA",0.013
"4790",514,"201492.9170.101","MA",2014,9,17,260,20.1,42.0881,-70.1499,1,0,1,1,0,"MA",0.013065
"4791",514,"201492.9210.102","MA",2014,9,17,260,13,42.0968,-70.2246,17,4,13,17,0,"MA",0.013
"4792",514,"201592.9250.1","MA",2015,9,8,251,20,41.8407,-70.5085,146,78,68,119,27,"MA",0.013
"4793",514,"201592.9260.2","MA",2015,9,8,251,18,41.8551,-70.4923,20,12,8,19,1,"MA",0.013
"4794",514,"201592.9270.3","MA",2015,9,8,251,20,41.9231,-70.4939,87,46,41,66,21,"MA",0.013
"4795",514,"201592.9290.4","MA",2015,9,8,251,20,41.9934,-70.4585,13,6,7,10,3,"MA",0.013
"4796",514,"201592.9290.5","MA",2015,9,8,251,19.6,41.9728,-70.4339,28,11,17,23,5,"MA",0.013
"4797",514,"201592.9290.6","MA",2015,9,8,251,20,41.9606,-70.4053,31,14,17,28,3,"MA",0.013
"4798",514,"201592.9280.7","MA",2015,9,8,251,20,41.8892,-70.3953,11,4,7,10,1,"MA",0.013
"4799",514,"201592.9270.8","MA",2015,9,9,252,20,41.7928,-70.3806,9,3,6,6,3,"MA",0.013
"4800",514,"201592.9260.9","MA",2015,9,9,252,20,41.7573,-70.3562,6,1,5,4,2,"MA",0.013
"4801",514,"201592.9260.10","MA",2015,9,9,252,20.1,41.7549,-70.3181,31,19,12,29,2,"MA",0.013065
"4802",514,"201592.9250.11","MA",2015,9,9,252,15,41.8156,-70.0504,0,0,0,0,0,"MA",0.013
"4803",514,"201592.9270.12","MA",2015,9,9,252,20.1,41.8468,-70.2317,4,1,3,4,0,"MA",0.013065
"4804",514,"201592.9270.13","MA",2015,9,9,252,18.7,41.8288,-70.3766,1,0,1,1,0,"MA",0.013
"4805",514,"201592.9250.14","MA",2015,9,10,253,20,42.1484,-70.6879,470,185,285,138,332,"MA",0.013
"4806",514,"201592.9340.15","MA",2015,9,10,253,13,42.3079,-70.7214,59,18,41,53,6,"MA",0.013
"4807",514,"201592.9320.16","MA",2015,9,10,253,13,42.2986,-70.822,623,281,342,339,284,"MA",0.013
"4808",514,"201592.9330.18","MA",2015,9,12,255,20.1,42.396,-70.9119,260,171,89,174,86,"MA",0.013065
"4809",514,"201592.9340.19","MA",2015,9,12,255,20,42.3922,-70.8216,76,41,35,69,7,"MA",0.013
"4810",514,"201592.9310.20","MA",2015,9,12,255,20.1,42.4526,-70.9223,232,98,134,153,79,"MA",0.013065
"4811",514,"201592.9330.21","MA",2015,9,12,255,20,42.45,-70.8883,422,225,197,163,259,"MA",0.013
"4812",514,"201592.9350.22","MA",2015,9,12,255,14.8,42.4545,-70.7121,3,2,1,2,1,"MA",0.013
"4813",514,"201592.9360.25","MA",2015,9,13,256,14.2,42.6612,-70.5207,39,18,21,35,4,"MA",0.013
"4814",514,"201592.9340.26","MA",2015,9,13,256,16.2,42.7244,-70.6715,45,20,25,41,4,"MA",0.013
"4815",514,"201592.9330.27","MA",2015,9,13,256,20.1,42.7215,-70.7158,19,11,8,15,4,"MA",0.013065
"4816",514,"201592.9320.28","MA",2015,9,13,256,20,42.7045,-70.7235,79,38,41,67,12,"MA",0.013
"4817",514,"201592.9310.29","MA",2015,9,13,256,20,42.69,-70.7206,68,44,24,44,24,"MA",0.013
"4818",514,"201592.9310.30","MA",2015,9,13,256,13,42.7116,-70.7513,159,78,81,146,13,"MA",0.013
"4819",514,"201592.9330.31","MA",2015,9,13,256,13,42.752,-70.7419,44,23,21,44,0,"MA",0.013
"4820",514,"201592.9350.33","MA",2015,9,14,257,20,42.5098,-70.6768,47,18,29,39,8,"MA",0.013
"4821",514,"201592.9360.35","MA",2015,9,14,257,13,42.4844,-70.6253,21,4,17,21,0,"MA",0.013
"4822",514,"201592.9300.36","MA",2015,9,14,257,20.1,42.0963,-70.3879,7,2,5,7,0,"MA",0.013065
"4823",514,"201592.9280.37","MA",2015,9,15,258,14.6,41.9107,-70.3417,9,2,7,8,1,"MA",0.013
"4824",514,"201592.9280.38","MA",2015,9,15,258,20,41.8706,-70.2984,5,2,3,4,1,"MA",0.013
"4825",514,"201592.9280.39","MA",2015,9,15,258,20.1,41.8913,-70.224,1,0,1,1,0,"MA",0.013065
"4826",514,"201592.9270.40","MA",2015,9,15,258,13.1,41.8575,-70.2194,43,26,17,41,2,"MA",0.013
"4827",514,"201592.9260.41","MA",2015,9,15,258,20,41.862,-70.1619,4,4,0,4,0,"MA",0.013
"4828",514,"201592.9280.42","MA",2015,9,15,258,19.9,41.9139,-70.1923,5,2,3,5,0,"MA",0.013
"4829",514,"201592.9260.43","MA",2015,9,15,258,13.1,41.9105,-70.1242,6,4,2,6,0,"MA",0.013
"4830",514,"201592.9290.45","MA",2015,9,16,259,20,41.9743,-70.2956,7,1,6,7,0,"MA",0.013
"4831",514,"201592.9290.46","MA",2015,9,16,259,20,42.0177,-70.3002,3,0,3,3,0,"MA",0.013
"4832",514,"201592.9300.47","MA",2015,9,16,259,20,42.1013,-70.3039,0,0,0,0,0,"MA",0.013
"4833",514,"201592.9210.48","MA",2015,9,16,259,20,42.0917,-70.2421,9,3,6,9,0,"MA",0.013
"4834",514,"201592.9210.49","MA",2015,9,16,259,20,42.109,-70.1532,1,1,0,1,0,"MA",0.013
"4835",514,"201592.9200.50","MA",2015,9,16,259,13,42.0984,-70.1149,8,4,4,8,0,"MA",0.013
"4836",521,"201592.9170.52","MA",2015,9,17,260,20,41.8941,-69.9533,12,10,2,12,0,"MA",0.013
"4837",521,"201592.9200.54","MA",2015,9,17,260,20,41.7945,-69.879,0,0,0,0,0,"MA",0.013
"4838",521,"201592.9180.55","MA",2015,9,17,260,13.1,41.7121,-69.8982,1,0,1,1,0,"MA",0.013
"4839",521,"201592.9190.56","MA",2015,9,17,260,13,41.6937,-69.8642,0,0,0,0,0,"MA",0.013
"4840",521,"201592.9180.57","MA",2015,9,17,260,14.6,41.6652,-69.8848,0,0,0,0,0,"MA",0.013
"4841",521,"201592.9170.58","MA",2015,9,17,260,20,41.5868,-69.9487,0,0,0,0,0,"MA",0.013
"4842",521,"201592.9170.60","MA",2015,9,18,261,13,41.3616,-69.9977,0,0,0,0,0,"MA",0.013
"4843",521,"201592.9180.61","MA",2015,9,18,261,20,41.388,-69.9643,1,0,1,1,0,"MA",0.013
"4844",514,"198291.9260.1","MA",1982,5,4,124,20,41.771,-70.4283,7,2,5,5,2,"MA",0.013
"4845",514,"198291.9270.2","MA",1982,5,4,124,20,41.7827,-70.3498,0,0,0,0,0,"MA",0.013
"4846",514,"198291.9260.3","MA",1982,5,4,124,20,41.7553,-70.3268,0,0,0,0,0,"MA",0.013
"4847",514,"198291.9260.4","MA",1982,5,4,124,20,41.8535,-70.1648,0,0,0,0,0,"MA",0.013
"4848",514,"198291.9270.5","MA",1982,5,4,124,20,41.8618,-70.2162,0,0,0,0,0,"MA",0.013
"4849",514,"198291.9270.6","MA",1982,5,4,124,20,41.832,-70.3343,1,0,1,1,0,"MA",0.013
"4850",514,"198291.9250.7","MA",1982,5,5,125,20,41.8218,-70.5148,3,3,0,2,1,"MA",0.013
"4851",514,"198291.9280.8","MA",1982,5,5,125,20,41.9422,-70.4738,0,0,0,0,0,"MA",0.013
"4852",514,"198291.9290.9","MA",1982,5,5,125,20,41.9553,-70.4137,1,1,0,1,0,"MA",0.013
"4853",514,"198291.9280.10","MA",1982,5,5,125,20,41.999,-70.5318,1,0,1,1,0,"MA",0.013
"4854",514,"198291.9260.11","MA",1982,5,5,125,20,41.9652,-70.581,18,7,11,13,5,"MA",0.013
"4855",514,"198291.9320.12","MA",1982,5,6,126,13,42.2935,-70.8497,178,79,99,145,33,"MA",0.013
"4856",514,"198291.9310.13","MA",1982,5,6,126,18,42.451,-70.9138,13,7,6,10,3,"MA",0.013
"4857",514,"198291.9330.14","MA",1982,5,6,126,18,42.4402,-70.8792,5,3,2,5,0,"MA",0.013
"4858",514,"198291.9340.15","MA",1982,5,6,126,20,42.4822,-70.765,2,0,2,2,0,"MA",0.013
"4859",514,"198291.9350.16","MA",1982,5,6,126,20,42.4862,-70.7362,3,1,2,3,0,"MA",0.013
"4860",514,"198291.9350.17","MA",1982,5,6,126,20,42.505,-70.722,0,0,0,0,0,"MA",0.013
"4861",514,"198291.9340.18","MA",1982,5,6,126,20,42.544,-70.7307,1,1,0,1,0,"MA",0.013
"4862",514,"198291.9360.19","MA",1982,5,7,127,20,42.6315,-70.5265,0,0,0,0,0,"MA",0.013
"4863",514,"198291.9360.20","MA",1982,5,7,127,20,42.7258,-70.5928,0,0,0,0,0,"MA",0.013
"4864",514,"198291.9330.21","MA",1982,5,7,127,20,42.697,-70.6698,0,0,0,0,0,"MA",0.013
"4865",514,"198291.9310.22","MA",1982,5,7,127,20,42.6705,-70.681,22,5,17,22,0,"MA",0.013
"4866",514,"198291.9320.23","MA",1982,5,7,127,20,42.7202,-70.7417,2,1,1,2,0,"MA",0.013
"4867",514,"198291.9310.24","MA",1982,5,7,127,20,42.7825,-70.7928,21,7,14,19,2,"MA",0.013
"4868",514,"198291.9330.25","MA",1982,5,7,127,15,42.7897,-70.7647,0,0,0,0,0,"MA",0.013
"4869",514,"198291.9340.26","MA",1982,5,7,127,20,42.7192,-70.6767,0,0,0,0,0,"MA",0.013
"4870",514,"198291.9350.27","MA",1982,5,8,128,20,42.5773,-70.5908,4,1,3,4,0,"MA",0.013
"4871",514,"198291.9350.28","MA",1982,5,8,128,17,42.5338,-70.6645,0,0,0,0,0,"MA",0.013
"4872",514,"198291.9360.29","MA",1982,5,8,128,20,42.4927,-70.6227,1,0,1,1,0,"MA",0.013
"4873",514,"198291.9360.30","MA",1982,5,8,128,20,42.4647,-70.6332,1,0,1,1,0,"MA",0.013
"4874",514,"198291.9350.31","MA",1982,5,8,128,20,42.3677,-70.693,2,1,1,2,0,"MA",0.013
"4875",514,"198291.9270.32","MA",1982,5,9,129,20,42.095,-70.5718,2,1,1,2,0,"MA",0.013
"4876",514,"198291.9290.33","MA",1982,5,9,129,20,42.1223,-70.4835,1,0,1,1,0,"MA",0.013
"4877",514,"198291.9300.34","MA",1982,5,9,129,20,42.0722,-70.3708,0,0,0,0,0,"MA",0.013
"4878",514,"198291.9290.35","MA",1982,5,9,129,20,42.0578,-70.4368,2,1,1,2,0,"MA",0.013
"4879",514,"198291.9280.36","MA",1982,5,9,129,20,41.9108,-70.4205,0,0,0,0,0,"MA",0.013
"4880",514,"198291.9290.40","MA",1982,5,12,132,20,41.955,-70.2995,0,0,0,0,0,"MA",0.013
"4881",514,"198291.9280.41","MA",1982,5,12,132,20,41.9618,-70.2005,0,0,0,0,0,"MA",0.013
"4882",514,"198291.9260.42","MA",1982,5,12,132,20,41.9558,-70.1095,0,0,0,0,0,"MA",0.013
"4883",514,"198291.9250.43","MA",1982,5,12,132,20,41.9038,-70.1032,0,0,0,0,0,"MA",0.013
"4884",514,"198291.9270.44","MA",1982,5,12,132,20,41.918,-70.1442,0,0,0,0,0,"MA",0.013
"4885",514,"198291.9280.45","MA",1982,5,12,132,20,41.8988,-70.2138,0,0,0,0,0,"MA",0.013
"4886",514,"198291.9290.46","MA",1982,5,13,133,20,42.0033,-70.272,0,0,0,0,0,"MA",0.013
"4887",514,"198291.9300.47","MA",1982,5,13,133,20,42.0897,-70.2833,0,0,0,0,0,"MA",0.013
"4888",514,"198291.9210.48","MA",1982,5,13,133,20,42.0925,-70.2178,1,0,1,1,0,"MA",0.013
"4889",514,"198291.9180.49","MA",1982,5,13,133,20,42.086,-70.1345,0,0,0,0,0,"MA",0.013
"4890",514,"198291.9210.50","MA",1982,5,13,133,20,42.08,-70.0395,0,0,0,0,0,"MA",0.013
"4891",514,"198291.9200.51","MA",1982,5,13,133,20,42.0978,-70.1278,1,1,0,1,0,"MA",0.013
"4892",521,"198291.9170.83","MA",1982,5,19,139,20,41.395,-69.9713,0,0,0,0,0,"MA",0.013
"4893",521,"198291.9190.88","MA",1982,5,20,140,13,41.7045,-69.873,0,0,0,0,0,"MA",0.013
"4894",521,"198291.9200.89","MA",1982,5,20,140,20,41.7722,-69.863,0,0,0,0,0,"MA",0.013
"4895",521,"198291.9180.90","MA",1982,5,20,140,16,41.7378,-69.9025,1,0,1,1,0,"MA",0.013
"4896",514,"198391.9250.2","MA",1983,5,9,129,16,41.8183,-70.5283,1,0,1,1,0,"MA",0.013
"4897",514,"198391.9270.3","MA",1983,5,9,129,15,41.8815,-70.4755,1,0,1,1,0,"MA",0.013
"4898",514,"198391.9280.4","MA",1983,5,9,129,15,41.96,-70.5242,1,1,0,1,0,"MA",0.013
"4899",514,"198391.9250.5","MA",1983,5,9,129,20,41.9588,-70.6068,2,1,1,2,0,"MA",0.013
"4900",514,"198391.9330.7","MA",1983,5,10,130,13,42.3055,-70.8172,31,17,14,24,7,"MA",0.013
"4901",514,"198391.9340.8","MA",1983,5,10,130,15,42.442,-70.8675,4,2,2,4,0,"MA",0.013
"4902",514,"198391.9310.9","MA",1983,5,10,130,13,42.4448,-70.9293,4,2,2,4,0,"MA",0.013
"4903",514,"198391.9350.10","MA",1983,5,10,130,20,42.4872,-70.7632,1,1,0,1,0,"MA",0.013
"4904",514,"198391.9360.11","MA",1983,5,10,130,13,42.4313,-70.6963,1,1,0,1,0,"MA",0.013
"4905",514,"198391.9360.12","MA",1983,5,10,130,15,42.5082,-70.6287,1,0,1,1,0,"MA",0.013
"4906",514,"198391.9350.13","MA",1983,5,11,131,20,42.5918,-70.5753,1,1,0,1,0,"MA",0.013
"4907",514,"198391.9350.14","MA",1983,5,11,131,20,42.6865,-70.562,0,0,0,0,0,"MA",0.013
"4908",514,"198391.9340.15","MA",1983,5,11,131,20,42.7183,-70.6595,0,0,0,0,0,"MA",0.013
"4909",514,"198391.9330.16","MA",1983,5,11,131,20,42.726,-70.7295,0,0,0,0,0,"MA",0.013
"4910",514,"198391.9320.17","MA",1983,5,11,131,20,42.767,-70.7843,8,1,7,8,0,"MA",0.013
"4911",514,"198391.9330.18","MA",1983,5,11,131,20,42.7995,-70.7785,7,3,4,6,1,"MA",0.013
"4912",514,"198391.9310.19","MA",1983,5,11,131,20,42.7808,-70.7963,0,0,0,0,0,"MA",0.013
"4913",514,"198391.9310.20","MA",1983,5,11,131,13,42.7087,-70.7443,13,4,9,13,0,"MA",0.013
"4914",514,"198391.9360.21","MA",1983,5,11,131,13,42.7193,-70.5665,1,1,0,1,0,"MA",0.013
"4915",514,"198391.9350.22","MA",1983,5,12,132,14,42.5628,-70.6275,1,0,1,1,0,"MA",0.013
"4916",514,"198391.9350.23","MA",1983,5,12,132,20,42.4743,-70.7303,2,1,1,2,0,"MA",0.013
"4917",514,"198391.9290.24","MA",1983,5,12,132,20,42.1012,-70.4847,3,1,2,3,0,"MA",0.013
"4918",514,"198391.9260.25","MA",1983,5,13,133,20,41.9648,-70.5835,12,6,6,9,3,"MA",0.013
"4919",514,"198391.9290.26","MA",1983,5,13,133,20,41.9853,-70.4123,4,2,2,4,0,"MA",0.013
"4920",514,"198391.9290.27","MA",1983,5,13,133,20,41.9243,-70.3702,1,0,1,1,0,"MA",0.013
"4921",514,"198391.9280.28","MA",1983,5,13,133,20,41.866,-70.438,3,0,3,2,1,"MA",0.013
"4922",514,"198391.9270.29","MA",1983,5,13,133,20,41.8165,-70.365,1,0,1,1,0,"MA",0.013
"4923",514,"198391.9260.30","MA",1983,5,14,134,20,41.8052,-70.4907,3,2,1,2,1,"MA",0.013
"4924",514,"198391.9270.31","MA",1983,5,14,134,20,41.8638,-70.4532,8,4,4,8,0,"MA",0.013
"4925",514,"198391.9280.32","MA",1983,5,14,134,20,41.8748,-70.3407,4,1,3,4,0,"MA",0.013
"4926",514,"198391.9290.33","MA",1983,5,14,134,16,41.9475,-70.2748,1,0,1,1,0,"MA",0.013
"4927",514,"198391.9280.34","MA",1983,5,14,134,20,41.8977,-70.2328,0,0,0,0,0,"MA",0.013
"4928",514,"198391.9270.35","MA",1983,5,14,134,20,41.8547,-70.2382,1,1,0,1,0,"MA",0.013
"4929",514,"198391.9260.36","MA",1983,5,14,134,20,41.8002,-70.2217,3,1,2,3,0,"MA",0.013
"4930",514,"198391.9210.37","MA",1983,5,15,135,20,42.0807,-70.2443,1,0,1,1,0,"MA",0.013
"4931",514,"198391.9170.38","MA",1983,5,15,135,20,42.0612,-70.0795,1,1,0,1,0,"MA",0.013
"4932",514,"198391.9210.39","MA",1983,5,15,135,17,42.0778,-70.0307,0,0,0,0,0,"MA",0.013
"4933",514,"198391.9300.40","MA",1983,5,16,136,20,42.0713,-70.3778,0,0,0,0,0,"MA",0.013
"4934",514,"198391.9300.41","MA",1983,5,16,136,20,42.06,-70.3223,3,2,1,3,0,"MA",0.013
"4935",514,"198391.9290.42","MA",1983,5,16,136,20,42.0075,-70.216,2,1,1,2,0,"MA",0.013
"4936",514,"198391.9270.43","MA",1983,5,16,136,15,42.0047,-70.147,0,0,0,0,0,"MA",0.013
"4937",514,"198391.9260.44","MA",1983,5,16,136,20,41.965,-70.1077,0,0,0,0,0,"MA",0.013
"4938",514,"198391.9280.45","MA",1983,5,16,136,20,41.9483,-70.1895,0,0,0,0,0,"MA",0.013
"4939",514,"198391.9250.46","MA",1983,5,16,136,20,41.8865,-70.1123,0,0,0,0,0,"MA",0.013
"4940",521,"198391.9180.59","MA",1983,5,19,139,13,41.624,-69.907,4,0,4,4,0,"MA",0.013
"4941",521,"198391.9190.60","MA",1983,5,19,139,20,41.7302,-69.8802,0,0,0,0,0,"MA",0.013
"4942",521,"198391.9180.61","MA",1983,5,19,139,20,41.8302,-69.9163,0,0,0,0,0,"MA",0.013
"4943",521,"198391.9170.62","MA",1983,5,19,139,15,41.8818,-69.9475,0,0,0,0,0,"MA",0.013
"4944",521,"198391.9200.63","MA",1983,5,19,139,20,41.79,-69.8773,0,0,0,0,0,"MA",0.013
"4945",521,"198391.9200.64","MA",1983,5,19,139,20,41.7732,-69.8687,0,0,0,0,0,"MA",0.013
"4946",521,"198391.9170.78","MA",1983,5,22,142,20,41.3762,-69.992,0,0,0,0,0,"MA",0.013
"4947",514,"198491.9260.1","MA",1984,5,7,128,20,41.853,-70.4877,2,1,1,2,0,"MA",0.013
"4948",514,"198491.9290.2","MA",1984,5,7,128,20,41.9488,-70.4235,1,0,1,1,0,"MA",0.013
"4949",514,"198491.9260.3","MA",1984,5,7,128,20,41.9695,-70.576,13,4,9,12,1,"MA",0.013
"4950",514,"198491.9270.4","MA",1984,5,7,128,20,42.048,-70.5742,5,0,5,4,1,"MA",0.013
"4951",514,"198491.9290.5","MA",1984,5,7,128,20,42.061,-70.5163,11,5,6,8,3,"MA",0.013
"4952",514,"198491.9290.6","MA",1984,5,7,128,20,42.0058,-70.4457,2,1,1,2,0,"MA",0.013
"4953",514,"198491.9300.7","MA",1984,5,7,128,20,42.1028,-70.4155,3,2,1,3,0,"MA",0.013
"4954",514,"198491.9330.8","MA",1984,5,8,129,20,42.3055,-70.8167,9,3,6,7,2,"MA",0.013
"4955",514,"198491.9310.9","MA",1984,5,8,129,20,42.2938,-70.8688,51,16,35,34,17,"MA",0.013
"4956",514,"198491.9320.10","MA",1984,5,8,129,20,42.3007,-70.8388,21,13,8,9,12,"MA",0.013
"4957",514,"198491.9320.11","MA",1984,5,8,129,20,42.457,-70.9095,17,3,14,16,1,"MA",0.013
"4958",514,"198491.9340.12","MA",1984,5,8,129,20,42.433,-70.8597,7,3,4,7,0,"MA",0.013
"4959",514,"198491.9350.13","MA",1984,5,8,129,20,42.4642,-70.7215,1,0,1,1,0,"MA",0.013
"4960",514,"198491.9360.14","MA",1984,5,9,130,20,42.6393,-70.531,1,0,1,1,0,"MA",0.013
"4961",514,"198491.9360.15","MA",1984,5,9,130,20,42.7118,-70.5428,8,3,5,8,0,"MA",0.013
"4962",514,"198491.9350.16","MA",1984,5,9,130,20,42.7413,-70.6518,1,1,0,1,0,"MA",0.013
"4963",514,"198491.9330.17","MA",1984,5,9,130,20,42.7812,-70.7447,0,0,0,0,0,"MA",0.013
"4964",514,"198491.9320.18","MA",1984,5,9,130,20,42.7553,-70.7738,12,3,9,12,0,"MA",0.013
"4965",514,"198491.9330.19","MA",1984,5,9,130,20,42.7318,-70.7345,4,2,2,4,0,"MA",0.013
"4966",514,"198491.9310.20","MA",1984,5,9,130,20,42.6752,-70.6873,14,5,9,11,3,"MA",0.013
"4967",514,"198491.9340.21","MA",1984,5,9,130,20,42.7012,-70.6313,3,2,1,3,0,"MA",0.013
"4968",514,"198491.9350.22","MA",1984,5,9,130,20,42.6378,-70.5462,0,0,0,0,0,"MA",0.013
"4969",514,"198491.9350.23","MA",1984,5,10,131,20,42.5727,-70.5977,0,0,0,0,0,"MA",0.013
"4970",514,"198491.9340.24","MA",1984,5,10,131,20,42.5435,-70.7355,2,1,1,2,0,"MA",0.013
"4971",514,"198491.9350.25","MA",1984,5,10,131,20,42.5063,-70.7035,1,0,1,1,0,"MA",0.013
"4972",514,"198491.9360.26","MA",1984,5,10,131,20,42.5078,-70.6288,1,0,1,1,0,"MA",0.013
"4973",514,"198491.9360.27","MA",1984,5,10,131,20,42.4722,-70.6448,3,1,2,3,0,"MA",0.013
"4974",514,"198491.9270.28","MA",1984,5,11,132,20,42.0967,-70.5815,3,3,0,3,0,"MA",0.013
"4975",514,"198491.9280.29","MA",1984,5,11,132,20,41.9675,-70.5087,25,13,12,23,2,"MA",0.013
"4976",514,"198491.9290.30","MA",1984,5,11,132,20,42.0312,-70.3153,0,0,0,0,0,"MA",0.013
"4977",514,"198491.9290.31","MA",1984,5,11,132,20,41.9728,-70.3127,0,0,0,0,0,"MA",0.013
"4978",514,"198491.9250.32","MA",1984,5,11,132,20,41.7657,-70.462,0,0,0,0,0,"MA",0.013
"4979",514,"198491.9210.33","MA",1984,5,12,133,20,42.097,-70.218,2,1,1,1,1,"MA",0.013
"4980",514,"198491.9210.34","MA",1984,5,12,133,20,42.0707,-70.0155,0,0,0,0,0,"MA",0.013
"4981",521,"198491.9170.35","MA",1984,5,12,133,20,41.9825,-69.9992,1,0,1,1,0,"MA",0.013
"4982",514,"198491.9170.36","MA",1984,5,12,133,20,42.0703,-70.0978,4,2,2,3,1,"MA",0.013
"4983",514,"198491.9200.37","MA",1984,5,12,133,20,42.0987,-70.1347,1,0,1,1,0,"MA",0.013
"4984",514,"198491.9260.38","MA",1984,5,13,134,20,42.02,-70.1147,2,1,1,2,0,"MA",0.013
"4985",514,"198491.9300.39","MA",1984,5,13,134,20,42.0498,-70.2895,1,0,1,1,0,"MA",0.013
"4986",514,"198491.9270.40","MA",1984,5,13,134,20,41.9865,-70.1295,0,0,0,0,0,"MA",0.013
"4987",514,"198491.9280.41","MA",1984,5,13,134,20,41.9565,-70.2192,1,1,0,1,0,"MA",0.013
"4988",514,"198491.9280.42","MA",1984,5,13,134,20,41.9233,-70.2815,0,0,0,0,0,"MA",0.013
"4989",514,"198491.9280.43","MA",1984,5,13,134,20,41.8788,-70.4098,1,0,1,1,0,"MA",0.013
"4990",514,"198491.9250.44","MA",1984,5,14,135,20,41.7423,-70.3328,6,3,3,4,2,"MA",0.013
"4991",514,"198491.9260.45","MA",1984,5,14,135,20,41.8225,-70.1963,3,1,2,3,0,"MA",0.013
"4992",514,"198491.9250.46","MA",1984,5,14,135,20,41.8105,-70.0643,0,0,0,0,0,"MA",0.013
"4993",514,"198491.9270.47","MA",1984,5,14,135,20,41.8442,-70.2512,0,0,0,0,0,"MA",0.013
"4994",514,"198491.9260.48","MA",1984,5,14,135,20,41.8967,-70.1292,4,0,4,3,1,"MA",0.013
"4995",514,"198491.9280.49","MA",1984,5,14,135,20,41.9017,-70.1993,0,0,0,0,0,"MA",0.013
"4996",514,"198491.9270.50","MA",1984,5,14,135,20,41.8478,-70.3872,1,1,0,1,0,"MA",0.013
"4997",521,"198491.9180.66","MA",1984,5,17,138,20,41.6495,-69.8865,0,0,0,0,0,"MA",0.013
"4998",521,"198491.9190.67","MA",1984,5,17,138,20,41.6883,-69.868,0,0,0,0,0,"MA",0.013
"4999",521,"198491.9200.68","MA",1984,5,17,138,20,41.8052,-69.8765,0,0,0,0,0,"MA",0.013
"5000",521,"198491.9180.69","MA",1984,5,17,138,20,41.7957,-69.9157,3,2,1,2,1,"MA",0.013
"5001",521,"198491.9170.81","MA",1984,5,19,140,20,41.391,-69.9933,0,0,0,0,0,"MA",0.013
"5002",514,"198591.9260.1","MA",1985,5,6,126,20,41.7713,-70.4388,0,0,0,0,0,"MA",0.013
"5003",514,"198591.9270.2","MA",1985,5,6,126,20,41.8045,-70.3445,0,0,0,0,0,"MA",0.013
"5004",514,"198591.9260.3","MA",1985,5,6,126,20,41.7687,-70.3438,0,0,0,0,0,"MA",0.013
"5005",514,"198591.9270.4","MA",1985,5,7,127,20,41.8523,-70.4208,6,3,3,6,0,"MA",0.013
"5006",514,"198591.9280.5","MA",1985,5,7,127,20,41.9363,-70.4695,11,6,5,9,2,"MA",0.013
"5007",514,"198591.9260.6","MA",1985,5,7,127,20,41.9723,-70.5787,33,21,12,28,5,"MA",0.013
"5008",514,"198591.9280.7","MA",1985,5,7,127,20,42.0135,-70.5358,3,1,2,2,1,"MA",0.013
"5009",514,"198591.9250.8","MA",1985,5,7,127,20,42.0468,-70.632,157,74,83,44,113,"MA",0.013
"5010",514,"198591.9270.9","MA",1985,5,7,127,20,42.1205,-70.5623,7,4,3,6,1,"MA",0.013
"5011",514,"198591.9290.10","MA",1985,5,7,127,20,42.1258,-70.4722,4,3,1,4,0,"MA",0.013
"5012",514,"198591.9350.11","MA",1985,5,9,129,20,42.5675,-70.5982,2,1,1,2,0,"MA",0.013
"5013",514,"198591.9350.12","MA",1985,5,9,129,20,42.5952,-70.5772,8,4,4,7,1,"MA",0.013
"5014",514,"198591.9360.13","MA",1985,5,9,129,20,42.6303,-70.5107,0,0,0,0,0,"MA",0.013
"5015",514,"198591.9330.14","MA",1985,5,9,129,20,42.648,-70.5802,1,0,1,1,0,"MA",0.013
"5016",514,"198591.9350.15","MA",1985,5,9,129,20,42.6988,-70.5812,1,0,1,1,0,"MA",0.013
"5017",514,"198591.9360.16","MA",1985,5,9,129,20,42.7202,-70.5632,1,1,0,1,0,"MA",0.013
"5018",514,"198591.9330.17","MA",1985,5,9,129,20,42.7467,-70.728,1,1,0,1,0,"MA",0.013
"5019",514,"198591.9340.18","MA",1985,5,9,129,20,42.826,-70.7467,0,0,0,0,0,"MA",0.013
"5020",514,"198591.9320.19","MA",1985,5,9,129,20,42.77,-70.7902,8,4,4,5,3,"MA",0.013
"5021",514,"198591.9310.20","MA",1985,5,9,129,20,42.7303,-70.7748,10,3,7,8,2,"MA",0.013
"5022",514,"198591.9340.21","MA",1985,5,10,130,20,42.5505,-70.7198,4,2,2,4,0,"MA",0.013
"5023",514,"198591.9320.22","MA",1985,5,10,130,20,42.5385,-70.8332,77,24,53,61,16,"MA",0.013
"5024",514,"198591.9340.23","MA",1985,5,10,130,20,42.4413,-70.8575,14,7,7,10,4,"MA",0.013
"5025",514,"198591.9320.24","MA",1985,5,10,130,20,42.4415,-70.9017,63,27,36,53,10,"MA",0.013
"5026",514,"198591.9310.25","MA",1985,5,10,130,20,42.4557,-70.9183,93,32,61,72,21,"MA",0.013
"5027",514,"198591.9330.26","MA",1985,5,10,130,20,42.3062,-70.8163,16,8,8,12,4,"MA",0.013
"5028",514,"198591.9310.27","MA",1985,5,10,130,20,42.2915,-70.8667,98,35,63,43,55,"MA",0.013
"5029",514,"198591.9360.28","MA",1985,5,11,131,20,42.4727,-70.6423,0,0,0,0,0,"MA",0.013
"5030",514,"198591.9350.29","MA",1985,5,11,131,20,42.4718,-70.7288,1,0,1,1,0,"MA",0.013
"5031",514,"198591.9300.30","MA",1985,5,11,131,20,42.0783,-70.3722,0,0,0,0,0,"MA",0.013
"5032",514,"198591.9290.31","MA",1985,5,11,131,20,41.978,-70.4362,4,1,3,4,0,"MA",0.013
"5033",514,"198591.9290.32","MA",1985,5,11,131,20,41.9397,-70.3742,3,2,1,3,0,"MA",0.013
"5034",514,"198591.9250.33","MA",1985,5,12,132,20,41.7523,-70.4235,1,0,1,0,1,"MA",0.013
"5035",514,"198591.9280.34","MA",1985,5,12,132,20,41.9005,-70.3522,0,0,0,0,0,"MA",0.013
"5036",514,"198591.9280.35","MA",1985,5,12,132,20,41.9423,-70.2473,1,1,0,1,0,"MA",0.013
"5037",514,"198591.9280.36","MA",1985,5,12,132,20,41.9007,-70.193,0,0,0,0,0,"MA",0.013
"5038",514,"198591.9260.37","MA",1985,5,12,132,20,41.859,-70.1845,1,0,1,1,0,"MA",0.013
"5039",514,"198591.9270.38","MA",1985,5,12,132,20,41.8515,-70.2312,3,1,2,3,0,"MA",0.013
"5040",514,"198591.9260.39","MA",1985,5,12,132,20,41.8302,-70.1205,0,0,0,0,0,"MA",0.013
"5041",514,"198591.9290.40","MA",1985,5,13,133,20,41.9792,-70.307,0,0,0,0,0,"MA",0.013
"5042",514,"198591.9300.41","MA",1985,5,13,133,20,42.0772,-70.3135,0,0,0,0,0,"MA",0.013
"5043",514,"198591.9210.42","MA",1985,5,13,133,20,42.1132,-70.2167,1,0,1,1,0,"MA",0.013
"5044",514,"198591.9210.43","MA",1985,5,13,133,20,42.0687,-70.0078,0,0,0,0,0,"MA",0.013
"5045",514,"198591.9200.44","MA",1985,5,13,133,20,42.1018,-70.16,1,0,1,1,0,"MA",0.013
"5046",514,"198591.9170.46","MA",1985,5,14,134,20,42.0685,-70.105,4,1,3,3,1,"MA",0.013
"5047",521,"198591.9180.47","MA",1985,5,14,134,20,41.98,-69.9913,5,4,1,3,2,"MA",0.013
"5048",521,"198591.9170.48","MA",1985,5,14,134,13,41.9038,-69.958,1,1,0,0,1,"MA",0.013
"5049",521,"198591.9180.77","MA",1985,5,19,139,20,41.659,-69.9067,0,0,0,0,0,"MA",0.013
"5050",521,"198591.9190.78","MA",1985,5,19,139,20,41.7157,-69.8577,0,0,0,0,0,"MA",0.013
"5051",521,"198591.9200.79","MA",1985,5,19,139,20,41.767,-69.8665,0,0,0,0,0,"MA",0.013
"5052",521,"198591.9170.84","MA",1985,5,20,140,20,41.3792,-69.9905,1,1,0,0,1,"MA",0.013
"5053",514,"198691.9260.1","MA",1986,5,5,125,20,41.773,-70.4292,1,0,1,0,1,"MA",0.013
"5054",514,"198691.9270.2","MA",1986,5,5,125,20,41.8085,-70.369,0,0,0,0,0,"MA",0.013
"5055",514,"198691.9260.3","MA",1986,5,6,126,20,41.849,-70.4932,1,0,1,1,0,"MA",0.013
"5056",514,"198691.9270.4","MA",1986,5,6,126,20,41.9565,-70.5363,15,10,5,12,3,"MA",0.013
"5057",514,"198691.9280.5","MA",1986,5,6,126,20,42.0045,-70.526,45,24,21,41,4,"MA",0.013
"5058",514,"198691.9250.6","MA",1986,5,6,126,20,42.0218,-70.61,5,2,3,4,1,"MA",0.013
"5059",514,"198691.9290.7","MA",1986,5,6,126,20,42.0597,-70.51,21,9,12,21,0,"MA",0.013
"5060",514,"198691.9270.8","MA",1986,5,6,126,20,42.092,-70.566,1,1,0,1,0,"MA",0.013
"5061",514,"198691.9320.9","MA",1986,5,7,127,13,42.292,-70.8617,64,23,41,44,20,"MA",0.013
"5062",514,"198691.9310.10","MA",1986,5,7,127,20,42.4525,-70.9192,9,1,8,7,2,"MA",0.013
"5063",514,"198691.9330.11","MA",1986,5,7,127,15,42.4465,-70.8877,6,2,4,5,1,"MA",0.013
"5064",514,"198691.9320.12","MA",1986,5,7,127,20,42.444,-70.9092,42,13,29,39,3,"MA",0.013
"5065",514,"198691.9340.13","MA",1986,5,7,127,14,42.427,-70.8337,15,7,8,14,1,"MA",0.013
"5066",514,"198691.9350.14","MA",1986,5,7,127,20,42.5243,-70.7125,0,0,0,0,0,"MA",0.013
"5067",514,"198691.9360.15","MA",1986,5,7,127,20,42.5088,-70.6367,4,2,2,4,0,"MA",0.013
"5068",514,"198691.9340.17","MA",1986,5,8,128,13,42.7302,-70.6612,0,0,0,0,0,"MA",0.013
"5069",514,"198691.9310.18","MA",1986,5,8,128,20,42.694,-70.7297,14,7,7,13,1,"MA",0.013
"5070",514,"198691.9310.19","MA",1986,5,8,128,20,42.7408,-70.7803,3,1,2,3,0,"MA",0.013
"5071",514,"198691.9330.20","MA",1986,5,8,128,14,42.7533,-70.753,0,0,0,0,0,"MA",0.013
"5072",514,"198691.9320.21","MA",1986,5,8,128,13,42.7325,-70.7508,4,0,4,4,0,"MA",0.013
"5073",514,"198691.9360.22","MA",1986,5,10,130,13,42.626,-70.5323,1,1,0,1,0,"MA",0.013
"5074",514,"198691.9350.23","MA",1986,5,10,130,18,42.5767,-70.6015,0,0,0,0,0,"MA",0.013
"5075",514,"198691.9350.24","MA",1986,5,10,130,15,42.5722,-70.5975,1,1,0,1,0,"MA",0.013
"5076",514,"198691.9360.25","MA",1986,5,10,130,17,42.5325,-70.6178,0,0,0,0,0,"MA",0.013
"5077",514,"198691.9340.26","MA",1986,5,10,130,16,42.5415,-70.732,1,1,0,1,0,"MA",0.013
"5078",514,"198691.9290.27","MA",1986,5,11,131,20,41.9547,-70.4473,21,8,13,20,1,"MA",0.013
"5079",514,"198691.9290.28","MA",1986,5,11,131,20,41.971,-70.3312,16,6,10,16,0,"MA",0.013
"5080",514,"198691.9270.29","MA",1986,5,11,131,20,41.925,-70.1498,0,0,0,0,0,"MA",0.013
"5081",514,"198691.9280.30","MA",1986,5,11,131,20,41.9073,-70.1858,2,1,1,2,0,"MA",0.013
"5082",514,"198691.9260.31","MA",1986,5,11,131,20,41.811,-70.1992,0,0,0,0,0,"MA",0.013
"5083",514,"198691.9260.32","MA",1986,5,11,131,13,41.785,-70.26,1,0,1,1,0,"MA",0.013
"5084",521,"198691.9170.60","MA",1986,5,16,136,20,41.4025,-69.9773,0,0,0,0,0,"MA",0.013
"5085",521,"198691.9170.77","MA",1986,5,18,138,20,41.5883,-69.9293,0,0,0,0,0,"MA",0.013
"5086",521,"198691.9180.78","MA",1986,5,19,139,15,41.6642,-69.9008,1,1,0,1,0,"MA",0.013
"5087",521,"198691.9170.79","MA",1986,5,19,139,20,41.9338,-69.9648,12,3,9,10,2,"MA",0.013
"5088",521,"198691.9190.80","MA",1986,5,19,139,17,41.9907,-69.982,0,0,0,0,0,"MA",0.013
"5089",514,"198691.9170.81","MA",1986,5,19,139,18,42.005,-70.0118,15,9,6,8,7,"MA",0.013
"5090",514,"198691.9180.82","MA",1986,5,19,139,20,42.04,-70.0377,4,2,2,3,1,"MA",0.013
"5091",514,"198691.9200.83","MA",1986,5,19,139,20,42.0657,-70.0318,0,0,0,0,0,"MA",0.013
"5092",514,"198691.9200.84","MA",1986,5,19,139,20,42.1013,-70.1608,0,0,0,0,0,"MA",0.013
"5093",514,"198691.9300.85","MA",1986,5,20,140,20,42.1075,-70.2847,0,0,0,0,0,"MA",0.013
"5094",514,"198691.9210.86","MA",1986,5,20,140,20,42.1147,-70.2488,0,0,0,0,0,"MA",0.013
"5095",514,"198691.9210.87","MA",1986,5,20,140,20,42.103,-70.185,4,2,2,4,0,"MA",0.013
"5096",514,"198691.9300.88","MA",1986,5,20,140,20,42.079,-70.3213,0,0,0,0,0,"MA",0.013
"5097",514,"198691.9290.89","MA",1986,5,20,140,20,42.0117,-70.3092,0,0,0,0,0,"MA",0.013
"5098",514,"198691.9290.90","MA",1986,5,20,140,20,41.9837,-70.3932,0,0,0,0,0,"MA",0.013
"5099",514,"198691.9280.91","MA",1986,5,20,140,20,41.8957,-70.3132,6,1,5,5,1,"MA",0.013
"5100",514,"198691.9250.92","MA",1986,5,21,141,20,41.7458,-70.3858,4,2,2,4,0,"MA",0.013
"5101",514,"198691.9280.93","MA",1986,5,21,141,20,41.8713,-70.4302,17,3,14,13,4,"MA",0.013
"5102",514,"198791.9250.13","MA",1987,5,6,126,20,41.7588,-70.4438,5,2,3,2,3,"MA",0.013
"5103",514,"198791.9270.14","MA",1987,5,7,127,20,41.8853,-70.4773,15,10,5,7,8,"MA",0.013
"5104",514,"198791.9270.15","MA",1987,5,7,127,13,41.9182,-70.4983,20,9,11,11,9,"MA",0.013
"5105",514,"198791.9250.16","MA",1987,5,7,127,20,41.9633,-70.6037,6,3,3,4,2,"MA",0.013
"5106",514,"198791.9270.17","MA",1987,5,7,127,20,42.0493,-70.56,7,4,3,6,1,"MA",0.013
"5107",514,"198791.9280.18","MA",1987,5,7,127,20,42.0902,-70.5447,3,1,2,3,0,"MA",0.013
"5108",514,"198791.9250.19","MA",1987,5,7,127,20,42.1498,-70.688,15,5,10,9,6,"MA",0.013
"5109",514,"198791.9320.20","MA",1987,5,7,127,20,42.3065,-70.8098,89,36,53,71,18,"MA",0.013
"5110",514,"198791.9310.21","MA",1987,5,7,127,17,42.2917,-70.8683,12,4,8,9,3,"MA",0.013
"5111",514,"198791.9340.22","MA",1987,5,8,128,20,42.439,-70.8648,15,5,10,14,1,"MA",0.013
"5112",514,"198791.9320.23","MA",1987,5,8,128,13,42.4582,-70.91,8,0,8,8,0,"MA",0.013
"5113",514,"198791.9330.24","MA",1987,5,8,128,15,42.4488,-70.8795,6,3,3,6,0,"MA",0.013
"5114",514,"198791.9350.25","MA",1987,5,8,128,13,42.4598,-70.7137,0,0,0,0,0,"MA",0.013
"5115",514,"198791.9350.26","MA",1987,5,8,128,20,42.5248,-70.7083,2,1,1,2,0,"MA",0.013
"5116",514,"198791.9340.27","MA",1987,5,8,128,17,42.5498,-70.725,3,2,1,3,0,"MA",0.013
"5117",514,"198791.9360.28","MA",1987,5,8,128,19,42.6327,-70.5202,1,1,0,1,0,"MA",0.013
"5118",514,"198791.9360.29","MA",1987,5,9,129,20,42.7097,-70.5553,3,1,2,3,0,"MA",0.013
"5119",514,"198791.9350.30","MA",1987,5,9,129,20,42.7257,-70.627,1,1,0,1,0,"MA",0.013
"5120",514,"198791.9350.31","MA",1987,5,9,129,20,42.7347,-70.6587,1,0,1,1,0,"MA",0.013
"5121",514,"198791.9330.32","MA",1987,5,9,129,20,42.7,-70.6983,4,1,3,3,1,"MA",0.013
"5122",514,"198791.9310.33","MA",1987,5,9,129,20,42.7102,-70.747,7,5,2,5,2,"MA",0.013
"5123",514,"198791.9320.34","MA",1987,5,9,129,20,42.7712,-70.7732,0,0,0,0,0,"MA",0.013
"5124",514,"198791.9310.35","MA",1987,5,9,129,20,42.7757,-70.7958,4,4,0,2,2,"MA",0.013
"5125",513,"198791.9330.36","MA",1987,5,9,129,20,42.8542,-70.7797,1,1,0,1,0,"MA",0.013
"5126",514,"198791.9340.37","MA",1987,5,9,129,20,42.8215,-70.7433,0,0,0,0,0,"MA",0.013
"5127",514,"198791.9360.38","MA",1987,5,10,130,20,42.4833,-70.625,2,1,1,2,0,"MA",0.013
"5128",514,"198791.9360.39","MA",1987,5,10,130,20,42.4175,-70.6573,2,1,1,2,0,"MA",0.013
"5129",514,"198791.9350.40","MA",1987,5,10,130,16,42.3828,-70.7002,7,5,2,7,0,"MA",0.013
"5130",514,"198791.9290.41","MA",1987,5,11,131,20,42.1038,-70.478,6,3,3,6,0,"MA",0.013
"5131",514,"198791.9290.42","MA",1987,5,11,131,13,42.0298,-70.4565,1,1,0,1,0,"MA",0.013
"5132",514,"198791.9290.43","MA",1987,5,11,131,20,41.9995,-70.3685,2,0,2,2,0,"MA",0.013
"5133",514,"198791.9280.44","MA",1987,5,11,131,20,41.9435,-70.4755,7,4,3,6,1,"MA",0.013
"5134",514,"198791.9280.45","MA",1987,5,11,131,20,41.913,-70.4008,13,8,5,7,6,"MA",0.013
"5135",514,"198791.9260.46","MA",1987,5,11,131,20,41.8372,-70.4947,2,2,0,2,0,"MA",0.013
"5136",514,"198791.9260.47","MA",1987,5,12,132,20,41.7858,-70.2708,10,4,6,9,1,"MA",0.013
"5137",514,"198791.9270.48","MA",1987,5,12,132,20,41.8437,-70.2642,0,0,0,0,0,"MA",0.013
"5138",514,"198791.9260.49","MA",1987,5,12,132,20,41.8447,-70.1733,4,2,2,4,0,"MA",0.013
"5139",514,"198791.9260.50","MA",1987,5,12,132,20,41.9047,-70.1175,1,0,1,1,0,"MA",0.013
"5140",514,"198791.9270.51","MA",1987,5,12,132,20,41.9403,-70.144,1,0,1,1,0,"MA",0.013
"5141",514,"198791.9290.52","MA",1987,5,12,132,20,42.0075,-70.2353,0,0,0,0,0,"MA",0.013
"5142",514,"198791.9280.53","MA",1987,5,12,132,20,41.9285,-70.2007,0,0,0,0,0,"MA",0.013
"5143",514,"198791.9280.54","MA",1987,5,12,132,20,41.8827,-70.2743,1,0,1,1,0,"MA",0.013
"5144",514,"198791.9290.55","MA",1987,5,13,133,20,42.0337,-70.3115,2,0,2,2,0,"MA",0.013
"5145",514,"198791.9300.56","MA",1987,5,13,133,20,42.0848,-70.314,3,1,2,3,0,"MA",0.013
"5146",514,"198791.9210.57","MA",1987,5,13,133,19,42.1017,-70.2062,0,0,0,0,0,"MA",0.013
"5147",514,"198791.9200.58","MA",1987,5,13,133,20,42.1023,-70.1395,1,0,1,1,0,"MA",0.013
"5148",514,"198791.9210.59","MA",1987,5,13,133,13,42.081,-70.0383,0,0,0,0,0,"MA",0.013
"5149",514,"198791.9180.60","MA",1987,5,13,133,20,42.0243,-70.0185,0,0,0,0,0,"MA",0.013
"5150",514,"198791.9170.61","MA",1987,5,13,133,20,42.0838,-70.14,5,2,3,3,2,"MA",0.013
"5151",514,"198791.9300.62","MA",1987,5,13,133,20,42.0772,-70.2665,1,0,1,1,0,"MA",0.013
"5152",514,"198791.9270.63","MA",1987,5,13,133,20,42.0272,-70.1303,0,0,0,0,0,"MA",0.013
"5153",521,"198791.9170.64","MA",1987,5,14,134,20,41.8575,-69.9383,4,1,3,3,1,"MA",0.013
"5154",521,"198791.9190.65","MA",1987,5,14,134,20,41.824,-69.9125,1,1,0,1,0,"MA",0.013
"5155",521,"198791.9200.66","MA",1987,5,14,134,20,41.835,-69.888,0,0,0,0,0,"MA",0.013
"5156",521,"198791.9180.67","MA",1987,5,14,134,20,41.7215,-69.897,0,0,0,0,0,"MA",0.013
"5157",521,"198791.9180.79","MA",1987,5,16,136,20,41.3862,-69.9675,1,0,1,1,0,"MA",0.013
"5158",521,"198791.9170.80","MA",1987,5,16,136,20,41.404,-69.9758,0,0,0,0,0,"MA",0.013
"5159",514,"198891.9260.1","MA",1988,5,9,130,20,41.7792,-70.1693,3,1,2,1,2,"MA",0.013
"5160",514,"198891.9250.2","MA",1988,5,9,130,20,41.747,-70.29,1,0,1,0,1,"MA",0.013
"5161",514,"198891.9270.3","MA",1988,5,9,130,20,41.809,-70.309,11,3,8,8,3,"MA",0.013
"5162",514,"198891.9270.4","MA",1988,5,10,131,14,41.8817,-70.4803,22,11,11,13,9,"MA",0.013
"5163",514,"198891.9250.5","MA",1988,5,10,131,20,41.9648,-70.621,37,12,25,27,10,"MA",0.013
"5164",514,"198891.9330.6","MA",1988,5,10,131,15,42.3067,-70.8072,28,10,18,18,10,"MA",0.013
"5165",514,"198891.9310.7","MA",1988,5,10,131,15,42.2923,-70.8642,96,30,66,48,48,"MA",0.013
"5166",514,"198891.9320.8","MA",1988,5,11,132,20,42.4575,-70.915,3,1,2,2,1,"MA",0.013
"5167",514,"198891.9340.9","MA",1988,5,11,132,17,42.4383,-70.8542,15,10,5,13,2,"MA",0.013
"5168",514,"198891.9350.10","MA",1988,5,11,132,13,42.46,-70.7185,1,1,0,1,0,"MA",0.013
"5169",514,"198891.9340.11","MA",1988,5,11,132,15,42.5495,-70.7243,2,1,1,2,0,"MA",0.013
"5170",514,"198891.9350.12","MA",1988,5,11,132,20,42.5115,-70.7153,3,2,1,2,1,"MA",0.013
"5171",514,"198891.9360.13","MA",1988,5,12,133,20,42.6305,-70.5267,1,1,0,1,0,"MA",0.013
"5172",514,"198891.9360.14","MA",1988,5,12,133,20,42.7168,-70.5645,0,0,0,0,0,"MA",0.013
"5173",514,"198891.9330.15","MA",1988,5,12,133,20,42.6995,-70.6713,1,1,0,1,0,"MA",0.013
"5174",514,"198891.9310.16","MA",1988,5,12,133,20,42.6793,-70.7065,2,0,2,2,0,"MA",0.013
"5175",514,"198891.9310.17","MA",1988,5,12,133,20,42.7597,-70.7862,6,2,4,5,1,"MA",0.013
"5176",514,"198891.9320.18","MA",1988,5,12,133,20,42.7835,-70.7877,37,15,22,30,7,"MA",0.013
"5177",514,"198891.9330.19","MA",1988,5,12,133,20,42.7773,-70.7592,2,0,2,2,0,"MA",0.013
"5178",514,"198891.9350.20","MA",1988,5,12,133,20,42.72,-70.6365,0,0,0,0,0,"MA",0.013
"5179",514,"198891.9340.21","MA",1988,5,12,133,20,42.699,-70.5992,0,0,0,0,0,"MA",0.013
"5180",514,"198891.9350.22","MA",1988,5,13,134,20,42.5842,-70.5877,3,1,2,3,0,"MA",0.013
"5181",514,"198891.9360.23","MA",1988,5,13,134,20,42.4778,-70.6285,1,0,1,1,0,"MA",0.013
"5182",514,"198891.9300.24","MA",1988,5,14,135,20,42.0923,-70.4173,1,0,1,1,0,"MA",0.013
"5183",514,"198891.9290.25","MA",1988,5,14,135,20,42.0535,-70.4455,2,1,1,2,0,"MA",0.013
"5184",514,"198891.9280.26","MA",1988,5,14,135,20,41.9965,-70.5392,2,1,1,2,0,"MA",0.013
"5185",514,"198891.9290.27","MA",1988,5,14,135,20,41.9992,-70.4035,2,0,2,2,0,"MA",0.013
"5186",514,"198891.9290.28","MA",1988,5,14,135,20,41.9578,-70.3415,0,0,0,0,0,"MA",0.013
"5187",514,"198891.9280.29","MA",1988,5,14,135,20,41.924,-70.3458,1,0,1,1,0,"MA",0.013
"5188",514,"198891.9280.30","MA",1988,5,14,135,20,41.8683,-70.4345,14,6,8,12,2,"MA",0.013
"5189",514,"198891.9260.31","MA",1988,5,15,136,20,41.8082,-70.4673,12,4,8,9,3,"MA",0.013
"5190",514,"198891.9260.32","MA",1988,5,15,136,20,41.8423,-70.1748,5,2,3,5,0,"MA",0.013
"5191",514,"198891.9280.33","MA",1988,5,15,136,20,41.9098,-70.2422,0,0,0,0,0,"MA",0.013
"5192",514,"198891.9280.34","MA",1988,5,15,136,20,41.9842,-70.1857,0,0,0,0,0,"MA",0.013
"5193",514,"198891.9290.35","MA",1988,5,15,136,20,42.0267,-70.281,0,0,0,0,0,"MA",0.013
"5194",514,"198891.9300.36","MA",1988,5,15,136,20,42.0643,-70.3478,0,0,0,0,0,"MA",0.013
"5195",514,"198891.9290.37","MA",1988,5,15,136,20,41.9955,-70.2978,0,0,0,0,0,"MA",0.013
"5196",514,"198891.9260.38","MA",1988,5,16,137,20,41.7658,-70.349,5,2,3,5,0,"MA",0.013
"5197",514,"198891.9270.39","MA",1988,5,16,137,20,41.9262,-70.1535,3,2,1,3,0,"MA",0.013
"5198",514,"198891.9270.40","MA",1988,5,16,137,13,42.0265,-70.1523,0,0,0,0,0,"MA",0.013
"5199",514,"198891.9250.41","MA",1988,5,16,137,20,42.0467,-70.1473,2,1,1,2,0,"MA",0.013
"5200",514,"198891.9260.42","MA",1988,5,16,137,20,41.9497,-70.1147,2,1,1,2,0,"MA",0.013
"5201",514,"198891.9210.43","MA",1988,5,17,138,20,42.1028,-70.2103,2,1,1,1,1,"MA",0.013
"5202",514,"198891.9180.44","MA",1988,5,17,138,20,42.0818,-70.1162,0,0,0,0,0,"MA",0.013
"5203",514,"198891.9200.45","MA",1988,5,17,138,20,42.0535,-70.0165,0,0,0,0,0,"MA",0.013
"5204",514,"198891.9210.46","MA",1988,5,17,138,20,42.0847,-70.0385,1,1,0,1,0,"MA",0.013
"5205",514,"198891.9170.47","MA",1988,5,17,138,20,42.0482,-70.0587,1,0,1,1,0,"MA",0.013
"5206",521,"198891.9170.48","MA",1988,5,18,139,20,41.9358,-69.9692,0,0,0,0,0,"MA",0.013
"5207",521,"198891.9200.49","MA",1988,5,18,139,20,41.8187,-69.8855,0,0,0,0,0,"MA",0.013
"5208",521,"198891.9190.50","MA",1988,5,18,139,19,41.824,-69.9137,0,0,0,0,0,"MA",0.013
"5209",521,"198891.9170.67","MA",1988,5,21,142,15,41.3353,-69.9817,2,1,1,1,1,"MA",0.013
"5210",514,"198991.9270.1","MA",1989,5,8,128,16,41.7827,-70.423,4,3,1,4,0,"MA",0.013
"5211",514,"198991.9260.2","MA",1989,5,8,128,18.5,41.7707,-70.3272,4,3,1,4,0,"MA",0.013
"5212",514,"198991.9260.3","MA",1989,5,9,129,20,41.856,-70.5015,8,4,4,7,1,"MA",0.013
"5213",514,"198991.9250.4","MA",1989,5,9,129,20,41.9735,-70.6008,14,8,6,11,3,"MA",0.013
"5214",514,"198991.9260.5","MA",1989,5,9,129,20,41.9845,-70.5752,22,12,10,22,0,"MA",0.013
"5215",514,"198991.9280.6","MA",1989,5,9,129,20,41.9955,-70.5428,16,6,10,9,7,"MA",0.013
"5216",514,"198991.9280.7","MA",1989,5,9,129,20,42.0965,-70.5447,3,2,1,3,0,"MA",0.013
"5217",514,"198991.9310.8","MA",1989,5,9,129,15,42.2927,-70.8673,10,2,8,4,6,"MA",0.013
"5218",514,"198991.9320.9","MA",1989,5,10,130,16,42.2927,-70.8597,195,93,102,130,65,"MA",0.013
"5219",514,"198991.9320.10","MA",1989,5,10,130,13,42.4517,-70.9053,89,46,43,73,16,"MA",0.013
"5220",514,"198991.9330.11","MA",1989,5,10,130,18,42.4513,-70.8775,35,19,16,33,2,"MA",0.013
"5221",514,"198991.9350.12","MA",1989,5,10,130,20,42.4637,-70.7215,5,3,2,5,0,"MA",0.013
"5222",514,"198991.9350.13","MA",1989,5,10,130,20,42.5237,-70.7153,1,0,1,1,0,"MA",0.013
"5223",514,"198991.9340.14","MA",1989,5,10,130,18.5,42.5492,-70.7227,0,0,0,0,0,"MA",0.013
"5224",514,"198991.9350.15","MA",1989,5,10,130,20,42.5672,-70.6145,3,2,1,3,0,"MA",0.013
"5225",514,"198991.9360.16","MA",1989,5,10,130,20,42.5328,-70.606,1,0,1,1,0,"MA",0.013
"5226",514,"198991.9270.25","MA",1989,5,13,133,20,41.8575,-70.4533,10,5,5,9,1,"MA",0.013
"5227",514,"198991.9290.26","MA",1989,5,13,133,20,41.9448,-70.399,4,2,2,4,0,"MA",0.013
"5228",514,"198991.9290.27","MA",1989,5,13,133,20,42.0632,-70.4667,0,0,0,0,0,"MA",0.013
"5229",514,"198991.9300.28","MA",1989,5,13,133,20,42.0707,-70.3287,2,0,2,2,0,"MA",0.013
"5230",514,"198991.9290.29","MA",1989,5,13,133,13,41.9528,-70.2762,0,0,0,0,0,"MA",0.013
"5231",514,"198991.9280.30","MA",1989,5,13,133,20,41.8718,-70.2407,1,0,1,1,0,"MA",0.013
"5232",514,"198991.9280.31","MA",1989,5,14,134,20,41.8715,-70.414,11,8,3,10,1,"MA",0.013
"5233",514,"198991.9290.32","MA",1989,5,14,134,20,41.957,-70.3478,2,1,1,2,0,"MA",0.013
"5234",514,"198991.9290.33","MA",1989,5,14,134,20,42.0718,-70.4327,1,0,1,1,0,"MA",0.013
"5235",514,"198991.9300.34","MA",1989,5,14,134,20,42.0513,-70.2792,1,0,1,1,0,"MA",0.013
"5236",514,"198991.9270.35","MA",1989,5,14,134,20,41.9263,-70.1613,3,1,2,2,1,"MA",0.013
"5237",514,"198991.9270.36","MA",1989,5,14,134,20,41.8538,-70.2833,2,0,2,2,0,"MA",0.013
"5238",514,"198991.9250.37","MA",1989,5,15,135,19,41.7427,-70.3298,8,3,5,8,0,"MA",0.013
"5239",514,"198991.9260.38","MA",1989,5,15,135,20,41.846,-70.1692,5,3,2,5,0,"MA",0.013
"5240",514,"198991.9260.39","MA",1989,5,15,135,20,41.8828,-70.1442,0,0,0,0,0,"MA",0.013
"5241",514,"198991.9260.40","MA",1989,5,15,135,20,41.942,-70.1195,1,1,0,1,0,"MA",0.013
"5242",514,"198991.9270.41","MA",1989,5,15,135,20,41.9788,-70.1372,0,0,0,0,0,"MA",0.013
"5243",514,"198991.9250.42","MA",1989,5,15,135,13,42.0403,-70.1232,21,9,12,21,0,"MA",0.013
"5244",514,"198991.9280.43","MA",1989,5,15,135,20,41.9232,-70.292,2,1,1,2,0,"MA",0.013
"5245",514,"198991.9210.44","MA",1989,5,16,136,20,42.0982,-70.2142,3,1,2,3,0,"MA",0.013
"5246",514,"198991.9210.45","MA",1989,5,16,136,20,42.0697,-70.0123,0,0,0,0,0,"MA",0.013
"5247",514,"198991.9170.46","MA",1989,5,16,136,20,41.996,-70.008,12,6,6,8,4,"MA",0.013
"5248",514,"198991.9180.47","MA",1989,5,16,136,20,42.0372,-70.0307,0,0,0,0,0,"MA",0.013
"5249",514,"198991.9200.48","MA",1989,5,17,137,20,42.1003,-70.1692,1,0,1,1,0,"MA",0.013
"5250",521,"198991.9190.49","MA",1989,5,17,137,20,41.8207,-69.9115,0,0,0,0,0,"MA",0.013
"5251",521,"198991.9200.50","MA",1989,5,17,137,20,41.8163,-69.8893,0,0,0,0,0,"MA",0.013
"5252",521,"198991.9170.51","MA",1989,5,17,137,20,41.7783,-69.9223,6,4,2,4,2,"MA",0.013
"5253",521,"198991.9180.52","MA",1989,5,17,137,13,41.6573,-69.9018,0,0,0,0,0,"MA",0.013
"5254",521,"198991.9170.67","MA",1989,5,20,140,20,41.397,-69.991,2,2,0,1,1,"MA",0.013
"5255",514,"198991.9360.87","MA",1989,5,23,143,16.5,42.469,-70.6332,0,0,0,0,0,"MA",0.013
"5256",514,"198991.9360.88","MA",1989,5,23,143,20,42.5112,-70.6405,0,0,0,0,0,"MA",0.013
"5257",514,"198991.9340.89","MA",1989,5,23,143,13,42.5457,-70.7322,0,0,0,0,0,"MA",0.013
"5258",514,"198991.9360.90","MA",1989,5,24,144,20,42.6273,-70.5353,3,0,3,3,0,"MA",0.013
"5259",514,"198991.9350.91","MA",1989,5,24,144,20,42.7057,-70.6078,1,0,1,1,0,"MA",0.013
"5260",514,"198991.9340.92","MA",1989,5,24,144,20,42.7305,-70.6765,2,0,2,2,0,"MA",0.013
"5261",514,"198991.9310.93","MA",1989,5,24,144,20,42.7478,-70.7797,9,2,7,8,1,"MA",0.013
"5262",514,"198991.9310.94","MA",1989,5,24,144,19,42.7693,-70.7938,30,14,16,28,2,"MA",0.013
"5263",514,"198991.9330.95","MA",1989,5,24,144,20,42.7813,-70.763,0,0,0,0,0,"MA",0.013
"5264",514,"198991.9330.96","MA",1989,5,24,144,20,42.6985,-70.6932,1,1,0,1,0,"MA",0.013
"5265",514,"198991.9320.97","MA",1989,5,24,144,15.5,42.7057,-70.7358,0,0,0,0,0,"MA",0.013
"5266",514,"199091.9270.1","MA",1990,5,7,127,20,41.8703,-70.4747,18,8,10,12,6,"MA",0.013
"5267",514,"199091.9270.2","MA",1990,5,7,127,20,41.8332,-70.3675,6,2,4,4,2,"MA",0.013
"5268",514,"199091.9250.3","MA",1990,5,8,128,20,41.834,-70.5152,8,5,3,8,0,"MA",0.013
"5269",514,"199091.9260.4","MA",1990,5,8,128,20,41.9863,-70.5853,39,17,22,28,11,"MA",0.013
"5270",514,"199091.9250.5","MA",1990,5,8,128,20,41.9803,-70.6013,37,14,23,26,11,"MA",0.013
"5271",514,"199091.9280.6","MA",1990,5,8,128,20,42.007,-70.5368,10,7,3,7,3,"MA",0.013
"5272",514,"199091.9280.7","MA",1990,5,8,128,20,42.0955,-70.5403,6,4,2,6,0,"MA",0.013
"5273",514,"199091.9320.8","MA",1990,5,9,129,20,42.303,-70.8292,168,75,93,116,52,"MA",0.013
"5274",514,"199091.9310.9","MA",1990,5,9,129,18,42.2925,-70.8633,711,328,383,222,489,"MA",0.013
"5275",514,"199091.9320.10","MA",1990,5,9,129,14,42.4533,-70.9102,59,17,42,36,23,"MA",0.013
"5276",514,"199091.9330.11","MA",1990,5,9,129,20,42.4477,-70.8805,50,23,27,46,4,"MA",0.013
"5277",514,"199091.9350.12","MA",1990,5,9,129,20,42.5197,-70.7105,11,8,3,9,2,"MA",0.013
"5278",514,"199091.9340.13","MA",1990,5,9,129,20,42.5483,-70.7195,8,5,3,6,2,"MA",0.013
"5279",514,"199091.9350.14","MA",1990,5,9,129,20,42.5918,-70.5818,11,6,5,10,1,"MA",0.013
"5280",514,"199091.9360.15","MA",1990,5,11,131,20,42.7302,-70.6077,2,1,1,1,1,"MA",0.013
"5281",514,"199091.9350.16","MA",1990,5,11,131,20,42.7357,-70.6395,5,3,2,5,0,"MA",0.013
"5282",514,"199091.9340.17","MA",1990,5,11,131,20,42.7108,-70.672,5,3,2,5,0,"MA",0.013
"5283",514,"199091.9320.18","MA",1990,5,11,131,20,42.7218,-70.7398,4,2,2,4,0,"MA",0.013
"5284",514,"199091.9310.19","MA",1990,5,11,131,20,42.7478,-70.7793,29,15,14,23,6,"MA",0.013
"5285",514,"199091.9310.20","MA",1990,5,11,131,20,42.7848,-70.7937,78,28,50,61,17,"MA",0.013
"5286",514,"199091.9330.21","MA",1990,5,11,131,20,42.7793,-70.7575,1,1,0,1,0,"MA",0.013
"5287",514,"199091.9330.22","MA",1990,5,11,131,16,42.7337,-70.7228,0,0,0,0,0,"MA",0.013
"5288",514,"199091.9360.23","MA",1990,5,12,132,20,42.4835,-70.6523,7,1,6,7,0,"MA",0.013
"5289",514,"199091.9360.24","MA",1990,5,12,132,20,42.4657,-70.6357,8,6,2,8,0,"MA",0.013
"5290",514,"199091.9350.25","MA",1990,5,12,132,20,42.3738,-70.694,2,2,0,2,0,"MA",0.013
"5291",514,"199091.9300.26","MA",1990,5,12,132,20,42.0968,-70.4005,3,0,3,3,0,"MA",0.013
"5292",514,"199091.9290.27","MA",1990,5,12,132,20,42.014,-70.427,4,0,4,4,0,"MA",0.013
"5293",514,"199091.9270.28","MA",1990,5,13,133,20,41.8423,-70.317,7,1,6,6,1,"MA",0.013
"5294",514,"199091.9270.29","MA",1990,5,13,133,20,41.8598,-70.2237,4,1,3,4,0,"MA",0.013
"5295",514,"199091.9280.30","MA",1990,5,13,133,20,41.9295,-70.2125,0,0,0,0,0,"MA",0.013
"5296",514,"199091.9260.31","MA",1990,5,13,133,20,41.9388,-70.119,1,0,1,1,0,"MA",0.013
"5297",514,"199091.9250.32","MA",1990,5,13,133,13,41.9113,-70.114,1,0,1,0,1,"MA",0.013
"5298",514,"199091.9260.33","MA",1990,5,13,133,20,41.8608,-70.1878,4,2,2,4,0,"MA",0.013
"5299",514,"199091.9260.34","MA",1990,5,13,133,20,41.7978,-70.2573,2,1,1,2,0,"MA",0.013
"5300",514,"199091.9260.35","MA",1990,5,13,133,20,41.765,-70.4087,20,7,13,17,3,"MA",0.013
"5301",514,"199091.9280.36","MA",1990,5,14,134,20,42.0107,-70.1685,1,1,0,1,0,"MA",0.013
"5302",514,"199091.9270.37","MA",1990,5,14,134,20,41.9832,-70.142,8,4,4,8,0,"MA",0.013
"5303",514,"199091.9290.38","MA",1990,5,14,134,20,42.0115,-70.2197,0,0,0,0,0,"MA",0.013
"5304",514,"199091.9290.39","MA",1990,5,14,134,20,41.9807,-70.2568,0,0,0,0,0,"MA",0.013
"5305",514,"199091.9290.40","MA",1990,5,14,134,20,41.9348,-70.3595,0,0,0,0,0,"MA",0.013
"5306",514,"199091.9280.41","MA",1990,5,14,134,20,41.8773,-70.3728,7,3,4,6,1,"MA",0.013
"5307",514,"199091.9300.42","MA",1990,5,15,135,20,42.1113,-70.2802,0,0,0,0,0,"MA",0.013
"5308",514,"199091.9210.43","MA",1990,5,15,135,20,42.11,-70.2255,0,0,0,0,0,"MA",0.013
"5309",514,"199091.9170.44","MA",1990,5,15,135,20,42.092,-70.1877,9,5,4,9,0,"MA",0.013
"5310",514,"199091.9180.45","MA",1990,5,15,135,20,42.027,-70.021,1,0,1,1,0,"MA",0.013
"5311",514,"199091.9210.46","MA",1990,5,15,135,20,42.078,-70.0258,0,0,0,0,0,"MA",0.013
"5312",514,"199091.9200.47","MA",1990,5,15,135,20,42.1018,-70.1632,4,2,2,3,1,"MA",0.013
"5313",521,"199091.9170.48","MA",1990,5,16,136,20,41.8938,-69.9533,13,10,3,12,1,"MA",0.013
"5314",521,"199091.9190.49","MA",1990,5,16,136,20,41.8167,-69.9088,0,0,0,0,0,"MA",0.013
"5315",521,"199091.9200.50","MA",1990,5,16,136,20,41.8335,-69.8902,0,0,0,0,0,"MA",0.013
"5316",521,"199091.9180.51","MA",1990,5,16,136,19,41.652,-69.9098,1,1,0,0,1,"MA",0.013
"5317",521,"199091.9170.72","MA",1990,5,20,140,19,41.3917,-69.999,0,0,0,0,0,"MA",0.013
"5318",521,"199091.9180.73","MA",1990,5,20,140,20,41.3715,-69.9562,0,0,0,0,0,"MA",0.013
"5319",514,"199191.9270.1","MA",1991,5,7,127,20,41.8633,-70.4057,10,4,6,6,4,"MA",0.013
"5320",514,"199191.9270.2","MA",1991,5,7,127,20,41.8335,-70.2883,4,1,3,2,2,"MA",0.013
"5321",514,"199191.9280.3","MA",1991,5,7,127,20,41.8728,-70.3465,0,0,0,0,0,"MA",0.013
"5322",514,"199191.9280.4","MA",1991,5,7,127,20,41.9382,-70.271,0,0,0,0,0,"MA",0.013
"5323",514,"199191.9280.5","MA",1991,5,7,127,20,41.8803,-70.4448,4,3,1,3,1,"MA",0.013
"5324",514,"199191.9260.6","MA",1991,5,7,127,20,41.8072,-70.4862,9,6,3,3,6,"MA",0.013
"5325",514,"199191.9290.7","MA",1991,5,8,128,20,41.9552,-70.4455,9,5,4,9,0,"MA",0.013
"5326",514,"199191.9290.8","MA",1991,5,8,128,20,41.994,-70.4798,6,2,4,6,0,"MA",0.013
"5327",514,"199191.9280.9","MA",1991,5,8,128,20,42.0095,-70.5375,6,2,4,6,0,"MA",0.013
"5328",514,"199191.9260.10","MA",1991,5,8,128,20,42.0507,-70.633,22,8,14,12,10,"MA",0.013
"5329",514,"199191.9270.11","MA",1991,5,8,128,20,42.1197,-70.5668,2,0,2,1,1,"MA",0.013
"5330",514,"199191.9250.12","MA",1991,5,8,128,20,42.1447,-70.684,87,37,50,44,43,"MA",0.013
"5331",514,"199191.9320.13","MA",1991,5,8,128,20,42.3003,-70.8437,56,25,31,32,24,"MA",0.013
"5332",514,"199191.9330.14","MA",1991,5,9,129,20,42.3087,-70.8023,39,16,23,30,9,"MA",0.013
"5333",514,"199191.9340.15","MA",1991,5,9,129,20,42.3898,-70.8227,17,7,10,16,1,"MA",0.013
"5334",514,"199191.9310.16","MA",1991,5,9,129,20,42.4537,-70.917,11,4,7,8,3,"MA",0.013
"5335",514,"199191.9330.17","MA",1991,5,9,129,20,42.4522,-70.8815,14,5,9,12,2,"MA",0.013
"5336",514,"199191.9350.18","MA",1991,5,9,129,20,42.4858,-70.7617,9,3,6,9,0,"MA",0.013
"5337",514,"199191.9340.19","MA",1991,5,9,129,14,42.5473,-70.7178,2,1,1,2,0,"MA",0.013
"5338",514,"199191.9350.20","MA",1991,5,9,129,20,42.5903,-70.5783,4,1,3,4,0,"MA",0.013
"5339",514,"199191.9360.21","MA",1991,5,9,129,20,42.5663,-70.5995,1,0,1,1,0,"MA",0.013
"5340",514,"199191.9360.22","MA",1991,5,10,130,20,42.6257,-70.531,8,5,3,8,0,"MA",0.013
"5341",514,"199191.9360.23","MA",1991,5,10,130,20,42.71,-70.5615,10,6,4,9,1,"MA",0.013
"5342",514,"199191.9350.24","MA",1991,5,10,130,20,42.7293,-70.6343,1,1,0,1,0,"MA",0.013
"5343",514,"199191.9310.25","MA",1991,5,10,130,20,42.6782,-70.7128,3,1,2,2,1,"MA",0.013
"5344",514,"199191.9310.26","MA",1991,5,10,130,20,42.711,-70.7522,2,1,1,1,1,"MA",0.013
"5345",514,"199191.9320.27","MA",1991,5,10,130,16,42.7408,-70.764,2,2,0,2,0,"MA",0.013
"5346",514,"199191.9330.28","MA",1991,5,10,130,20,42.796,-70.7625,1,0,1,1,0,"MA",0.013
"5347",513,"199191.9340.29","MA",1991,5,10,130,20,42.8368,-70.7505,0,0,0,0,0,"MA",0.013
"5348",514,"199191.9330.30","MA",1991,5,10,130,20,42.7048,-70.7015,1,0,1,0,1,"MA",0.013
"5349",514,"199191.9360.31","MA",1991,5,11,131,20,42.4937,-70.6242,5,2,3,5,0,"MA",0.013
"5350",514,"199191.9360.32","MA",1991,5,11,131,20,42.4782,-70.6333,4,0,4,4,0,"MA",0.013
"5351",514,"199191.9350.33","MA",1991,5,11,131,15,42.4573,-70.7133,4,3,1,4,0,"MA",0.013
"5352",514,"199191.9350.34","MA",1991,5,11,131,16,42.377,-70.6977,5,3,2,5,0,"MA",0.013
"5353",514,"199191.9290.35","MA",1991,5,11,131,20,42.0538,-70.4848,5,2,3,4,1,"MA",0.013
"5354",514,"199191.9280.36","MA",1991,5,12,132,20,41.9413,-70.1943,0,0,0,0,0,"MA",0.013
"5355",514,"199191.9270.37","MA",1991,5,12,132,20,41.986,-70.1368,1,0,1,1,0,"MA",0.013
"5356",514,"199191.9260.38","MA",1991,5,12,132,17,41.9837,-70.1053,13,4,9,12,1,"MA",0.013
"5357",514,"199191.9270.39","MA",1991,5,12,132,20,41.9057,-70.164,0,0,0,0,0,"MA",0.013
"5358",514,"199191.9260.40","MA",1991,5,12,132,20,41.8847,-70.1457,2,0,2,2,0,"MA",0.013
"5359",514,"199191.9250.41","MA",1991,5,12,132,20,41.848,-70.1527,1,0,1,0,1,"MA",0.013
"5360",514,"199191.9250.42","MA",1991,5,12,132,20,41.745,-70.3495,3,0,3,2,1,"MA",0.013
"5361",514,"199191.9260.43","MA",1991,5,12,132,20,41.7557,-70.3555,11,7,4,7,4,"MA",0.013
"5362",514,"199191.9290.44","MA",1991,5,13,133,20,42.048,-70.3883,3,1,2,2,1,"MA",0.013
"5363",514,"199191.9300.45","MA",1991,5,13,133,20,42.1152,-70.3953,0,0,0,0,0,"MA",0.013
"5364",514,"199191.9210.46","MA",1991,5,13,133,20,42.1082,-70.2253,1,1,0,1,0,"MA",0.013
"5365",514,"199191.9300.47","MA",1991,5,13,133,20,42.0498,-70.2755,2,2,0,2,0,"MA",0.013
"5366",514,"199191.9290.48","MA",1991,5,13,133,20,41.976,-70.3227,6,1,5,6,0,"MA",0.013
"5367",514,"199191.9200.49","MA",1991,5,14,134,20,42.1018,-70.1637,1,1,0,1,0,"MA",0.013
"5368",514,"199191.9170.50","MA",1991,5,14,134,20,42.0455,-70.0583,0,0,0,0,0,"MA",0.013
"5369",514,"199191.9180.51","MA",1991,5,14,134,20,42.0283,-70.0305,1,0,1,1,0,"MA",0.013
"5370",514,"199191.9210.52","MA",1991,5,14,134,20,42.081,-70.0268,0,0,0,0,0,"MA",0.013
"5371",514,"199191.9180.53","MA",1991,5,14,134,20,42.0887,-70.1453,3,3,0,3,0,"MA",0.013
"5372",521,"199191.9170.54","MA",1991,5,15,135,20,41.8748,-69.9475,5,1,4,0,5,"MA",0.013
"5373",521,"199191.9190.55","MA",1991,5,15,135,20,41.821,-69.9135,4,2,2,3,1,"MA",0.013
"5374",521,"199191.9200.56","MA",1991,5,15,135,20,41.797,-69.8813,0,0,0,0,0,"MA",0.013
"5375",514,"199291.9260.12","MA",1992,5,9,130,20,41.7702,-70.4305,10,4,6,6,4,"MA",0.013
"5376",514,"199291.9270.13","MA",1992,5,9,130,20,41.8053,-70.3327,6,3,3,4,2,"MA",0.013
"5377",514,"199291.9260.14","MA",1992,5,9,130,20,41.7562,-70.297,4,2,2,3,1,"MA",0.013
"5378",514,"199291.9260.15","MA",1992,5,9,130,20,41.8542,-70.1717,2,1,1,2,0,"MA",0.013
"5379",514,"199291.9260.16","MA",1992,5,9,130,20,41.9002,-70.1428,1,0,1,1,0,"MA",0.013
"5380",514,"199291.9270.17","MA",1992,5,9,130,20,41.884,-70.1782,0,0,0,0,0,"MA",0.013
"5381",514,"199291.9280.18","MA",1992,5,9,130,20,41.9013,-70.2105,2,1,1,2,0,"MA",0.013
"5382",514,"199291.9250.19","MA",1992,5,10,131,20,41.82,-70.5307,7,4,3,3,4,"MA",0.013
"5383",514,"199291.9250.20","MA",1992,5,10,131,20,41.979,-70.5985,33,12,21,23,10,"MA",0.013
"5384",514,"199291.9270.21","MA",1992,5,10,131,20,42.0572,-70.568,19,6,13,18,1,"MA",0.013
"5385",514,"199291.9260.22","MA",1992,5,10,131,13,42.0577,-70.6295,8,4,4,8,0,"MA",0.013
"5386",514,"199291.9310.23","MA",1992,5,10,131,13,42.2853,-70.8605,37,13,24,4,33,"MA",0.013
"5387",514,"199291.9340.24","MA",1992,5,11,132,13,42.3858,-70.8252,60,18,42,56,4,"MA",0.013
"5388",514,"199291.9320.25","MA",1992,5,11,132,13,42.412,-70.9418,134,69,65,84,50,"MA",0.013
"5389",514,"199291.9320.26","MA",1992,5,11,132,13,42.446,-70.9135,64,28,36,43,21,"MA",0.013
"5390",514,"199291.9330.27","MA",1992,5,11,132,20,42.4427,-70.8922,7,4,3,5,2,"MA",0.013
"5391",514,"199291.9350.28","MA",1992,5,12,133,20,42.5788,-70.5963,8,5,3,8,0,"MA",0.013
"5392",514,"199291.9360.29","MA",1992,5,12,133,20,42.6205,-70.5385,1,0,1,1,0,"MA",0.013
"5393",514,"199291.9340.30","MA",1992,5,12,133,20,42.6507,-70.5715,0,0,0,0,0,"MA",0.013
"5394",514,"199291.9360.31","MA",1992,5,12,133,20,42.7098,-70.5455,8,5,3,8,0,"MA",0.013
"5395",514,"199291.9350.32","MA",1992,5,12,133,20,42.7185,-70.6198,2,1,1,2,0,"MA",0.013
"5396",514,"199291.9330.33","MA",1992,5,12,133,20,42.6947,-70.6953,4,2,2,3,1,"MA",0.013
"5397",514,"199291.9310.34","MA",1992,5,12,133,20,42.7293,-70.7625,2,1,1,2,0,"MA",0.013
"5398",514,"199291.9310.35","MA",1992,5,12,133,20,42.7693,-70.7933,1,0,1,1,0,"MA",0.013
"5399",514,"199291.9320.36","MA",1992,5,12,133,20,42.7697,-70.7768,7,1,6,7,0,"MA",0.013
"5400",514,"199291.9340.37","MA",1992,5,13,134,13,42.5428,-70.7385,2,1,1,2,0,"MA",0.013
"5401",514,"199291.9350.38","MA",1992,5,13,134,20,42.5062,-70.7205,4,0,4,4,0,"MA",0.013
"5402",514,"199291.9360.39","MA",1992,5,13,134,20,42.4677,-70.6443,7,2,5,7,0,"MA",0.013
"5403",514,"199291.9290.40","MA",1992,5,13,134,20,42.107,-70.4557,7,3,4,7,0,"MA",0.013
"5404",514,"199291.9300.41","MA",1992,5,13,134,20,42.095,-70.4077,0,0,0,0,0,"MA",0.013
"5405",514,"199291.9290.42","MA",1992,5,13,134,20,42.0103,-70.4503,7,3,4,7,0,"MA",0.013
"5406",514,"199291.9280.43","MA",1992,5,13,134,20,41.9032,-70.4298,23,9,14,19,4,"MA",0.013
"5407",514,"199291.9280.44","MA",1992,5,14,135,20,41.8862,-70.3732,49,15,34,43,6,"MA",0.013
"5408",514,"199291.9280.45","MA",1992,5,14,135,20,41.885,-70.2847,6,2,4,6,0,"MA",0.013
"5409",514,"199291.9280.46","MA",1992,5,14,135,20,41.9193,-70.2747,3,2,1,3,0,"MA",0.013
"5410",514,"199291.9250.47","MA",1992,5,14,135,20,41.9393,-70.0963,1,1,0,1,0,"MA",0.013
"5411",514,"199291.9270.48","MA",1992,5,14,135,20,42.0002,-70.1545,7,1,6,7,0,"MA",0.013
"5412",514,"199291.9290.49","MA",1992,5,14,135,20,42.0163,-70.2362,7,1,6,7,0,"MA",0.013
"5413",514,"199291.9290.50","MA",1992,5,14,135,20,42.0377,-70.3172,3,1,2,3,0,"MA",0.013
"5414",514,"199291.9290.51","MA",1992,5,14,135,20,41.9723,-70.4288,10,6,4,9,1,"MA",0.013
"5415",514,"199291.9300.52","MA",1992,5,15,136,20,42.0822,-70.3095,5,1,4,5,0,"MA",0.013
"5416",514,"199291.9210.53","MA",1992,5,15,136,20,42.1135,-70.2228,0,0,0,0,0,"MA",0.013
"5417",514,"199291.9200.54","MA",1992,5,15,136,20,42.1005,-70.1588,1,1,0,1,0,"MA",0.013
"5418",514,"199291.9170.55","MA",1992,5,15,136,20,42.0847,-70.1382,3,3,0,3,0,"MA",0.013
"5419",514,"199291.9210.56","MA",1992,5,15,136,20,42.0823,-70.028,0,0,0,0,0,"MA",0.013
"5420",514,"199291.9200.57","MA",1992,5,15,136,20,42.0587,-70.0222,0,0,0,0,0,"MA",0.013
"5421",514,"199291.9170.58","MA",1992,5,15,136,20,41.9958,-70.0082,0,0,0,0,0,"MA",0.013
"5422",521,"199291.9190.59","MA",1992,5,15,136,13,41.9283,-69.9437,0,0,0,0,0,"MA",0.013
"5423",521,"199291.9180.60","MA",1992,5,15,136,20,41.8833,-69.9468,1,0,1,1,0,"MA",0.013
"5424",521,"199291.9180.61","MA",1992,5,16,137,17,41.6448,-69.9123,4,2,2,3,1,"MA",0.013
"5425",521,"199291.9180.62","MA",1992,5,16,137,20,41.3712,-69.9622,0,0,0,0,0,"MA",0.013
"5426",521,"199291.9170.63","MA",1992,5,16,137,20,41.355,-69.9778,0,0,0,0,0,"MA",0.013
"5427",514,"199391.9270.1","MA",1993,5,5,125,20,41.887,-70.4852,15,7,8,8,7,"MA",0.013
"5428",514,"199391.9280.2","MA",1993,5,5,125,20,41.9357,-70.467,19,4,15,17,2,"MA",0.013
"5429",514,"199391.9250.3","MA",1993,5,5,125,20,41.9783,-70.6078,11,4,7,6,5,"MA",0.013
"5430",514,"199391.9260.4","MA",1993,5,5,125,20,42.1477,-70.6822,57,22,35,30,27,"MA",0.013
"5431",514,"199391.9310.5","MA",1993,5,5,125,13,42.2927,-70.8647,65,29,36,22,43,"MA",0.013
"5432",514,"199391.9320.6","MA",1993,5,6,126,20,42.4112,-70.9315,163,58,105,80,83,"MA",0.013
"5433",514,"199391.9330.7","MA",1993,5,6,126,20,42.446,-70.904,77,30,47,49,28,"MA",0.013
"5434",514,"199391.9320.8","MA",1993,5,6,126,20,42.4543,-70.911,41,16,25,20,21,"MA",0.013
"5435",514,"199391.9340.9","MA",1993,5,6,126,20,42.4482,-70.8482,49,17,32,39,10,"MA",0.013
"5436",514,"199391.9350.10","MA",1993,5,6,126,15,42.4803,-70.7358,4,2,2,4,0,"MA",0.013
"5437",514,"199391.9340.11","MA",1993,5,6,126,20,42.5482,-70.7217,14,8,6,13,1,"MA",0.013
"5438",514,"199391.9350.12","MA",1993,5,7,127,20,42.5878,-70.5788,9,6,3,9,0,"MA",0.013
"5439",514,"199391.9360.13","MA",1993,5,7,127,20,42.713,-70.5612,4,2,2,4,0,"MA",0.013
"5440",514,"199391.9340.14","MA",1993,5,7,127,20,42.7022,-70.6657,7,2,5,6,1,"MA",0.013
"5441",514,"199391.9310.15","MA",1993,5,7,127,20,42.6923,-70.7318,5,0,5,4,1,"MA",0.013
"5442",514,"199391.9330.16","MA",1993,5,7,127,20,42.7738,-70.7662,1,1,0,1,0,"MA",0.013
"5443",514,"199391.9320.17","MA",1993,5,7,127,20,42.7008,-70.7205,14,6,8,13,1,"MA",0.013
"5444",514,"199391.9350.18","MA",1993,5,8,128,20,42.5093,-70.716,1,0,1,1,0,"MA",0.013
"5445",514,"199391.9360.19","MA",1993,5,8,128,20,42.421,-70.6505,5,1,4,5,0,"MA",0.013
"5446",514,"199391.9360.20","MA",1993,5,8,128,20,42.4682,-70.6428,4,0,4,4,0,"MA",0.013
"5447",514,"199391.9250.21","MA",1993,5,9,129,20,41.7442,-70.3432,20,13,7,17,3,"MA",0.013
"5448",514,"199391.9260.22","MA",1993,5,9,129,20,41.7662,-70.3492,5,1,4,4,1,"MA",0.013
"5449",514,"199391.9270.23","MA",1993,5,9,129,20,41.817,-70.3093,11,6,5,10,1,"MA",0.013
"5450",514,"199391.9290.24","MA",1993,5,9,129,20,41.9577,-70.3985,12,4,8,11,1,"MA",0.013
"5451",514,"199391.9290.25","MA",1993,5,9,129,20,42.028,-70.4177,1,1,0,1,0,"MA",0.013
"5452",514,"199391.9300.26","MA",1993,5,9,129,20,42.081,-70.3985,6,2,4,6,0,"MA",0.013
"5453",514,"199391.9280.27","MA",1993,5,9,129,20,41.9957,-70.5287,10,5,5,7,3,"MA",0.013
"5454",514,"199391.9260.28","MA",1993,5,10,130,20,41.7935,-70.2275,4,3,1,4,0,"MA",0.013
"5455",514,"199391.9260.29","MA",1993,5,10,130,20,41.8357,-70.1937,2,0,2,2,0,"MA",0.013
"5456",514,"199391.9270.30","MA",1993,5,10,130,20,41.9183,-70.1573,1,1,0,1,0,"MA",0.013
"5457",514,"199391.9250.31","MA",1993,5,10,130,20,41.9467,-70.0947,0,0,0,0,0,"MA",0.013
"5458",514,"199391.9290.32","MA",1993,5,10,130,20,41.9982,-70.2295,1,0,1,1,0,"MA",0.013
"5459",514,"199391.9280.33","MA",1993,5,10,130,20,41.907,-70.2922,1,0,1,1,0,"MA",0.013
"5460",514,"199391.9300.34","MA",1993,5,11,131,20,42.0845,-70.3118,1,0,1,0,1,"MA",0.013
"5461",514,"199391.9200.35","MA",1993,5,11,131,20,42.1023,-70.1578,5,4,1,5,0,"MA",0.013
"5462",514,"199391.9170.36","MA",1993,5,11,131,20,42.0845,-70.1422,5,4,1,4,1,"MA",0.013
"5463",514,"199391.9210.37","MA",1993,5,11,131,20,42.0817,-70.0443,2,1,1,2,0,"MA",0.013
"5464",514,"199391.9210.38","MA",1993,5,11,131,20,42.1058,-70.2333,2,0,2,0,2,"MA",0.013
"5465",514,"199391.9210.39","MA",1993,5,11,131,20,42.1015,-70.218,2,1,1,2,0,"MA",0.013
"5466",514,"199391.9180.40","MA",1993,5,12,132,20,41.9922,-70.0017,7,2,5,7,0,"MA",0.013
"5467",521,"199391.9170.41","MA",1993,5,12,132,13,41.9575,-69.983,6,6,0,0,6,"MA",0.013
"5468",521,"199391.9190.42","MA",1993,5,12,132,20,41.8245,-69.913,1,0,1,0,1,"MA",0.013
"5469",521,"199391.9210.43","MA",1993,5,12,132,20,41.8317,-69.8668,1,0,1,1,0,"MA",0.013
"5470",521,"199391.9200.44","MA",1993,5,12,132,20,41.786,-69.8763,0,0,0,0,0,"MA",0.013
"5471",521,"199391.9180.64","MA",1993,5,15,135,20,41.364,-69.9535,1,1,0,1,0,"MA",0.013
"5472",514,"199491.9260.1","MA",1994,5,10,130,20,41.7618,-70.3788,11,3,8,7,4,"MA",0.013
"5473",514,"199491.9270.2","MA",1994,5,10,130,20,41.792,-70.3813,14,5,9,9,5,"MA",0.013
"5474",514,"199491.9260.3","MA",1994,5,10,130,20,41.7708,-70.3243,6,5,1,5,1,"MA",0.013
"5475",514,"199491.9280.4","MA",1994,5,10,130,20,41.8728,-70.3465,6,2,4,4,2,"MA",0.013
"5476",514,"199491.9280.5","MA",1994,5,10,130,20,41.9048,-70.4405,5,4,1,5,0,"MA",0.013
"5477",514,"199491.9250.6","MA",1994,5,11,131,20,41.8322,-70.513,18,13,5,10,8,"MA",0.013
"5478",514,"199491.9250.7","MA",1994,5,11,131,20,41.9757,-70.6017,39,18,21,28,11,"MA",0.013
"5479",514,"199491.9280.8","MA",1994,5,11,131,20,41.9755,-70.5158,22,12,10,17,5,"MA",0.013
"5480",514,"199491.9270.9","MA",1994,5,11,131,20,42.0398,-70.5727,30,16,14,25,5,"MA",0.013
"5481",514,"199491.9310.10","MA",1994,5,11,131,13,42.2902,-70.864,306,142,164,103,203,"MA",0.013
"5482",514,"199491.9320.11","MA",1994,5,12,132,17,42.3035,-70.832,179,97,82,103,76,"MA",0.013
"5483",514,"199491.9340.12","MA",1994,5,12,132,20,42.3847,-70.8238,125,69,56,112,13,"MA",0.013
"5484",514,"199491.9320.13","MA",1994,5,12,132,14,42.4517,-70.909,87,41,46,52,35,"MA",0.013
"5485",514,"199491.9350.15","MA",1994,5,12,132,20,42.5225,-70.7192,1,0,1,1,0,"MA",0.013
"5486",514,"199491.9350.16","MA",1994,5,13,133,20,42.5883,-70.5835,5,1,4,4,1,"MA",0.013
"5487",514,"199491.9360.17","MA",1994,5,14,134,15,42.7017,-70.545,4,1,3,4,0,"MA",0.013
"5488",514,"199491.9330.18","MA",1994,5,14,134,20,42.7457,-70.7413,2,0,2,2,0,"MA",0.013
"5489",514,"199491.9310.19","MA",1994,5,14,134,20,42.7247,-70.7672,1,0,1,1,0,"MA",0.013
"5490",514,"199491.9330.20","MA",1994,5,14,134,20,42.704,-70.6957,2,1,1,1,1,"MA",0.013
"5491",514,"199491.9340.21","MA",1994,5,14,134,20,42.718,-70.6605,1,0,1,1,0,"MA",0.013
"5492",514,"199491.9360.22","MA",1994,5,14,134,20,42.7297,-70.6063,2,1,1,2,0,"MA",0.013
"5493",514,"199491.9270.23","MA",1994,5,15,135,20,41.8482,-70.264,10,3,7,8,2,"MA",0.013
"5494",514,"199491.9260.24","MA",1994,5,15,135,20,41.8628,-70.1857,3,0,3,3,0,"MA",0.013
"5495",514,"199491.9280.25","MA",1994,5,15,135,20,41.9325,-70.2112,3,1,2,3,0,"MA",0.013
"5496",514,"199491.9270.26","MA",1994,5,15,135,20,41.9112,-70.157,3,1,2,3,0,"MA",0.013
"5497",514,"199491.9260.27","MA",1994,5,15,135,20,41.9005,-70.1398,4,0,4,4,0,"MA",0.013
"5498",514,"199491.9250.28","MA",1994,5,15,135,20,41.8827,-70.1138,1,1,0,1,0,"MA",0.013
"5499",514,"199491.9280.29","MA",1994,5,15,135,20,41.9382,-70.2533,3,1,2,1,2,"MA",0.013
"5500",514,"199491.9290.30","MA",1994,5,16,136,20,41.9353,-70.3815,9,1,8,9,0,"MA",0.013
"5501",514,"199491.9290.31","MA",1994,5,16,136,20,42.0155,-70.4242,9,1,8,7,2,"MA",0.013
"5502",514,"199491.9290.32","MA",1994,5,16,136,20,42.0288,-70.3118,9,1,8,8,1,"MA",0.013
"5503",514,"199491.9300.33","MA",1994,5,16,136,20,42.0705,-70.3182,2,0,2,1,1,"MA",0.013
"5504",514,"199491.9290.34","MA",1994,5,16,136,20,41.9848,-70.31,3,1,2,3,0,"MA",0.013
"5505",521,"199491.9170.66","MA",1994,5,22,142,20,41.4017,-69.9788,0,0,0,0,0,"MA",0.013
"5506",521,"199491.9170.67","MA",1994,5,22,142,20,41.3705,-69.9902,0,0,0,0,0,"MA",0.013
"5507",521,"199491.9180.68","MA",1994,5,22,142,20,41.3683,-69.9608,0,0,0,0,0,"MA",0.013
"5508",521,"199491.9180.80","MA",1994,5,24,144,18,41.7462,-69.9177,4,0,4,1,3,"MA",0.013
"5509",521,"199491.9200.81","MA",1994,5,24,144,20,41.7957,-69.8783,0,0,0,0,0,"MA",0.013
"5510",521,"199491.9180.82","MA",1994,5,24,144,20,41.8268,-69.9248,5,1,4,4,1,"MA",0.013
"5511",521,"199491.9170.83","MA",1994,5,24,144,20,41.881,-69.9518,2,1,1,1,1,"MA",0.013
"5512",514,"199491.9300.84","MA",1994,5,25,145,20,42.0503,-70.2808,2,1,1,2,0,"MA",0.013
"5513",514,"199491.9210.85","MA",1994,5,25,145,20,42.0945,-70.2247,5,2,3,5,0,"MA",0.013
"5514",514,"199491.9210.86","MA",1994,5,25,145,20,42.0773,-70.0252,0,0,0,0,0,"MA",0.013
"5515",514,"199491.9190.87","MA",1994,5,25,145,13,42.0323,-70.0187,0,0,0,0,0,"MA",0.013
"5516",514,"199491.9200.88","MA",1994,5,25,145,20,42.1003,-70.1453,1,1,0,1,0,"MA",0.013
"5517",514,"199591.9260.1","MA",1995,5,9,129,20,41.7637,-70.3887,5,1,4,2,3,"MA",0.013
"5518",514,"199591.9260.2","MA",1995,5,9,129,20,41.7988,-70.2322,2,0,2,2,0,"MA",0.013
"5519",514,"199591.9270.3","MA",1995,5,9,129,20,41.8348,-70.3127,9,3,6,7,2,"MA",0.013
"5520",514,"199591.9280.4","MA",1995,5,9,129,20,41.883,-70.3292,1,0,1,1,0,"MA",0.013
"5521",514,"199591.9280.5","MA",1995,5,9,129,20,41.9168,-70.2775,6,2,4,6,0,"MA",0.013
"5522",514,"199591.9270.6","MA",1995,5,9,129,20,41.8437,-70.4297,14,5,9,10,4,"MA",0.013
"5523",514,"199591.9250.7","MA",1995,5,10,130,20,41.8337,-70.5115,3,2,1,2,1,"MA",0.013
"5524",514,"199591.9280.8","MA",1995,5,10,130,20,41.9553,-70.4718,19,7,12,14,5,"MA",0.013
"5525",514,"199591.9260.9","MA",1995,5,10,130,20,41.9772,-70.5822,17,8,9,11,6,"MA",0.013
"5526",514,"199591.9250.10","MA",1995,5,10,130,20,41.9717,-70.6035,14,8,6,6,8,"MA",0.013
"5527",514,"199591.9270.11","MA",1995,5,10,130,20,42.0438,-70.5678,29,18,11,21,8,"MA",0.013
"5528",514,"199591.9280.12","MA",1995,5,10,130,20,42.0955,-70.5423,6,3,3,6,0,"MA",0.013
"5529",514,"199591.9310.13","MA",1995,5,10,130,13,42.2903,-70.8668,295,136,159,42,253,"MA",0.013
"5530",514,"199591.9320.14","MA",1995,5,10,130,13,42.2997,-70.8467,202,106,96,92,110,"MA",0.013
"5531",514,"199591.9330.15","MA",1995,5,11,131,13.5,42.3883,-70.8237,65,33,32,63,2,"MA",0.013
"5532",514,"199591.9320.16","MA",1995,5,11,131,20,42.4522,-70.906,21,10,11,15,6,"MA",0.013
"5533",514,"199591.9340.17","MA",1995,5,11,131,20,42.4373,-70.8652,48,14,34,37,11,"MA",0.013
"5534",514,"199591.9350.18","MA",1995,5,11,131,20,42.5175,-70.7212,6,2,4,6,0,"MA",0.013
"5535",514,"199591.9340.19","MA",1995,5,11,131,14,42.5458,-70.7197,11,1,10,8,3,"MA",0.013
"5536",514,"199591.9350.20","MA",1995,5,12,132,20,42.5848,-70.59,10,1,9,9,1,"MA",0.013
"5537",514,"199591.9360.21","MA",1995,5,12,132,20,42.6243,-70.535,9,2,7,7,2,"MA",0.013
"5538",514,"199591.9350.22","MA",1995,5,12,132,13,42.7023,-70.5897,22,10,12,20,2,"MA",0.013
"5539",514,"199591.9350.23","MA",1995,5,12,132,20,42.7285,-70.6418,3,0,3,3,0,"MA",0.013
"5540",514,"199591.9340.24","MA",1995,5,12,132,20,42.8293,-70.7597,1,1,0,1,0,"MA",0.013
"5541",514,"199591.9330.25","MA",1995,5,12,132,20,42.7858,-70.7642,1,1,0,1,0,"MA",0.013
"5542",514,"199591.9320.26","MA",1995,5,12,132,20,42.7723,-70.7835,7,2,5,7,0,"MA",0.013
"5543",514,"199591.9310.27","MA",1995,5,12,132,20,42.763,-70.7907,21,8,13,3,18,"MA",0.013
"5544",514,"199591.9310.28","MA",1995,5,12,132,20,42.7293,-70.7737,3,2,1,0,3,"MA",0.013
"5545",514,"199591.9330.29","MA",1995,5,12,132,20,42.7018,-70.7065,5,0,5,4,1,"MA",0.013
"5546",514,"199591.9350.30","MA",1995,5,13,133,20,42.533,-70.6697,8,4,4,8,0,"MA",0.013
"5547",514,"199591.9360.31","MA",1995,5,13,133,20,42.4553,-70.6473,3,0,3,3,0,"MA",0.013
"5548",514,"199591.9260.32","MA",1995,5,14,134,20,41.8632,-70.1817,1,1,0,1,0,"MA",0.013
"5549",514,"199591.9250.33","MA",1995,5,14,134,20,41.9012,-70.1055,0,0,0,0,0,"MA",0.013
"5550",514,"199591.9290.34","MA",1995,5,14,134,20,41.9937,-70.2558,10,2,8,10,0,"MA",0.013
"5551",514,"199591.9290.35","MA",1995,5,14,134,13,41.982,-70.3103,1,0,1,1,0,"MA",0.013
"5552",514,"199591.9290.36","MA",1995,5,14,134,20,42.0245,-70.4255,2,1,1,2,0,"MA",0.013
"5553",514,"199591.9290.37","MA",1995,5,14,134,20,41.9677,-70.4097,10,6,4,9,1,"MA",0.013
"5554",514,"199591.9290.38","MA",1995,5,15,135,20,41.935,-70.4032,10,2,8,10,0,"MA",0.013
"5555",514,"199591.9280.39","MA",1995,5,15,135,20,41.9467,-70.2392,4,2,2,4,0,"MA",0.013
"5556",514,"199591.9270.40","MA",1995,5,15,135,20,42.0075,-70.1468,2,0,2,2,0,"MA",0.013
"5557",514,"199591.9260.41","MA",1995,5,15,135,20,41.9858,-70.113,0,0,0,0,0,"MA",0.013
"5558",514,"199591.9270.42","MA",1995,5,15,135,13,41.9733,-70.1383,14,6,8,12,2,"MA",0.013
"5559",514,"199591.9300.43","MA",1995,5,15,135,20,42.061,-70.328,8,3,5,8,0,"MA",0.013
"5560",514,"199591.9300.44","MA",1995,5,16,136,20,42.1027,-70.2838,0,0,0,0,0,"MA",0.013
"5561",514,"199591.9210.45","MA",1995,5,16,136,13,42.0968,-70.1997,5,4,1,5,0,"MA",0.013
"5562",514,"199591.9200.46","MA",1995,5,16,136,20,42.102,-70.1715,0,0,0,0,0,"MA",0.013
"5563",514,"199591.9170.47","MA",1995,5,16,136,20,42.0893,-70.1745,0,0,0,0,0,"MA",0.013
"5564",514,"199591.9180.48","MA",1995,5,16,136,20,42.0275,-70.026,0,0,0,0,0,"MA",0.013
"5565",514,"199591.9170.49","MA",1995,5,16,136,20,42.0555,-70.0732,0,0,0,0,0,"MA",0.013
"5566",514,"199591.9200.50","MA",1995,5,16,136,13,42.0678,-70.0293,0,0,0,0,0,"MA",0.013
"5567",521,"199591.9180.52","MA",1995,5,17,137,20,41.985,-69.9908,3,0,3,3,0,"MA",0.013
"5568",521,"199591.9190.53","MA",1995,5,17,137,20,41.9668,-69.9687,1,1,0,1,0,"MA",0.013
"5569",521,"199591.9170.75","MA",1995,5,21,141,20,41.3707,-69.9832,0,0,0,0,0,"MA",0.013
"5570",514,"199691.9250.1","MA",1996,5,7,128,20,41.8282,-70.5183,3,0,3,2,1,"MA",0.013
"5571",514,"199691.9280.2","MA",1996,5,7,128,20,41.8865,-70.4107,20,6,14,18,2,"MA",0.013
"5572",514,"199691.9290.3","MA",1996,5,7,128,20,41.9367,-70.4067,4,3,1,4,0,"MA",0.013
"5573",514,"199691.9290.4","MA",1996,5,7,128,20,41.9562,-70.3498,7,2,5,7,0,"MA",0.013
"5574",514,"199691.9280.5","MA",1996,5,7,128,20,41.9158,-70.3332,4,2,2,4,0,"MA",0.013
"5575",514,"199691.9270.6","MA",1996,5,8,129,20,41.8897,-70.482,18,10,8,14,4,"MA",0.013
"5576",514,"199691.9260.7","MA",1996,5,8,129,20,41.975,-70.5817,5,2,3,4,1,"MA",0.013
"5577",514,"199691.9270.8","MA",1996,5,8,129,20,42.0417,-70.57,18,8,10,12,6,"MA",0.013
"5578",514,"199691.9250.9","MA",1996,5,8,129,20,42.0533,-70.635,60,24,36,19,41,"MA",0.013
"5579",514,"199691.9260.10","MA",1996,5,8,129,20,42.1495,-70.6828,58,24,34,28,30,"MA",0.013
"5580",514,"199691.9310.11","MA",1996,5,8,129,13,42.2917,-70.865,48,24,24,22,26,"MA",0.013
"5581",514,"199691.9320.12","MA",1996,5,8,129,13,42.3032,-70.8377,40,19,21,24,16,"MA",0.013
"5582",514,"199691.9340.13","MA",1996,5,9,130,13,42.3915,-70.829,44,29,15,40,4,"MA",0.013
"5583",514,"199691.9320.14","MA",1996,5,9,130,17,42.4428,-70.9125,38,15,23,15,23,"MA",0.013
"5584",514,"199691.9330.15","MA",1996,5,9,130,20,42.4425,-70.8925,27,11,16,21,6,"MA",0.013
"5585",514,"199691.9340.16","MA",1996,5,9,130,20,42.4405,-70.863,15,7,8,12,3,"MA",0.013
"5586",514,"199691.9360.17","MA",1996,5,9,130,20,42.4693,-70.646,8,3,5,8,0,"MA",0.013
"5587",514,"199691.9350.18","MA",1996,5,9,130,20,42.5175,-70.7232,1,1,0,1,0,"MA",0.013
"5588",514,"199691.9350.19","MA",1996,5,9,130,20,42.576,-70.6137,4,0,4,4,0,"MA",0.013
"5589",514,"199691.9350.20","MA",1996,5,10,131,20,42.5852,-70.5878,4,2,2,4,0,"MA",0.013
"5590",514,"199691.9360.21","MA",1996,5,10,131,20,42.7327,-70.6097,3,0,3,3,0,"MA",0.013
"5591",514,"199691.9330.22","MA",1996,5,10,131,20,42.717,-70.7177,1,0,1,1,0,"MA",0.013
"5592",514,"199691.9330.23","MA",1996,5,10,131,20,42.7668,-70.7457,2,1,1,2,0,"MA",0.013
"5593",513,"199691.9340.24","MA",1996,5,10,131,17,42.839,-70.752,0,0,0,0,0,"MA",0.013
"5594",514,"199691.9310.25","MA",1996,5,10,131,20,42.7722,-70.7947,3,2,1,2,1,"MA",0.013
"5595",514,"199691.9320.26","MA",1996,5,10,131,16,42.7847,-70.7935,2,0,2,1,1,"MA",0.013
"5596",514,"199691.9310.27","MA",1996,5,10,131,20,42.7137,-70.754,1,0,1,1,0,"MA",0.013
"5597",514,"199691.9350.28","MA",1996,5,10,131,20,42.7325,-70.6672,1,0,1,1,0,"MA",0.013
"5598",514,"199691.9350.29","MA",1996,5,11,132,20,42.5292,-70.6725,10,9,1,10,0,"MA",0.013
"5599",514,"199691.9350.30","MA",1996,5,11,132,20,42.3822,-70.7028,4,3,1,3,1,"MA",0.013
"5600",514,"199691.9270.31","MA",1996,5,11,132,20,42.1195,-70.5697,3,1,2,3,0,"MA",0.013
"5601",514,"199691.9280.32","MA",1996,5,11,132,20,42.0858,-70.5478,5,2,3,5,0,"MA",0.013
"5602",514,"199691.9290.33","MA",1996,5,11,132,20,42.1155,-70.4937,6,4,2,6,0,"MA",0.013
"5603",514,"199691.9300.34","MA",1996,5,11,132,20,42.1132,-70.396,0,0,0,0,0,"MA",0.013
"5604",514,"199691.9260.35","MA",1996,5,12,133,20,41.7587,-70.3798,3,1,2,3,0,"MA",0.013
"5605",514,"199691.9260.36","MA",1996,5,12,133,13,41.8448,-70.1837,0,0,0,0,0,"MA",0.013
"5606",514,"199691.9270.37","MA",1996,5,12,133,13,41.8762,-70.1885,4,0,4,4,0,"MA",0.013
"5607",514,"199691.9260.38","MA",1996,5,12,133,20,41.9173,-70.1223,1,1,0,1,0,"MA",0.013
"5608",514,"199691.9280.39","MA",1996,5,13,134,20,41.8923,-70.2263,0,0,0,0,0,"MA",0.013
"5609",514,"199691.9280.40","MA",1996,5,13,134,20,41.947,-70.1987,2,1,1,2,0,"MA",0.013
"5610",514,"199691.9270.41","MA",1996,5,13,134,20,41.9385,-70.139,2,0,2,2,0,"MA",0.013
"5611",514,"199691.9250.42","MA",1996,5,13,134,20,41.9422,-70.0993,1,0,1,1,0,"MA",0.013
"5612",514,"199691.9290.43","MA",1996,5,13,134,20,42.0125,-70.223,4,2,2,4,0,"MA",0.013
"5613",514,"199691.9300.44","MA",1996,5,13,134,20,42.0913,-70.297,2,1,1,2,0,"MA",0.013
"5614",514,"199691.9290.45","MA",1996,5,13,134,20,42.031,-70.3192,5,1,4,5,0,"MA",0.013
"5615",514,"199691.9210.46","MA",1996,5,14,135,20,42.1092,-70.2333,0,0,0,0,0,"MA",0.013
"5616",514,"199691.9200.47","MA",1996,5,14,135,20,42.1008,-70.1467,0,0,0,0,0,"MA",0.013
"5617",514,"199691.9180.48","MA",1996,5,14,135,20,42.0815,-70.1153,0,0,0,0,0,"MA",0.013
"5618",514,"199691.9210.49","MA",1996,5,14,135,20,42.083,-70.0368,0,0,0,0,0,"MA",0.013
"5619",514,"199691.9170.50","MA",1996,5,14,135,20,42.0562,-70.0713,0,0,0,0,0,"MA",0.013
"5620",521,"199691.9190.51","MA",1996,5,14,135,20,42.0008,-69.9895,1,1,0,1,0,"MA",0.013
"5621",521,"199691.9170.52","MA",1996,5,15,136,20,41.8658,-69.943,0,0,0,0,0,"MA",0.013
"5622",521,"199691.9190.53","MA",1996,5,15,136,20,41.8723,-69.9275,1,1,0,1,0,"MA",0.013
"5623",521,"199691.9180.54","MA",1996,5,15,136,20,41.8678,-69.9402,1,1,0,1,0,"MA",0.013
"5624",521,"199691.9200.55","MA",1996,5,15,136,20,41.8227,-69.8893,0,0,0,0,0,"MA",0.013
"5625",521,"199691.9180.56","MA",1996,5,15,136,20,41.6543,-69.906,0,0,0,0,0,"MA",0.013
"5626",521,"199691.9170.78","MA",1996,5,19,140,20,41.4017,-69.9805,0,0,0,0,0,"MA",0.013
"5627",521,"199691.9170.79","MA",1996,5,19,140,13,41.3448,-69.985,0,0,0,0,0,"MA",0.013
"5628",514,"199791.9270.1","MA",1997,5,6,126,20,41.7865,-70.3468,4,3,1,3,1,"MA",0.013
"5629",514,"199791.9260.2","MA",1997,5,6,126,20,41.7663,-70.3263,1,1,0,1,0,"MA",0.013
"5630",514,"199791.9260.3","MA",1997,5,6,126,20,41.8027,-70.2395,0,0,0,0,0,"MA",0.013
"5631",514,"199791.9270.4","MA",1997,5,6,126,20,41.8792,-70.1855,1,1,0,1,0,"MA",0.013
"5632",514,"199791.9270.5","MA",1997,5,6,126,20,41.846,-70.4205,15,7,8,13,2,"MA",0.013
"5633",514,"199791.9270.6","MA",1997,5,6,126,20,41.865,-70.4557,3,2,1,3,0,"MA",0.013
"5634",514,"199791.9250.7","MA",1997,5,7,127,20,41.8325,-70.5113,2,1,1,0,2,"MA",0.013
"5635",514,"199791.9280.8","MA",1997,5,7,127,20,41.9467,-70.4832,35,17,18,20,15,"MA",0.013
"5636",514,"199791.9250.9","MA",1997,5,7,127,20,42.038,-70.6238,8,3,5,2,6,"MA",0.013
"5637",514,"199791.9260.10","MA",1997,5,7,127,13,42.1422,-70.6795,7,6,1,2,5,"MA",0.013
"5638",514,"199791.9330.11","MA",1997,5,7,127,13,42.313,-70.7973,18,12,6,14,4,"MA",0.013
"5639",514,"199791.9320.12","MA",1997,5,8,128,20,42.301,-70.8423,24,11,13,17,7,"MA",0.013
"5640",514,"199791.9340.13","MA",1997,5,8,128,20,42.3023,-70.7133,25,0,25,23,2,"MA",0.013
"5641",514,"199791.9320.14","MA",1997,5,8,128,13,42.4502,-70.9088,2,1,1,0,2,"MA",0.013
"5642",514,"199791.9310.15","MA",1997,5,8,128,13,42.4532,-70.9198,1,0,1,0,1,"MA",0.013
"5643",514,"199791.9350.16","MA",1997,5,9,129,20,42.5948,-70.5778,21,10,11,20,1,"MA",0.013
"5644",514,"199791.9360.17","MA",1997,5,9,129,20,42.7153,-70.5642,20,8,12,18,2,"MA",0.013
"5645",514,"199791.9350.18","MA",1997,5,9,129,20,42.711,-70.6145,12,7,5,10,2,"MA",0.013
"5646",514,"199791.9340.19","MA",1997,5,9,129,17,42.7202,-70.6862,1,1,0,1,0,"MA",0.013
"5647",514,"199791.9350.20","MA",1997,5,9,129,20,42.7352,-70.6378,3,1,2,3,0,"MA",0.013
"5648",514,"199791.9330.21","MA",1997,5,9,129,20,42.7005,-70.6947,1,1,0,1,0,"MA",0.013
"5649",514,"199791.9310.22","MA",1997,5,9,129,20,42.6778,-70.6897,2,2,0,2,0,"MA",0.013
"5650",514,"199791.9320.23","MA",1997,5,9,129,20,42.7802,-70.786,1,0,1,0,1,"MA",0.013
"5651",514,"199791.9310.24","MA",1997,5,9,129,20,42.7608,-70.7885,2,0,2,2,0,"MA",0.013
"5652",514,"199791.9330.25","MA",1997,5,9,129,20,42.7583,-70.757,0,0,0,0,0,"MA",0.013
"5653",514,"199791.9360.26","MA",1997,5,10,130,20,42.5092,-70.6375,39,10,29,28,11,"MA",0.013
"5654",514,"199791.9350.27","MA",1997,5,10,130,20,42.5137,-70.7148,8,2,6,8,0,"MA",0.013
"5655",514,"199791.9340.28","MA",1997,5,10,130,20,42.544,-70.7347,6,2,4,6,0,"MA",0.013
"5656",514,"199791.9280.29","MA",1997,5,10,130,20,42.0852,-70.5483,6,1,5,5,1,"MA",0.013
"5657",514,"199791.9290.30","MA",1997,5,10,130,20,42.0627,-70.5155,38,17,21,28,10,"MA",0.013
"5658",514,"199791.9290.31","MA",1997,5,10,130,20,42.0128,-70.4543,28,14,14,23,5,"MA",0.013
"5659",514,"199791.9290.32","MA",1997,5,10,130,20,41.967,-70.4062,22,11,11,21,1,"MA",0.013
"5660",514,"199791.9260.33","MA",1997,5,11,131,20,41.8367,-70.1927,1,1,0,1,0,"MA",0.013
"5661",514,"199791.9280.34","MA",1997,5,11,131,20,41.9148,-70.2352,4,1,3,4,0,"MA",0.013
"5662",514,"199791.9280.35","MA",1997,5,11,131,13,41.921,-70.1795,7,0,7,7,0,"MA",0.013
"5663",514,"199791.9270.36","MA",1997,5,11,131,20,41.9813,-70.1375,3,0,3,3,0,"MA",0.013
"5664",514,"199791.9260.37","MA",1997,5,11,131,13,41.9645,-70.1158,7,1,6,7,0,"MA",0.013
"5665",514,"199791.9250.38","MA",1997,5,11,131,20,41.9233,-70.1008,0,0,0,0,0,"MA",0.013
"5666",514,"199791.9290.39","MA",1997,5,11,131,20,41.9802,-70.2917,14,2,12,14,0,"MA",0.013
"5667",514,"199791.9280.40","MA",1997,5,11,131,20,41.8967,-70.3363,43,7,36,37,6,"MA",0.013
"5668",514,"199791.9290.41","MA",1997,5,12,132,20,42.0287,-70.3123,10,3,7,9,1,"MA",0.013
"5669",514,"199791.9300.42","MA",1997,5,12,132,20,42.0832,-70.4038,5,4,1,3,2,"MA",0.013
"5670",514,"199791.9210.43","MA",1997,5,12,132,20,42.1102,-70.2298,2,1,1,1,1,"MA",0.013
"5671",514,"199791.9210.44","MA",1997,5,12,132,20,42.097,-70.2232,1,1,0,1,0,"MA",0.013
"5672",514,"199791.9300.45","MA",1997,5,12,132,13,42.0965,-70.2853,23,2,21,23,0,"MA",0.013
"5673",514,"199791.9170.46","MA",1997,5,13,133,20,42.0577,-70.074,0,0,0,0,0,"MA",0.013
"5674",521,"199791.9190.47","MA",1997,5,13,133,20,41.983,-69.9783,0,0,0,0,0,"MA",0.013
"5675",514,"199791.9170.48","MA",1997,5,13,133,20,42.0067,-70.0145,2,2,0,2,0,"MA",0.013
"5676",521,"199791.9180.49","MA",1997,5,13,133,20,41.9143,-69.9578,4,2,2,4,0,"MA",0.013
"5677",514,"199791.9200.50","MA",1997,5,14,134,20,42.101,-70.1465,2,2,0,2,0,"MA",0.013
"5678",521,"199791.9200.51","MA",1997,5,14,134,20,41.8333,-69.888,0,0,0,0,0,"MA",0.013
"5679",521,"199791.9180.52","MA",1997,5,14,134,20,41.7338,-69.8932,0,0,0,0,0,"MA",0.013
"5680",521,"199791.9170.74","MA",1997,5,18,138,13,41.4013,-69.9873,0,0,0,0,0,"MA",0.013
"5681",521,"199791.9170.75","MA",1997,5,18,138,20,41.3585,-69.9792,0,0,0,0,0,"MA",0.013
"5682",514,"199891.9250.1","MA",1998,5,5,125,20,41.7487,-70.285,2,2,0,1,1,"MA",0.013
"5683",514,"199891.9260.2","MA",1998,5,5,125,20,41.7833,-70.2772,0,0,0,0,0,"MA",0.013
"5684",514,"199891.9260.3","MA",1998,5,5,125,14,41.8328,-70.1208,0,0,0,0,0,"MA",0.013
"5685",514,"199891.9250.4","MA",1998,5,5,125,14,41.8215,-70.0862,0,0,0,0,0,"MA",0.013
"5686",514,"199891.9260.5","MA",1998,5,5,125,20,41.8807,-70.1473,2,1,1,2,0,"MA",0.013
"5687",514,"199891.9270.6","MA",1998,5,6,126,20,41.9533,-70.5342,24,14,10,19,5,"MA",0.013
"5688",514,"199891.9260.7","MA",1998,5,6,126,15,41.9782,-70.5822,8,2,6,6,2,"MA",0.013
"5689",514,"199891.9250.8","MA",1998,5,6,126,20,41.9763,-70.601,0,0,0,0,0,"MA",0.013
"5690",514,"199891.9270.9","MA",1998,5,6,126,20,42.0508,-70.5753,9,5,4,9,0,"MA",0.013
"5691",514,"199891.9310.10","MA",1998,5,6,126,13,42.2903,-70.8658,85,34,51,41,44,"MA",0.013
"5692",514,"199891.9320.11","MA",1998,5,7,127,20,42.3,-70.8513,72,31,41,59,13,"MA",0.013
"5693",514,"199891.9330.12","MA",1998,5,7,127,20,42.3112,-70.8013,131,74,57,86,45,"MA",0.013
"5694",514,"199891.9320.13","MA",1998,5,7,127,13,42.4328,-70.9108,50,8,42,38,12,"MA",0.013
"5695",514,"199891.9350.14","MA",1998,5,7,127,20,42.5212,-70.7155,2,1,1,2,0,"MA",0.013
"5696",514,"199891.9340.15","MA",1998,5,7,127,19,42.5458,-70.7377,3,3,0,2,1,"MA",0.013
"5697",514,"199891.9350.16","MA",1998,5,8,128,20,42.5982,-70.5682,12,6,6,12,0,"MA",0.013
"5698",514,"199891.9360.17","MA",1998,5,8,128,20,42.6252,-70.5123,6,3,3,5,1,"MA",0.013
"5699",514,"199891.9350.18","MA",1998,5,8,128,20,42.7018,-70.5777,27,10,17,27,0,"MA",0.013
"5700",514,"199891.9340.19","MA",1998,5,8,128,20,42.7302,-70.6752,0,0,0,0,0,"MA",0.013
"5701",514,"199891.9330.20","MA",1998,5,8,128,20,42.7887,-70.7553,0,0,0,0,0,"MA",0.013
"5702",514,"199891.9320.21","MA",1998,5,8,128,20,42.7353,-70.7613,10,3,7,10,0,"MA",0.013
"5703",514,"199891.9310.22","MA",1998,5,8,128,20,42.713,-70.7517,5,1,4,5,0,"MA",0.013
"5704",514,"199891.9350.23","MA",1998,5,8,128,20,42.7212,-70.6375,0,0,0,0,0,"MA",0.013
"5705",514,"199891.9350.24","MA",1998,5,9,129,20,42.5763,-70.6292,7,4,3,6,1,"MA",0.013
"5706",514,"199891.9360.25","MA",1998,5,9,129,18,42.475,-70.6375,9,1,8,9,0,"MA",0.013
"5707",521,"199891.9170.63","MA",1998,5,17,137,13,41.3692,-69.9925,0,0,0,0,0,"MA",0.013
"5708",521,"199891.9180.70","MA",1998,5,18,138,20,41.6578,-69.9093,1,0,1,1,0,"MA",0.013
"5709",521,"199891.9200.71","MA",1998,5,18,138,20,41.7668,-69.8657,1,0,1,1,0,"MA",0.013
"5710",521,"199891.9210.72","MA",1998,5,18,138,20,41.8208,-69.8735,0,0,0,0,0,"MA",0.013
"5711",521,"199891.9170.73","MA",1998,5,18,138,20,41.8237,-69.9312,1,0,1,0,1,"MA",0.013
"5712",521,"199891.9180.74","MA",1998,5,18,138,20,41.9275,-69.9632,7,6,1,4,3,"MA",0.013
"5713",514,"199891.9200.75","MA",1998,5,18,138,20,42.0667,-70.0267,0,0,0,0,0,"MA",0.013
"5714",514,"199891.9190.76","MA",1998,5,19,139,13,42.0967,-70.167,1,1,0,1,0,"MA",0.013
"5715",514,"199891.9210.77","MA",1998,5,19,139,20,42.0978,-70.223,3,2,1,3,0,"MA",0.013
"5716",514,"199891.9300.78","MA",1998,5,19,139,20,42.0633,-70.3142,0,0,0,0,0,"MA",0.013
"5717",514,"199891.9300.79","MA",1998,5,19,139,20,42.0715,-70.2823,1,1,0,1,0,"MA",0.013
"5718",514,"199891.9290.80","MA",1998,5,19,139,20,42.0437,-70.395,0,0,0,0,0,"MA",0.013
"5719",514,"199891.9290.81","MA",1998,5,19,139,20,41.9933,-70.3907,16,5,11,14,2,"MA",0.013
"5720",514,"199891.9290.82","MA",1998,5,19,139,20,41.9903,-70.2842,2,1,1,2,0,"MA",0.013
"5721",514,"199891.9280.83","MA",1998,5,19,139,20,41.9732,-70.2088,2,1,1,2,0,"MA",0.013
"5722",514,"199891.9280.84","MA",1998,5,19,139,20,41.941,-70.2522,7,1,6,7,0,"MA",0.013
"5723",514,"199891.9280.85","MA",1998,5,20,140,20,41.9343,-70.4718,5,0,5,5,0,"MA",0.013
"5724",514,"199891.9290.86","MA",1998,5,20,140,20,41.9497,-70.4268,4,1,3,4,0,"MA",0.013
"5725",514,"199891.9280.87","MA",1998,5,20,140,20,41.9137,-70.3947,3,1,2,2,1,"MA",0.013
"5726",514,"199891.9270.88","MA",1998,5,20,140,20,41.8478,-70.2255,2,1,1,2,0,"MA",0.013
"5727",514,"199891.9270.89","MA",1998,5,20,140,17,41.8493,-70.337,15,7,8,12,3,"MA",0.013
"5728",514,"199991.9270.1","MA",1999,5,11,131,20,41.776,-70.3678,4,2,2,3,1,"MA",0.013
"5729",514,"199991.9260.2","MA",1999,5,11,131,20,41.7585,-70.3362,12,4,8,9,3,"MA",0.013
"5730",514,"199991.9260.3","MA",1999,5,11,131,20,41.8263,-70.2075,12,2,10,12,0,"MA",0.013
"5731",514,"199991.9270.4","MA",1999,5,11,131,20,41.8055,-70.3538,5,3,2,5,0,"MA",0.013
"5732",514,"199991.9260.5","MA",1999,5,11,131,20,41.8072,-70.4947,38,12,26,32,6,"MA",0.013
"5733",514,"199991.9250.6","MA",1999,5,12,132,20,41.8177,-70.518,13,10,3,13,0,"MA",0.013
"5734",514,"199991.9270.7","MA",1999,5,12,132,18,41.9088,-70.4857,27,8,19,23,4,"MA",0.013
"5735",514,"199991.9260.8","MA",1999,5,12,132,20,41.9752,-70.5807,32,17,15,21,11,"MA",0.013
"5736",514,"199991.9280.9","MA",1999,5,12,132,20,42,-70.5347,7,3,4,7,0,"MA",0.013
"5737",514,"199991.9250.10","MA",1999,5,12,132,20,42.0592,-70.6392,74,15,59,41,33,"MA",0.013
"5738",514,"199991.9320.11","MA",1999,5,12,132,13,42.2838,-70.8103,84,55,29,58,26,"MA",0.013
"5739",514,"199991.9330.12","MA",1999,5,13,133,15,42.3927,-70.8228,18,10,8,17,1,"MA",0.013
"5740",514,"199991.9320.13","MA",1999,5,13,133,13,42.4102,-70.9537,70,26,44,52,18,"MA",0.013
"5741",514,"199991.9310.14","MA",1999,5,13,133,13,42.406,-70.9635,36,18,18,26,10,"MA",0.013
"5742",514,"199991.9350.15","MA",1999,5,13,133,17,42.4498,-70.817,0,0,0,0,0,"MA",0.013
"5743",514,"199991.9350.16","MA",1999,5,13,133,20,42.5115,-70.72,0,0,0,0,0,"MA",0.013
"5744",514,"199991.9340.17","MA",1999,5,13,133,20,42.544,-70.7377,1,0,1,1,0,"MA",0.013
"5745",514,"199991.9350.18","MA",1999,5,14,134,20,42.5907,-70.5798,13,9,4,13,0,"MA",0.013
"5746",514,"199991.9360.19","MA",1999,5,14,134,20,42.6375,-70.5088,1,1,0,1,0,"MA",0.013
"5747",514,"199991.9350.20","MA",1999,5,14,134,20,42.7215,-70.6257,1,1,0,1,0,"MA",0.013
"5748",514,"199991.9330.21","MA",1999,5,14,134,20,42.7022,-70.7013,2,2,0,2,0,"MA",0.013
"5749",514,"199991.9310.22","MA",1999,5,14,134,20,42.6988,-70.7425,17,10,7,16,1,"MA",0.013
"5750",514,"199991.9330.23","MA",1999,5,14,134,20,42.77,-70.761,0,0,0,0,0,"MA",0.013
"5751",514,"199991.9310.24","MA",1999,5,14,134,20,42.7712,-70.7933,50,27,23,47,3,"MA",0.013
"5752",514,"199991.9340.25","MA",1999,5,14,134,20,42.7358,-70.7128,2,1,1,2,0,"MA",0.013
"5753",514,"199991.9320.26","MA",1999,5,14,134,20,42.697,-70.7042,2,1,1,2,0,"MA",0.013
"5754",514,"199991.9360.27","MA",1999,5,14,134,20,42.7307,-70.6108,3,2,1,3,0,"MA",0.013
"5755",514,"199991.9350.28","MA",1999,5,15,135,20,42.5232,-70.7055,0,0,0,0,0,"MA",0.013
"5756",514,"199991.9360.29","MA",1999,5,15,135,20,42.4827,-70.65,9,0,9,9,0,"MA",0.013
"5757",514,"199991.9280.30","MA",1999,5,15,135,20,42.1022,-70.5338,1,0,1,1,0,"MA",0.013
"5758",514,"199991.9290.31","MA",1999,5,15,135,20,42.1025,-70.454,8,2,6,7,1,"MA",0.013
"5759",514,"199991.9290.32","MA",1999,5,15,135,20,42.0762,-70.5112,2,0,2,2,0,"MA",0.013
"5760",514,"199991.9290.33","MA",1999,5,16,136,20,41.9658,-70.3557,0,0,0,0,0,"MA",0.013
"5761",514,"199991.9290.34","MA",1999,5,16,136,20,42.0403,-70.308,0,0,0,0,0,"MA",0.013
"5762",514,"199991.9300.35","MA",1999,5,16,136,20,42.0627,-70.3513,1,0,1,1,0,"MA",0.013
"5763",514,"199991.9290.36","MA",1999,5,16,136,20,41.9948,-70.2383,0,0,0,0,0,"MA",0.013
"5764",514,"199991.9280.37","MA",1999,5,16,136,20,41.9743,-70.176,0,0,0,0,0,"MA",0.013
"5765",514,"199991.9280.38","MA",1999,5,16,136,20,41.9393,-70.2143,0,0,0,0,0,"MA",0.013
"5766",514,"199991.9280.39","MA",1999,5,16,136,20,41.885,-70.3125,2,0,2,2,0,"MA",0.013
"5767",514,"199991.9260.40","MA",1999,5,17,137,20,41.8897,-70.1277,9,1,8,9,0,"MA",0.013
"5768",514,"199991.9270.41","MA",1999,5,17,137,20,41.94,-70.145,0,0,0,0,0,"MA",0.013
"5769",514,"199991.9250.42","MA",1999,5,17,137,13,41.9665,-70.0933,4,0,4,4,0,"MA",0.013
"5770",514,"199991.9270.43","MA",1999,5,17,137,20,42.0078,-70.1443,0,0,0,0,0,"MA",0.013
"5771",514,"199991.9300.44","MA",1999,5,17,137,20,42.083,-70.2915,0,0,0,0,0,"MA",0.013
"5772",514,"199991.9210.45","MA",1999,5,17,137,20,42.1028,-70.2128,1,1,0,1,0,"MA",0.013
"5773",514,"199991.9200.46","MA",1999,5,18,138,20,42.1022,-70.1593,1,0,1,1,0,"MA",0.013
"5774",514,"199991.9170.47","MA",1999,5,18,138,20,42.085,-70.1392,0,0,0,0,0,"MA",0.013
"5775",514,"199991.9210.48","MA",1999,5,18,138,20,42.0825,-70.0305,0,0,0,0,0,"MA",0.013
"5776",514,"199991.9200.49","MA",1999,5,18,138,20,42.051,-70.0127,0,0,0,0,0,"MA",0.013
"5777",514,"199991.9170.50","MA",1999,5,18,138,13,42.0533,-70.069,1,1,0,1,0,"MA",0.013
"5778",521,"199991.9190.51","MA",1999,5,19,139,20,41.834,-69.916,1,1,0,1,0,"MA",0.013
"5779",521,"199991.9180.52","MA",1999,5,19,139,15,41.792,-69.9207,2,1,1,1,1,"MA",0.013
"5780",521,"199991.9180.53","MA",1999,5,19,139,20,41.7323,-69.8928,1,1,0,1,0,"MA",0.013
"5781",521,"199991.9170.74","MA",1999,5,22,142,20,41.3955,-69.9802,0,0,0,0,0,"MA",0.013
"5782",514,"200091.9270.1","MA",2000,5,9,130,20,41.7938,-70.3768,4,2,2,2,2,"MA",0.013
"5783",514,"200091.9260.2","MA",2000,5,9,130,20,41.7563,-70.2948,10,5,5,6,4,"MA",0.013
"5784",514,"200091.9250.3","MA",2000,5,9,130,20,41.8495,-70.15,5,0,5,5,0,"MA",0.013
"5785",514,"200091.9280.4","MA",2000,5,9,130,20,41.8747,-70.2325,3,1,2,3,0,"MA",0.013
"5786",514,"200091.9280.5","MA",2000,5,9,130,20,41.8958,-70.4175,8,2,6,8,0,"MA",0.013
"5787",514,"200091.9260.6","MA",2000,5,10,131,20,41.7968,-70.483,2,0,2,2,0,"MA",0.013
"5788",514,"200091.9250.7","MA",2000,5,10,131,13,42.0417,-70.6282,93,32,61,27,66,"MA",0.013
"5789",514,"200091.9270.8","MA",2000,5,10,131,20,42.0937,-70.5783,7,3,4,7,0,"MA",0.013
"5790",514,"200091.9330.9","MA",2000,5,11,132,20,42.3048,-70.8117,27,18,9,26,1,"MA",0.013
"5791",514,"200091.9340.10","MA",2000,5,11,132,14,42.39,-70.8233,21,9,12,19,2,"MA",0.013
"5792",514,"200091.9340.11","MA",2000,5,11,132,19,42.433,-70.858,7,2,5,6,1,"MA",0.013
"5793",514,"200091.9310.12","MA",2000,5,11,132,20,42.4405,-70.9167,48,12,36,39,9,"MA",0.013
"5794",514,"200091.9320.13","MA",2000,5,11,132,20,42.4415,-70.9033,30,18,12,24,6,"MA",0.013
"5795",514,"200091.9350.14","MA",2000,5,11,132,20,42.473,-70.7338,0,0,0,0,0,"MA",0.013
"5796",514,"200091.9350.15","MA",2000,5,11,132,20,42.522,-70.711,0,0,0,0,0,"MA",0.013
"5797",514,"200091.9350.16","MA",2000,5,12,133,20,42.5935,-70.5805,24,12,12,23,1,"MA",0.013
"5798",514,"200091.9350.17","MA",2000,5,12,133,20,42.6487,-70.5443,46,21,25,43,3,"MA",0.013
"5799",514,"200091.9360.18","MA",2000,5,12,133,20,42.713,-70.5562,12,6,6,8,4,"MA",0.013
"5800",514,"200091.9350.19","MA",2000,5,12,133,20,42.7088,-70.5965,12,5,7,12,0,"MA",0.013
"5801",514,"200091.9330.20","MA",2000,5,12,133,20,42.7087,-70.7148,6,3,3,6,0,"MA",0.013
"5802",514,"200091.9330.21","MA",2000,5,12,133,20,42.7,-70.6545,10,6,4,8,2,"MA",0.013
"5803",514,"200091.9320.22","MA",2000,5,12,133,20,42.7557,-70.7812,12,5,7,10,2,"MA",0.013
"5804",514,"200091.9310.23","MA",2000,5,12,133,20,42.7875,-70.8002,19,5,14,12,7,"MA",0.013
"5805",513,"200091.9310.24","MA",2000,5,12,133,13,42.835,-70.81,92,29,63,45,47,"MA",0.013
"5806",514,"200091.9340.25","MA",2000,5,12,133,20,42.8265,-70.7472,4,2,2,4,0,"MA",0.013
"5807",514,"200091.9350.26","MA",2000,5,13,134,20,42.567,-70.5992,5,2,3,5,0,"MA",0.013
"5808",514,"200091.9360.27","MA",2000,5,13,134,20,42.4702,-70.6313,7,4,3,7,0,"MA",0.013
"5809",514,"200091.9290.28","MA",2000,5,13,134,20,42.0868,-70.5048,1,0,1,1,0,"MA",0.013
"5810",514,"200091.9290.29","MA",2000,5,13,134,20,41.9743,-70.4553,1,1,0,1,0,"MA",0.013
"5811",514,"200091.9260.30","MA",2000,5,14,135,20,41.7585,-70.3705,8,5,3,7,1,"MA",0.013
"5812",514,"200091.9250.31","MA",2000,5,14,135,20,41.7497,-70.28,1,0,1,0,1,"MA",0.013
"5813",514,"200091.9270.32","MA",2000,5,14,135,20,41.8655,-70.2335,1,1,0,1,0,"MA",0.013
"5814",514,"200091.9260.33","MA",2000,5,14,135,20,41.8828,-70.1435,5,1,4,5,0,"MA",0.013
"5815",514,"200091.9260.34","MA",2000,5,14,135,20,41.919,-70.1188,7,1,6,7,0,"MA",0.013
"5816",514,"200091.9270.35","MA",2000,5,14,135,20,41.9797,-70.1362,7,1,6,7,0,"MA",0.013
"5817",514,"200091.9280.36","MA",2000,5,14,135,20,41.9493,-70.2342,0,0,0,0,0,"MA",0.013
"5818",514,"200091.9290.37","MA",2000,5,14,135,20,42.0098,-70.3343,1,0,1,1,0,"MA",0.013
"5819",514,"200091.9270.38","MA",2000,5,15,136,20,41.8613,-70.4538,36,17,19,23,13,"MA",0.013
"5820",514,"200091.9280.39","MA",2000,5,15,136,20,41.9405,-70.4773,8,4,4,6,2,"MA",0.013
"5821",514,"200091.9290.40","MA",2000,5,15,136,20,41.9557,-70.3977,5,1,4,5,0,"MA",0.013
"5822",514,"200091.9290.41","MA",2000,5,15,136,20,42.0138,-70.258,6,2,4,6,0,"MA",0.013
"5823",514,"200091.9280.42","MA",2000,5,15,136,20,41.9068,-70.3263,9,1,8,8,1,"MA",0.013
"5824",514,"200091.9300.43","MA",2000,5,16,137,20,42.1048,-70.4032,9,2,7,9,0,"MA",0.013
"5825",514,"200091.9300.44","MA",2000,5,16,137,20,42.0908,-70.2928,14,6,8,13,1,"MA",0.013
"5826",514,"200091.9210.45","MA",2000,5,16,137,20,42.1007,-70.1898,1,0,1,1,0,"MA",0.013
"5827",514,"200091.9210.46","MA",2000,5,16,137,20,42.1202,-70.2298,1,0,1,1,0,"MA",0.013
"5828",514,"200091.9200.47","MA",2000,5,16,137,20,42.1018,-70.1547,3,3,0,3,0,"MA",0.013
"5829",521,"200091.9170.48","MA",2000,5,17,138,20,41.8788,-69.9507,1,0,1,1,0,"MA",0.013
"5830",521,"200091.9180.49","MA",2000,5,17,138,20,41.9283,-69.9632,3,1,2,3,0,"MA",0.013
"5831",521,"200091.9190.50","MA",2000,5,17,138,20,41.8817,-69.93,2,2,0,2,0,"MA",0.013
"5832",521,"200091.9200.51","MA",2000,5,17,138,20,41.8198,-69.886,0,0,0,0,0,"MA",0.013
"5833",521,"200091.9170.52","MA",2000,5,17,138,20,41.7713,-69.9233,0,0,0,0,0,"MA",0.013
"5834",521,"200091.9180.53","MA",2000,5,17,138,20,41.7253,-69.901,2,1,1,2,0,"MA",0.013
"5835",521,"200091.9180.70","MA",2000,5,21,142,18,41.372,-69.9587,1,0,1,0,1,"MA",0.013
"5836",521,"200091.9170.71","MA",2000,5,21,142,20,41.3887,-69.9798,0,0,0,0,0,"MA",0.013
"5837",521,"200091.9170.72","MA",2000,5,21,142,20,41.3585,-69.9792,0,0,0,0,0,"MA",0.013
"5838",514,"200191.9260.1","MA",2001,5,8,128,20,41.767,-70.427,9,6,3,9,0,"MA",0.013
"5839",514,"200191.9260.2","MA",2001,5,8,128,20,41.7803,-70.2787,9,4,5,9,0,"MA",0.013
"5840",514,"200191.9260.3","MA",2001,5,8,128,20,41.8363,-70.193,5,1,4,5,0,"MA",0.013
"5841",514,"200191.9280.4","MA",2001,5,8,128,20,41.8988,-70.2138,2,0,2,2,0,"MA",0.013
"5842",514,"200191.9270.5","MA",2001,5,9,129,20,41.9095,-70.4853,8,3,5,6,2,"MA",0.013
"5843",514,"200191.9250.6","MA",2001,5,9,129,20,41.967,-70.6067,5,1,4,4,1,"MA",0.013
"5844",514,"200191.9260.7","MA",2001,5,9,129,20,41.9685,-70.5783,14,7,7,13,1,"MA",0.013
"5845",514,"200191.9250.8","MA",2001,5,9,129,15,42.138,-70.6793,10,4,6,4,6,"MA",0.013
"5846",514,"200191.9320.9","MA",2001,5,9,129,13,42.2347,-70.7412,29,14,15,18,11,"MA",0.013
"5847",514,"200191.9330.10","MA",2001,5,9,129,18,42.3085,-70.816,8,4,4,3,5,"MA",0.013
"5848",514,"200191.9320.11","MA",2001,5,9,129,13,42.2993,-70.8515,89,55,34,47,42,"MA",0.013
"5849",514,"200191.9310.12","MA",2001,5,10,130,13,42.4137,-70.9597,32,9,23,23,9,"MA",0.013
"5850",514,"200191.9340.13","MA",2001,5,10,130,20,42.4362,-70.8445,4,3,1,4,0,"MA",0.013
"5851",514,"200191.9350.14","MA",2001,5,10,130,15,42.5142,-70.7137,2,0,2,2,0,"MA",0.013
"5852",514,"200191.9340.15","MA",2001,5,10,130,17,42.5455,-70.7348,5,3,2,5,0,"MA",0.013
"5853",514,"200191.9350.16","MA",2001,5,10,130,20,42.593,-70.5772,3,0,3,3,0,"MA",0.013
"5854",514,"200191.9350.17","MA",2001,5,10,130,20,42.6053,-70.5738,4,3,1,3,1,"MA",0.013
"5855",514,"200191.9360.18","MA",2001,5,11,131,13,42.6613,-70.5325,28,9,19,28,0,"MA",0.013
"5856",514,"200191.9350.19","MA",2001,5,11,131,20,42.696,-70.5732,16,10,6,15,1,"MA",0.013
"5857",514,"200191.9320.20","MA",2001,5,11,131,20,42.6968,-70.7098,2,1,1,2,0,"MA",0.013
"5858",514,"200191.9330.21","MA",2001,5,11,131,20,42.7043,-70.7047,4,2,2,3,1,"MA",0.013
"5859",514,"200191.9310.22","MA",2001,5,11,131,20,42.729,-70.7717,2,1,1,1,1,"MA",0.013
"5860",514,"200191.9310.23","MA",2001,5,11,131,20,42.7785,-70.7967,2,2,0,2,0,"MA",0.013
"5861",513,"200191.9330.24","MA",2001,5,11,131,18,42.8463,-70.788,4,3,1,4,0,"MA",0.013
"5862",513,"200191.9340.25","MA",2001,5,11,131,20,42.8458,-70.754,0,0,0,0,0,"MA",0.013
"5863",514,"200191.9350.26","MA",2001,5,12,132,20,42.532,-70.6707,2,1,1,2,0,"MA",0.013
"5864",514,"200191.9360.27","MA",2001,5,12,132,20,42.5073,-70.6375,5,2,3,4,1,"MA",0.013
"5865",514,"200191.9270.28","MA",2001,5,12,132,13,42.0962,-70.5775,1,0,1,1,0,"MA",0.013
"5866",514,"200191.9280.29","MA",2001,5,12,132,20,41.9912,-70.5407,2,2,0,2,0,"MA",0.013
"5867",514,"200191.9270.30","MA",2001,5,13,133,20,41.8007,-70.344,19,9,10,10,9,"MA",0.013
"5868",514,"200191.9260.31","MA",2001,5,13,133,20,41.8822,-70.1448,9,1,8,9,0,"MA",0.013
"5869",514,"200191.9270.32","MA",2001,5,13,133,20,41.913,-70.1608,1,0,1,1,0,"MA",0.013
"5870",514,"200191.9270.33","MA",2001,5,13,133,16,41.997,-70.153,0,0,0,0,0,"MA",0.013
"5871",514,"200191.9250.34","MA",2001,5,13,133,20,42.0408,-70.1208,16,1,15,16,0,"MA",0.013
"5872",514,"200191.9280.35","MA",2001,5,13,133,20,41.9373,-70.2547,9,2,7,8,1,"MA",0.013
"5873",514,"200191.9280.36","MA",2001,5,14,134,20,41.8857,-70.3782,13,4,9,10,3,"MA",0.013
"5874",514,"200191.9290.37","MA",2001,5,14,134,20,42.0132,-70.4102,31,11,20,29,2,"MA",0.013
"5875",514,"200191.9290.38","MA",2001,5,14,134,20,42.031,-70.3203,2,0,2,2,0,"MA",0.013
"5876",514,"200191.9290.39","MA",2001,5,14,134,20,42.0532,-70.3725,6,0,6,5,1,"MA",0.013
"5877",514,"200191.9290.40","MA",2001,5,14,134,20,42.0188,-70.4612,26,11,15,22,4,"MA",0.013
"5878",514,"200191.9290.41","MA",2001,5,14,134,20,41.94,-70.3818,27,9,18,25,2,"MA",0.013
"5879",514,"200191.9280.42","MA",2001,5,14,134,20,41.8603,-70.4238,20,7,13,12,8,"MA",0.013
"5880",521,"200191.9180.75","MA",2001,5,20,140,20,41.3722,-69.957,0,0,0,0,0,"MA",0.013
"5881",521,"200191.9170.76","MA",2001,5,20,140,17,41.3615,-69.9807,0,0,0,0,0,"MA",0.013
"5882",521,"200191.9180.88","MA",2001,5,22,142,13,41.658,-69.9003,0,0,0,0,0,"MA",0.013
"5883",521,"200191.9190.89","MA",2001,5,22,142,20,41.8312,-69.9155,0,0,0,0,0,"MA",0.013
"5884",521,"200191.9200.90","MA",2001,5,22,142,20,41.83,-69.8882,0,0,0,0,0,"MA",0.013
"5885",521,"200191.9170.91","MA",2001,5,22,142,20,41.8925,-69.9552,3,1,2,2,1,"MA",0.013
"5886",521,"200191.9180.92","MA",2001,5,22,142,20,41.9275,-69.9627,8,4,4,8,0,"MA",0.013
"5887",514,"200191.9170.93","MA",2001,5,22,142,20,42.0072,-70.016,5,2,3,3,2,"MA",0.013
"5888",514,"200191.9210.94","MA",2001,5,23,143,20,42.0935,-70.2315,1,1,0,1,0,"MA",0.013
"5889",514,"200191.9200.95","MA",2001,5,23,143,20,42.1018,-70.1688,6,4,2,6,0,"MA",0.013
"5890",514,"200191.9210.96","MA",2001,5,23,143,20,42.1045,-70.2418,0,0,0,0,0,"MA",0.013
"5891",514,"200191.9300.97","MA",2001,5,23,143,20,42.0878,-70.2995,0,0,0,0,0,"MA",0.013
"5892",514,"200191.9300.98","MA",2001,5,23,143,20,42.0605,-70.2953,1,1,0,1,0,"MA",0.013
"5893",514,"200291.9250.1","MA",2002,5,7,127,20,41.7562,-70.4412,5,1,4,4,1,"MA",0.013
"5894",514,"200291.9250.2","MA",2002,5,7,127,20,41.743,-70.3787,1,0,1,1,0,"MA",0.013
"5895",514,"200291.9260.3","MA",2002,5,7,127,20,41.7598,-70.3367,7,6,1,5,2,"MA",0.013
"5896",514,"200291.9280.4","MA",2002,5,7,127,20,41.8793,-70.23,8,1,7,8,0,"MA",0.013
"5897",514,"200291.9280.5","MA",2002,5,7,127,20,41.8682,-70.3635,6,2,4,6,0,"MA",0.013
"5898",514,"200291.9270.6","MA",2002,5,7,127,20,41.8443,-70.426,9,4,5,6,3,"MA",0.013
"5899",514,"200291.9270.7","MA",2002,5,8,128,20,41.8557,-70.4515,17,9,8,13,4,"MA",0.013
"5900",514,"200291.9280.8","MA",2002,5,8,128,20,41.9383,-70.4728,15,5,10,11,4,"MA",0.013
"5901",514,"200291.9260.9","MA",2002,5,8,128,20,42.1482,-70.6815,23,12,11,16,7,"MA",0.013
"5902",514,"200291.9320.10","MA",2002,5,8,128,17,42.2382,-70.7405,131,60,71,68,63,"MA",0.013
"5903",514,"200291.9330.11","MA",2002,5,8,128,20,42.3092,-70.8117,22,12,10,21,1,"MA",0.013
"5904",514,"200291.9340.12","MA",2002,5,9,129,20,42.3902,-70.8205,19,13,6,14,5,"MA",0.013
"5905",514,"200291.9320.13","MA",2002,5,9,129,20,42.4127,-70.9445,19,9,10,17,2,"MA",0.013
"5906",514,"200291.9310.14","MA",2002,5,9,129,20,42.4515,-70.9177,10,5,5,5,5,"MA",0.013
"5907",514,"200291.9340.15","MA",2002,5,9,129,20,42.4387,-70.8452,10,9,1,9,1,"MA",0.013
"5908",514,"200291.9350.16","MA",2002,5,9,129,20,42.513,-70.7123,0,0,0,0,0,"MA",0.013
"5909",514,"200291.9350.17","MA",2002,5,9,129,20,42.5245,-70.6922,1,0,1,1,0,"MA",0.013
"5910",514,"200291.9330.18","MA",2002,5,9,129,14.7,42.6107,-70.6123,6,3,3,5,1,"MA",0.013
"5911",514,"200291.9350.19","MA",2002,5,10,130,20,42.698,-70.5708,13,9,4,11,2,"MA",0.013
"5912",514,"200291.9350.20","MA",2002,5,10,130,20,42.7145,-70.6143,15,5,10,15,0,"MA",0.013
"5913",514,"200291.9350.21","MA",2002,5,10,130,20,42.7362,-70.6578,4,2,2,4,0,"MA",0.013
"5914",514,"200291.9310.22","MA",2002,5,10,130,20,42.6828,-70.7157,9,2,7,7,2,"MA",0.013
"5915",514,"200291.9320.23","MA",2002,5,10,130,20,42.7453,-70.7667,5,2,3,5,0,"MA",0.013
"5916",514,"200291.9330.24","MA",2002,5,10,130,20,42.7842,-70.7615,2,0,2,2,0,"MA",0.013
"5917",513,"200291.9310.25","MA",2002,5,10,130,17,42.8432,-70.8107,6,2,4,2,4,"MA",0.013
"5918",514,"200291.9340.26","MA",2002,5,10,130,14,42.8257,-70.7438,0,0,0,0,0,"MA",0.013
"5919",514,"200291.9360.27","MA",2002,5,11,131,14,42.7083,-70.5563,11,8,3,8,3,"MA",0.013
"5920",514,"200291.9360.28","MA",2002,5,11,131,20,42.5082,-70.6377,1,0,1,1,0,"MA",0.013
"5921",514,"200291.9350.29","MA",2002,5,11,131,20,42.3822,-70.7008,0,0,0,0,0,"MA",0.013
"5922",514,"200291.9350.30","MA",2002,5,11,131,13,42.3343,-70.7065,1,0,1,0,1,"MA",0.013
"5923",514,"200291.9290.31","MA",2002,5,11,131,20,42.0143,-70.4567,3,1,2,3,0,"MA",0.013
"5924",514,"200291.9260.32","MA",2002,5,12,132,20,41.8102,-70.4958,6,3,3,5,1,"MA",0.013
"5925",514,"200291.9280.33","MA",2002,5,12,132,20,41.8715,-70.4277,6,4,2,5,1,"MA",0.013
"5926",514,"200291.9290.34","MA",2002,5,12,132,20,41.9735,-70.4382,3,1,2,3,0,"MA",0.013
"5927",514,"200291.9290.35","MA",2002,5,12,132,20,41.9677,-70.3745,13,5,8,13,0,"MA",0.013
"5928",514,"200291.9290.36","MA",2002,5,12,132,13,42.0122,-70.3627,14,10,4,14,0,"MA",0.013
"5929",514,"200291.9300.37","MA",2002,5,12,132,20,42.0592,-70.3247,1,0,1,1,0,"MA",0.013
"5930",514,"200291.9300.38","MA",2002,5,12,132,20,42.101,-70.2753,0,0,0,0,0,"MA",0.013
"5931",514,"200291.9290.39","MA",2002,5,12,132,20,41.9603,-70.306,3,0,3,3,0,"MA",0.013
"5932",514,"200291.9270.40","MA",2002,5,13,133,20,41.7905,-70.3925,7,5,2,7,0,"MA",0.013
"5933",514,"200291.9260.41","MA",2002,5,13,133,20,41.8243,-70.122,3,1,2,3,0,"MA",0.013
"5934",514,"200291.9270.42","MA",2002,5,13,133,20,41.8775,-70.1823,10,1,9,10,0,"MA",0.013
"5935",514,"200291.9250.43","MA",2002,5,13,133,20,41.8693,-70.1353,6,0,6,6,0,"MA",0.013
"5936",514,"200291.9260.44","MA",2002,5,13,133,13,41.9433,-70.1072,10,0,10,10,0,"MA",0.013
"5937",514,"200291.9270.45","MA",2002,5,13,133,19,42.019,-70.1497,1,0,1,1,0,"MA",0.013
"5938",514,"200291.9280.46","MA",2002,5,13,133,20,41.9618,-70.208,2,1,1,2,0,"MA",0.013
"5939",514,"200291.9180.47","MA",2002,5,14,134,20,42.06,-70.0755,0,0,0,0,0,"MA",0.013
"5940",514,"200291.9180.48","MA",2002,5,14,134,13,42.0285,-70.0265,0,0,0,0,0,"MA",0.013
"5941",514,"200291.9170.49","MA",2002,5,14,134,20,42.0073,-70.0148,1,1,0,1,0,"MA",0.013
"5942",514,"200291.9210.50","MA",2002,5,14,134,20,42.0755,-70.0203,0,0,0,0,0,"MA",0.013
"5943",514,"200291.9210.51","MA",2002,5,14,134,20,42.1077,-70.2247,0,0,0,0,0,"MA",0.013
"5944",521,"200291.9200.52","MA",2002,5,15,135,13,41.826,-69.8865,0,0,0,0,0,"MA",0.013
"5945",521,"200291.9200.53","MA",2002,5,15,135,20,41.79,-69.8738,0,0,0,0,0,"MA",0.013
"5946",521,"200291.9170.54","MA",2002,5,15,135,20,41.7953,-69.9237,1,1,0,1,0,"MA",0.013
"5947",521,"200291.9190.55","MA",2002,5,15,135,13,41.7107,-69.8755,5,1,4,5,0,"MA",0.013
"5948",514,"200391.9270.1","MA",2003,5,6,126,20,41.8487,-70.4185,8,2,6,6,2,"MA",0.013
"5949",514,"200391.9270.2","MA",2003,5,6,126,20,41.8472,-70.3263,2,0,2,2,0,"MA",0.013
"5950",514,"200391.9270.3","MA",2003,5,6,126,20,41.8442,-70.2297,3,0,3,2,1,"MA",0.013
"5951",514,"200391.9260.4","MA",2003,5,6,126,20,41.7857,-70.1745,0,0,0,0,0,"MA",0.013
"5952",514,"200391.9280.6","MA",2003,5,7,127,20,41.9493,-70.4775,6,2,4,2,4,"MA",0.013
"5953",514,"200391.9270.7","MA",2003,5,7,127,20,42.1157,-70.5685,3,0,3,3,0,"MA",0.013
"5954",514,"200391.9250.8","MA",2003,5,7,127,20,42.1473,-70.6855,5,1,4,0,5,"MA",0.013
"5955",514,"200391.9340.9","MA",2003,5,7,127,20,42.3075,-70.7168,0,0,0,0,0,"MA",0.013
"5956",514,"200391.9320.10","MA",2003,5,7,127,16,42.284,-70.798,6,3,3,6,0,"MA",0.013
"5957",514,"200391.9310.11","MA",2003,5,7,127,20,42.2927,-70.8633,2,1,1,1,1,"MA",0.013
"5958",514,"200391.9330.12","MA",2003,5,7,127,20,42.315,-70.8022,2,1,1,2,0,"MA",0.013
"5959",514,"200391.9320.13","MA",2003,5,8,128,13,42.4095,-70.9298,15,1,14,13,2,"MA",0.013
"5960",514,"200391.9350.14","MA",2003,5,8,128,20,42.4503,-70.8197,2,2,0,2,0,"MA",0.013
"5961",514,"200391.9350.15","MA",2003,5,8,128,17,42.4805,-70.7523,1,1,0,1,0,"MA",0.013
"5962",514,"200391.9350.16","MA",2003,5,8,128,20,42.522,-70.6767,1,1,0,1,0,"MA",0.013
"5963",514,"200391.9350.17","MA",2003,5,8,128,20,42.5913,-70.5813,7,5,2,7,0,"MA",0.013
"5964",514,"200391.9340.18","MA",2003,5,8,128,20,42.5475,-70.7233,0,0,0,0,0,"MA",0.013
"5965",514,"200391.9360.19","MA",2003,5,9,129,16,42.7117,-70.5478,7,2,5,5,2,"MA",0.013
"5966",514,"200391.9350.20","MA",2003,5,9,129,20,42.7255,-70.621,22,11,11,22,0,"MA",0.013
"5967",514,"200391.9330.21","MA",2003,5,9,129,20,42.7003,-70.6662,9,4,5,8,1,"MA",0.013
"5968",514,"200391.9310.22","MA",2003,5,9,129,20,42.7088,-70.7518,2,1,1,2,0,"MA",0.013
"5969",514,"200391.9320.23","MA",2003,5,9,129,18,42.7295,-70.7533,1,0,1,1,0,"MA",0.013
"5970",514,"200391.9310.24","MA",2003,5,9,129,20,42.7787,-70.7978,6,2,4,4,2,"MA",0.013
"5971",514,"200391.9330.25","MA",2003,5,9,129,20,42.7962,-70.764,0,0,0,0,0,"MA",0.013
"5972",513,"200391.9340.26","MA",2003,5,9,129,20,42.8345,-70.7498,0,0,0,0,0,"MA",0.013
"5973",514,"200391.9360.27","MA",2003,5,10,130,20,42.4833,-70.646,1,1,0,1,0,"MA",0.013
"5974",514,"200391.9350.28","MA",2003,5,10,130,20,42.3812,-70.6913,2,1,1,2,0,"MA",0.013
"5975",514,"200391.9290.29","MA",2003,5,10,130,20,42.0573,-70.4635,1,0,1,1,0,"MA",0.013
"5976",514,"200391.9280.30","MA",2003,5,10,130,20,41.9027,-70.403,7,3,4,5,2,"MA",0.013
"5977",514,"200391.9280.31","MA",2003,5,10,130,20,41.8742,-70.4437,6,2,4,4,2,"MA",0.013
"5978",514,"200391.9250.32","MA",2003,5,10,130,15.5,41.8455,-70.521,1,0,1,0,1,"MA",0.013
"5979",514,"200391.9260.33","MA",2003,5,11,131,15,41.7623,-70.3863,0,0,0,0,0,"MA",0.013
"5980",514,"200391.9260.34","MA",2003,5,11,131,20,41.752,-70.2985,6,4,2,5,1,"MA",0.013
"5981",514,"200391.9260.35","MA",2003,5,11,131,20,41.8895,-70.1438,5,2,3,4,1,"MA",0.013
"5982",514,"200391.9250.36","MA",2003,5,11,131,18,41.9603,-70.0952,15,2,13,14,1,"MA",0.013
"5983",514,"200391.9270.37","MA",2003,5,11,131,20,41.9992,-70.154,2,1,1,2,0,"MA",0.013
"5984",514,"200391.9280.38","MA",2003,5,11,131,20,41.9923,-70.1827,4,0,4,4,0,"MA",0.013
"5985",514,"200391.9280.39","MA",2003,5,11,131,20,41.8992,-70.196,0,0,0,0,0,"MA",0.013
"5986",514,"200391.9290.40","MA",2003,5,12,132,20,41.9317,-70.4368,9,6,3,5,4,"MA",0.013
"5987",514,"200391.9290.41","MA",2003,5,12,132,20,42.0092,-70.472,3,0,3,3,0,"MA",0.013
"5988",514,"200391.9300.42","MA",2003,5,12,132,14,42.0938,-70.3988,2,1,1,2,0,"MA",0.013
"5989",514,"200391.9300.43","MA",2003,5,12,132,14,42.1082,-70.413,4,0,4,4,0,"MA",0.013
"5990",514,"200391.9290.44","MA",2003,5,12,132,20,42.0262,-70.3158,7,0,7,7,0,"MA",0.013
"5991",514,"200391.9290.45","MA",2003,5,13,133,13,42.0335,-70.2453,0,0,0,0,0,"MA",0.013
"5992",514,"200391.9210.46","MA",2003,5,13,133,20,42.1018,-70.2148,2,1,1,2,0,"MA",0.013
"5993",514,"200391.9210.47","MA",2003,5,13,133,20,42.1273,-70.1748,1,1,0,1,0,"MA",0.013
"5994",514,"200391.9180.48","MA",2003,5,13,133,20,42.0188,-70.02,2,2,0,2,0,"MA",0.013
"5995",514,"200391.9200.49","MA",2003,5,13,133,15,42.0988,-70.1203,1,1,0,1,0,"MA",0.013
"5996",521,"200391.9170.50","MA",2003,5,14,134,20,41.947,-69.9752,0,0,0,0,0,"MA",0.013
"5997",521,"200391.9170.51","MA",2003,5,14,134,20,41.787,-69.9238,0,0,0,0,0,"MA",0.013
"5998",521,"200391.9200.52","MA",2003,5,14,134,20,41.7502,-69.8592,0,0,0,0,0,"MA",0.013
"5999",521,"200391.9180.53","MA",2003,5,14,134,13,41.6872,-69.8817,0,0,0,0,0,"MA",0.013
"6000",521,"200391.9190.54","MA",2003,5,14,134,13,41.687,-69.865,1,0,1,1,0,"MA",0.013
"6001",521,"200391.9170.74","MA",2003,5,18,138,20,41.3978,-69.9825,0,0,0,0,0,"MA",0.013
"6002",521,"200391.9180.75","MA",2003,5,18,138,19,41.3623,-69.9527,0,0,0,0,0,"MA",0.013
"6003",514,"200491.9270.1","MA",2004,5,3,124,20,41.8348,-70.3668,0,0,0,0,0,"MA",0.013
"6004",514,"200491.9280.2","MA",2004,5,3,124,20,41.8767,-70.3645,1,0,1,0,1,"MA",0.013
"6005",514,"200491.9270.3","MA",2004,5,3,124,20,41.8513,-70.421,3,1,2,3,0,"MA",0.013
"6006",514,"200491.9260.4","MA",2004,5,3,124,19,41.86,-70.5033,1,0,1,1,0,"MA",0.013
"6007",514,"200491.9250.5","MA",2004,5,3,124,20,41.8178,-70.5185,1,0,1,1,0,"MA",0.013
"6008",514,"200491.9270.6","MA",2004,5,4,125,20,41.7727,-70.3572,4,1,3,4,0,"MA",0.013
"6009",514,"200491.9260.7","MA",2004,5,4,125,20,41.7842,-70.248,8,2,6,8,0,"MA",0.013
"6010",514,"200491.9260.8","MA",2004,5,4,125,16,41.7997,-70.1725,1,0,1,1,0,"MA",0.013
"6011",514,"200491.9250.9","MA",2004,5,4,125,20,41.8073,-70.0673,1,1,0,1,0,"MA",0.013
"6012",514,"200491.9260.10","MA",2004,5,4,125,17,41.877,-70.1525,1,0,1,1,0,"MA",0.013
"6013",514,"200491.9270.11","MA",2004,5,4,125,20,41.9392,-70.1428,3,0,3,3,0,"MA",0.013
"6014",514,"200491.9270.12","MA",2004,5,4,125,20,42.014,-70.1393,3,1,2,3,0,"MA",0.013
"6015",514,"200491.9300.13","MA",2004,5,5,126,18,42.0662,-70.3025,3,3,0,3,0,"MA",0.013
"6016",514,"200491.9300.14","MA",2004,5,5,126,20,42.0678,-70.3905,5,0,5,5,0,"MA",0.013
"6017",514,"200491.9290.15","MA",2004,5,5,126,20,41.967,-70.45,10,3,7,8,2,"MA",0.013
"6018",514,"200491.9280.16","MA",2004,5,5,126,20,41.9757,-70.5163,12,7,5,11,1,"MA",0.013
"6019",514,"200491.9260.17","MA",2004,5,5,126,20,41.9842,-70.5848,5,3,2,4,1,"MA",0.013
"6020",514,"200491.9250.18","MA",2004,5,5,126,20,42.1357,-70.6815,1,0,1,1,0,"MA",0.013
"6021",514,"200491.9310.19","MA",2004,5,6,127,14,42.2833,-70.8577,10,8,2,6,4,"MA",0.013
"6022",514,"200491.9330.20","MA",2004,5,6,127,20,42.3152,-70.7918,7,6,1,6,1,"MA",0.013
"6023",514,"200491.9340.21","MA",2004,5,6,127,15,42.3083,-70.7125,2,1,1,2,0,"MA",0.013
"6024",514,"200491.9320.22","MA",2004,5,6,127,14.5,42.286,-70.801,0,0,0,0,0,"MA",0.013
"6025",514,"200491.9340.23","MA",2004,5,6,127,13,42.3912,-70.8213,0,0,0,0,0,"MA",0.013
"6026",514,"200491.9320.24","MA",2004,5,7,128,14,42.4505,-70.9073,3,0,3,3,0,"MA",0.013
"6027",514,"200491.9350.25","MA",2004,5,7,128,17,42.4605,-70.8077,2,1,1,2,0,"MA",0.013
"6028",514,"200491.9350.26","MA",2004,5,7,128,15,42.4602,-70.7162,0,0,0,0,0,"MA",0.013
"6029",514,"200491.9350.27","MA",2004,5,7,128,20,42.5142,-70.7128,2,1,1,2,0,"MA",0.013
"6030",514,"200491.9360.28","MA",2004,5,7,128,20,42.4872,-70.652,2,0,2,2,0,"MA",0.013
"6031",514,"200491.9350.29","MA",2004,5,7,128,20,42.5297,-70.6708,3,1,2,3,0,"MA",0.013
"6032",514,"200491.9340.30","MA",2004,5,8,129,20,42.7035,-70.647,37,21,16,33,4,"MA",0.013
"6033",514,"200491.9330.31","MA",2004,5,8,129,20,42.6948,-70.6628,12,7,5,12,0,"MA",0.013
"6034",514,"200491.9350.32","MA",2004,5,8,129,20,42.7333,-70.6682,3,2,1,2,1,"MA",0.013
"6035",514,"200491.9330.33","MA",2004,5,8,129,20,42.7658,-70.7478,3,3,0,3,0,"MA",0.013
"6036",513,"200491.9310.34","MA",2004,5,8,129,20,42.8422,-70.8117,0,0,0,0,0,"MA",0.013
"6037",514,"200491.9320.35","MA",2004,5,8,129,20,42.7827,-70.7892,11,3,8,8,3,"MA",0.013
"6038",514,"200491.9310.36","MA",2004,5,8,129,20,42.7055,-70.7465,0,0,0,0,0,"MA",0.013
"6039",514,"200491.9360.37","MA",2004,5,9,130,20,42.6052,-70.538,15,5,10,14,1,"MA",0.013
"6040",514,"200491.9350.38","MA",2004,5,9,130,20,42.6513,-70.5403,43,18,25,36,7,"MA",0.013
"6041",514,"200491.9280.39","MA",2004,5,10,131,20,41.9548,-70.4818,8,6,2,7,1,"MA",0.013
"6042",514,"200491.9290.40","MA",2004,5,10,131,20,41.9418,-70.385,3,2,1,3,0,"MA",0.013
"6043",514,"200491.9290.41","MA",2004,5,10,131,20,41.9635,-70.3493,3,1,2,3,0,"MA",0.013
"6044",514,"200491.9280.42","MA",2004,5,10,131,20,41.885,-70.2673,1,1,0,1,0,"MA",0.013
"6045",514,"200491.9280.43","MA",2004,5,10,131,20,41.9508,-70.2227,0,0,0,0,0,"MA",0.013
"6046",514,"200491.9290.44","MA",2004,5,10,131,20,42.0363,-70.3223,3,1,2,3,0,"MA",0.013
"6047",514,"200491.9290.45","MA",2004,5,10,131,20,41.9927,-70.2223,2,0,2,2,0,"MA",0.013
"6048",514,"200491.9210.46","MA",2004,5,11,132,20,42.0975,-70.2158,0,0,0,0,0,"MA",0.013
"6049",514,"200491.9200.47","MA",2004,5,11,132,20,42.1023,-70.1437,0,0,0,0,0,"MA",0.013
"6050",514,"200491.9170.48","MA",2004,5,11,132,20,42.0482,-70.0568,0,0,0,0,0,"MA",0.013
"6051",514,"200491.9210.49","MA",2004,5,11,132,20,42.0682,-70.016,0,0,0,0,0,"MA",0.013
"6052",521,"200491.9190.50","MA",2004,5,11,132,20,41.979,-69.973,0,0,0,0,0,"MA",0.013
"6053",514,"200491.9180.51","MA",2004,5,11,132,20,41.9998,-70.009,4,1,3,1,3,"MA",0.013
"6054",521,"200491.9170.52","MA",2004,5,12,133,20,41.8663,-69.9433,3,2,1,2,1,"MA",0.013
"6055",521,"200491.9200.53","MA",2004,5,12,133,20,41.8178,-69.8835,2,0,2,2,0,"MA",0.013
"6056",521,"200491.9180.54","MA",2004,5,12,133,20,41.7838,-69.9135,5,1,4,4,1,"MA",0.013
"6057",514,"200591.9260.1","MA",2005,5,10,130,20,41.762,-70.3815,13,10,3,8,5,"MA",0.013
"6058",514,"200591.9250.2","MA",2005,5,10,130,20,41.7458,-70.38,11,5,6,4,7,"MA",0.013
"6059",514,"200591.9260.3","MA",2005,5,10,130,19,41.7798,-70.2585,1,0,1,0,1,"MA",0.013
"6060",514,"200591.9260.4","MA",2005,5,10,130,16.2,41.7848,-70.1633,1,0,1,1,0,"MA",0.013
"6061",514,"200591.9250.5","MA",2005,5,10,130,20,41.83,-70.111,0,0,0,0,0,"MA",0.013
"6062",514,"200591.9270.6","MA",2005,5,10,130,20,41.8445,-70.253,5,0,5,5,0,"MA",0.013
"6063",514,"200591.9260.7","MA",2005,5,11,131,20,41.8228,-70.4957,8,5,3,2,6,"MA",0.013
"6064",514,"200591.9270.8","MA",2005,5,11,131,20,41.9228,-70.5,54,28,26,38,16,"MA",0.013
"6065",514,"200591.9250.9","MA",2005,5,11,131,20,41.9568,-70.6067,28,14,14,7,21,"MA",0.013
"6066",514,"200591.9280.10","MA",2005,5,11,131,13,42.0707,-70.5602,30,18,12,18,12,"MA",0.013
"6067",514,"200591.9270.11","MA",2005,5,11,131,20,42.1112,-70.5528,5,1,4,5,0,"MA",0.013
"6068",514,"200591.9320.12","MA",2005,5,11,131,20,42.296,-70.8512,58,32,26,49,9,"MA",0.013
"6069",514,"200591.9350.13","MA",2005,5,12,132,13,42.3208,-70.7117,10,6,4,10,0,"MA",0.013
"6070",514,"200591.9310.14","MA",2005,5,12,132,18,42.4535,-70.9157,18,4,14,13,5,"MA",0.013
"6071",514,"200591.9330.15","MA",2005,5,12,132,20,42.4475,-70.8787,22,15,7,20,2,"MA",0.013
"6072",514,"200591.9320.16","MA",2005,5,13,133,20,42.4133,-70.9465,32,13,19,24,8,"MA",0.013
"6073",514,"200591.9340.17","MA",2005,5,13,133,20,42.4878,-70.7602,5,5,0,5,0,"MA",0.013
"6074",514,"200591.9350.18","MA",2005,5,13,133,20,42.5198,-70.7105,1,1,0,1,0,"MA",0.013
"6075",514,"200591.9340.19","MA",2005,5,13,133,20,42.5443,-70.7353,12,6,6,11,1,"MA",0.013
"6076",514,"200591.9350.20","MA",2005,5,13,133,16,42.5838,-70.6073,18,6,12,17,1,"MA",0.013
"6077",514,"200591.9360.21","MA",2005,5,16,136,20,42.4957,-70.652,3,1,2,3,0,"MA",0.013
"6078",514,"200591.9360.22","MA",2005,5,17,137,20,42.661,-70.522,3,2,1,3,0,"MA",0.013
"6079",514,"200591.9350.23","MA",2005,5,17,137,20,42.7018,-70.5922,46,28,18,43,3,"MA",0.013
"6080",514,"200591.9340.24","MA",2005,5,17,137,20,42.7155,-70.6658,7,3,4,5,2,"MA",0.013
"6081",514,"200591.9330.25","MA",2005,5,17,137,20,42.767,-70.7557,6,5,1,4,2,"MA",0.013
"6082",514,"200591.9310.26","MA",2005,5,17,137,20,42.7127,-70.7562,22,11,11,19,3,"MA",0.013
"6083",514,"200591.9310.27","MA",2005,5,17,137,20,42.6808,-70.7062,19,9,10,19,0,"MA",0.013
"6084",514,"200591.9320.28","MA",2005,5,17,137,16,42.6935,-70.6965,15,5,10,11,4,"MA",0.013
"6085",514,"200591.9330.29","MA",2005,5,17,137,20,42.6995,-70.6705,21,9,12,18,3,"MA",0.013
"6086",514,"200591.9350.30","MA",2005,5,17,137,20,42.7403,-70.6605,6,2,4,5,1,"MA",0.013
"6087",514,"200591.9280.31","MA",2005,5,18,138,20,41.907,-70.3665,3,1,2,2,1,"MA",0.013
"6088",514,"200591.9290.32","MA",2005,5,18,138,20,41.9433,-70.3387,4,1,3,4,0,"MA",0.013
"6089",514,"200591.9290.33","MA",2005,5,18,138,20,41.9995,-70.265,1,0,1,1,0,"MA",0.013
"6090",514,"200591.9280.34","MA",2005,5,18,138,20,41.9958,-70.1772,0,0,0,0,0,"MA",0.013
"6091",514,"200591.9280.35","MA",2005,5,18,138,20,41.9605,-70.1607,3,0,3,3,0,"MA",0.013
"6092",514,"200591.9260.36","MA",2005,5,18,138,20,41.8838,-70.1518,3,0,3,3,0,"MA",0.013
"6093",514,"200591.9270.37","MA",2005,5,18,138,20,41.9337,-70.162,4,0,4,3,1,"MA",0.013
"6094",514,"200591.9300.38","MA",2005,5,18,138,20,42.0647,-70.2773,3,3,0,3,0,"MA",0.013
"6095",514,"200591.9290.39","MA",2005,5,19,139,17.6,42.0485,-70.4305,3,0,3,2,1,"MA",0.013
"6096",514,"200591.9290.40","MA",2005,5,19,139,20,42.0772,-70.4257,3,0,3,2,1,"MA",0.013
"6097",514,"200591.9300.41","MA",2005,5,19,139,20,42.1027,-70.4467,1,1,0,1,0,"MA",0.013
"6098",514,"200591.9210.42","MA",2005,5,19,139,20,42.1128,-70.22,0,0,0,0,0,"MA",0.013
"6099",514,"200591.9210.43","MA",2005,5,19,139,20,42.0837,-70.033,0,0,0,0,0,"MA",0.013
"6100",514,"200591.9200.44","MA",2005,5,19,139,20,42.0555,-70.0197,0,0,0,0,0,"MA",0.013
"6101",521,"200591.9170.45","MA",2005,5,19,139,20,41.88,-69.9498,8,3,5,1,7,"MA",0.013
"6102",521,"200591.9190.46","MA",2005,5,20,140,20,41.9033,-69.9382,11,7,4,9,2,"MA",0.013
"6103",521,"200591.9180.47","MA",2005,5,20,140,18.4,41.7985,-69.912,4,2,2,4,0,"MA",0.013
"6104",521,"200591.9200.48","MA",2005,5,20,140,20,41.7957,-69.8738,0,0,0,0,0,"MA",0.013
"6105",521,"200591.9180.49","MA",2005,5,20,140,16,41.6302,-69.9007,3,3,0,3,0,"MA",0.013
"6106",521,"200591.9170.50","MA",2005,5,20,140,20,41.5807,-69.9475,0,0,0,0,0,"MA",0.013
"6107",521,"200591.9180.89","MA",2005,5,28,148,20,41.4393,-69.9965,0,0,0,0,0,"MA",0.013
"6108",521,"200591.9170.90","MA",2005,5,28,148,20,41.364,-69.982,0,0,0,0,0,"MA",0.013
"6109",514,"200691.9260.1","MA",2006,5,8,128,20,41.8092,-70.475,2,1,1,2,0,"MA",0.013
"6110",514,"200691.9250.2","MA",2006,5,8,128,20,41.744,-70.3583,2,0,2,2,0,"MA",0.013
"6111",514,"200691.9260.3","MA",2006,5,8,128,17.5,41.8258,-70.4763,4,1,3,4,0,"MA",0.013
"6112",514,"200691.9270.4","MA",2006,5,8,128,20,41.8608,-70.4723,10,2,8,7,3,"MA",0.013
"6113",514,"200691.9280.5","MA",2006,5,8,128,15,41.8722,-70.3907,6,2,4,5,1,"MA",0.013
"6114",514,"200691.9270.26","MA",2006,5,13,133,20,41.8148,-70.3568,3,0,3,2,1,"MA",0.013
"6115",514,"200691.9280.27","MA",2006,5,13,133,20,41.9195,-70.433,10,1,9,9,1,"MA",0.013
"6116",514,"200691.9280.28","MA",2006,5,13,133,20,41.9017,-70.2963,6,0,6,6,0,"MA",0.013
"6117",514,"200691.9260.29","MA",2006,5,13,133,18.5,41.8018,-70.1913,3,0,3,3,0,"MA",0.013
"6118",514,"200691.9250.30","MA",2006,5,13,133,20,41.8273,-70.1112,0,0,0,0,0,"MA",0.013
"6119",514,"200691.9290.31","MA",2006,5,15,135,20,41.9687,-70.4522,3,3,0,3,0,"MA",0.013
"6120",514,"200691.9290.32","MA",2006,5,15,135,20,41.9527,-70.3395,2,0,2,2,0,"MA",0.013
"6121",514,"200691.9280.33","MA",2006,5,15,135,20,41.9148,-70.3437,1,0,1,1,0,"MA",0.013
"6122",514,"200691.9270.34","MA",2006,5,15,135,20,41.8545,-70.2818,1,1,0,0,1,"MA",0.013
"6123",514,"200691.9280.35","MA",2006,5,15,135,20,41.8717,-70.242,6,4,2,5,1,"MA",0.013
"6124",514,"200691.9250.36","MA",2006,5,15,135,20,41.8387,-70.1648,6,2,4,6,0,"MA",0.013
"6125",514,"200691.9250.37","MA",2006,5,16,136,20,42.044,-70.63,59,21,38,14,45,"MA",0.013
"6126",514,"200691.9290.38","MA",2006,5,16,136,20,42.0617,-70.514,1,1,0,1,0,"MA",0.013
"6127",514,"200691.9290.39","MA",2006,5,16,136,20,42.0812,-70.45,0,0,0,0,0,"MA",0.013
"6128",514,"200691.9260.40","MA",2006,5,16,136,13,42.1443,-70.68,121,43,78,79,42,"MA",0.013
"6129",514,"200691.9330.41","MA",2006,5,16,136,20,42.3122,-70.8018,32,16,16,29,3,"MA",0.013
"6130",514,"200691.9310.42","MA",2006,5,17,137,20,42.2798,-70.8518,109,46,63,62,47,"MA",0.013
"6131",514,"200691.9320.43","MA",2006,5,17,137,15,42.2857,-70.8557,99,50,49,64,35,"MA",0.013
"6132",514,"200691.9320.44","MA",2006,5,17,137,13,42.4133,-70.9445,83,40,43,62,21,"MA",0.013
"6133",514,"200691.9330.45","MA",2006,5,17,137,20,42.4483,-70.8743,45,20,25,38,7,"MA",0.013
"6134",514,"200691.9340.46","MA",2006,5,17,137,20,42.4388,-70.8342,10,8,2,10,0,"MA",0.013
"6135",514,"200691.9350.47","MA",2006,5,17,137,13,42.4733,-70.741,1,0,1,1,0,"MA",0.013
"6136",514,"200691.9350.48","MA",2006,5,18,138,15,42.3275,-70.7007,7,3,4,7,0,"MA",0.013
"6137",514,"200691.9350.49","MA",2006,5,18,138,20,42.381,-70.6968,4,2,2,4,0,"MA",0.013
"6138",514,"200691.9360.50","MA",2006,5,18,138,20,42.4953,-70.6447,3,0,3,3,0,"MA",0.013
"6139",514,"200691.9340.51","MA",2006,5,18,138,20,42.5458,-70.7337,15,11,4,13,2,"MA",0.013
"6140",514,"200691.9350.52","MA",2006,5,18,138,13,42.5877,-70.5835,32,19,13,30,2,"MA",0.013
"6141",514,"200691.9350.53","MA",2006,5,19,139,18.5,42.6892,-70.5623,76,44,32,64,12,"MA",0.013
"6142",514,"200691.9360.54","MA",2006,5,19,139,20,42.7283,-70.5982,23,8,15,21,2,"MA",0.013
"6143",514,"200691.9340.55","MA",2006,5,19,139,20,42.7133,-70.6863,8,1,7,7,1,"MA",0.013
"6144",514,"200691.9310.56","MA",2006,5,19,139,20,42.681,-70.7022,23,8,15,19,4,"MA",0.013
"6145",514,"200691.9320.57","MA",2006,5,19,139,20,42.7067,-70.7212,16,5,11,14,2,"MA",0.013
"6146",514,"200691.9310.58","MA",2006,5,19,139,20,42.6985,-70.7375,10,6,4,6,4,"MA",0.013
"6147",514,"200691.9330.59","MA",2006,5,19,139,20,42.7168,-70.7173,9,3,6,9,0,"MA",0.013
"6148",514,"200691.9300.60","MA",2006,5,20,140,20,42.1063,-70.3008,0,0,0,0,0,"MA",0.013
"6149",514,"200691.9210.61","MA",2006,5,20,140,20,42.11,-70.226,1,0,1,1,0,"MA",0.013
"6150",514,"200691.9210.62","MA",2006,5,20,140,20,42.1008,-70.2118,1,0,1,1,0,"MA",0.013
"6151",514,"200691.9270.63","MA",2006,5,20,140,20,41.9382,-70.1365,3,0,3,3,0,"MA",0.013
"6152",514,"200691.9260.64","MA",2006,5,20,140,20,41.9423,-70.1233,5,1,4,5,0,"MA",0.013
"6153",514,"200691.9290.65","MA",2006,5,21,141,20,42.0088,-70.2445,0,0,0,0,0,"MA",0.013
"6154",514,"200691.9300.66","MA",2006,5,21,141,20,42.0585,-70.2742,1,0,1,1,0,"MA",0.013
"6155",514,"200691.9200.67","MA",2006,5,21,141,20,42.0547,-70.0195,1,1,0,1,0,"MA",0.013
"6156",514,"200691.9170.68","MA",2006,5,21,141,20,42.0088,-70.0162,8,6,2,6,2,"MA",0.013
"6157",514,"200691.9200.69","MA",2006,5,21,141,20,42.1002,-70.1708,2,0,2,2,0,"MA",0.013
"6158",521,"200691.9170.70","MA",2006,5,22,142,20,41.875,-69.9482,2,1,1,1,1,"MA",0.013
"6159",521,"200691.9180.71","MA",2006,5,22,142,13,41.7945,-69.9193,8,2,6,4,4,"MA",0.013
"6160",521,"200691.9180.72","MA",2006,5,22,142,20,41.7173,-69.8958,1,1,0,1,0,"MA",0.013
"6161",521,"200691.9190.73","MA",2006,5,22,142,13,41.678,-69.8795,6,2,4,6,0,"MA",0.013
"6162",521,"200691.9170.82","MA",2006,5,24,144,20,41.3752,-69.991,0,0,0,0,0,"MA",0.013
"6163",514,"200791.9260.1","MA",2007,5,7,127,20,41.8123,-70.4778,1,0,1,0,1,"MA",0.013
"6164",514,"200791.9260.2","MA",2007,5,7,127,20,41.8545,-70.4995,0,0,0,0,0,"MA",0.013
"6165",514,"200791.9270.3","MA",2007,5,7,127,20,41.9123,-70.4908,1,0,1,1,0,"MA",0.013
"6166",514,"200791.9280.4","MA",2007,5,7,127,20,41.912,-70.4203,1,1,0,1,0,"MA",0.013
"6167",514,"200791.9290.5","MA",2007,5,7,127,20,41.9668,-70.3705,5,0,5,3,2,"MA",0.013
"6168",514,"200791.9280.6","MA",2007,5,7,127,20,41.8725,-70.3478,0,0,0,0,0,"MA",0.013
"6169",514,"200791.9250.7","MA",2007,5,8,128,20,41.7443,-70.3252,0,0,0,0,0,"MA",0.013
"6170",514,"200791.9260.8","MA",2007,5,8,128,20,41.7727,-70.2783,0,0,0,0,0,"MA",0.013
"6171",514,"200791.9270.9","MA",2007,5,8,128,20,41.7902,-70.2927,0,0,0,0,0,"MA",0.013
"6172",514,"200791.9270.10","MA",2007,5,8,128,20,41.8455,-70.3105,0,0,0,0,0,"MA",0.013
"6173",514,"200791.9260.11","MA",2007,5,8,128,20,41.8163,-70.2237,0,0,0,0,0,"MA",0.013
"6174",514,"200791.9250.12","MA",2007,5,8,128,20,41.8327,-70.1648,0,0,0,0,0,"MA",0.013
"6175",514,"200791.9250.13","MA",2007,5,8,128,20,41.818,-70.049,0,0,0,0,0,"MA",0.013
"6176",514,"200791.9280.14","MA",2007,5,9,129,13,42.0992,-70.5415,0,0,0,0,0,"MA",0.013
"6177",514,"200791.9290.15","MA",2007,5,9,129,20,42.1072,-70.5085,0,0,0,0,0,"MA",0.013
"6178",514,"200791.9250.16","MA",2007,5,9,129,20,42.144,-70.6852,3,1,2,2,1,"MA",0.013
"6179",514,"200791.9320.17","MA",2007,5,9,129,20,42.237,-70.7435,0,0,0,0,0,"MA",0.013
"6180",514,"200791.9310.18","MA",2007,5,9,129,20,42.2802,-70.8537,5,1,4,3,2,"MA",0.013
"6181",514,"200791.9320.19","MA",2007,5,9,129,14,42.3003,-70.8462,1,0,1,1,0,"MA",0.013
"6182",514,"200791.9330.20","MA",2007,5,10,130,13,42.31,-70.7977,0,0,0,0,0,"MA",0.013
"6183",514,"200791.9350.21","MA",2007,5,10,130,13,42.319,-70.7027,5,4,1,5,0,"MA",0.013
"6184",514,"200791.9350.22","MA",2007,5,10,130,13,42.364,-70.6947,2,2,0,2,0,"MA",0.013
"6185",514,"200791.9360.23","MA",2007,5,10,130,15,42.4182,-70.6567,0,0,0,0,0,"MA",0.013
"6186",514,"200791.9340.24","MA",2007,5,10,130,20,42.4832,-70.763,6,4,2,5,1,"MA",0.013
"6187",514,"200791.9340.25","MA",2007,5,10,130,13,42.439,-70.8473,0,0,0,0,0,"MA",0.013
"6188",514,"200791.9330.26","MA",2007,5,10,130,20,42.4498,-70.8925,0,0,0,0,0,"MA",0.013
"6189",514,"200791.9350.27","MA",2007,5,11,131,15,42.5735,-70.5848,0,0,0,0,0,"MA",0.013
"6190",514,"200791.9350.28","MA",2007,5,11,131,20,42.5907,-70.5818,3,0,3,3,0,"MA",0.013
"6191",514,"200791.9340.29","MA",2007,5,11,131,20,42.6652,-70.5537,17,9,8,15,2,"MA",0.013
"6192",514,"200791.9350.30","MA",2007,5,11,131,13,42.6967,-70.5645,13,9,4,7,6,"MA",0.013
"6193",514,"200791.9360.31","MA",2007,5,12,132,20,42.7233,-70.5957,7,3,4,6,1,"MA",0.013
"6194",514,"200791.9310.32","MA",2007,5,12,132,20,42.6877,-70.7207,0,0,0,0,0,"MA",0.013
"6195",514,"200791.9310.33","MA",2007,5,12,132,20,42.6765,-70.6877,5,3,2,5,0,"MA",0.013
"6196",514,"200791.9320.34","MA",2007,5,12,132,20,42.695,-70.7162,5,3,2,4,1,"MA",0.013
"6197",514,"200791.9330.35","MA",2007,5,12,132,15,42.703,-70.711,0,0,0,0,0,"MA",0.013
"6198",514,"200791.9330.36","MA",2007,5,12,132,17,42.7497,-70.7485,0,0,0,0,0,"MA",0.013
"6199",514,"200791.9340.37","MA",2007,5,12,132,20,42.7165,-70.6758,6,5,1,6,0,"MA",0.013
"6200",514,"200791.9300.38","MA",2007,5,14,134,20,42.1014,-70.3579,2,0,2,2,0,"MA",0.013
"6201",514,"200791.9300.39","MA",2007,5,14,134,20,42.0615,-70.3307,3,1,2,3,0,"MA",0.013
"6202",514,"200791.9290.40","MA",2007,5,16,136,17,41.9873,-70.4067,2,0,2,1,1,"MA",0.013
"6203",514,"200791.9290.41","MA",2007,5,16,136,20,42.0133,-70.3423,2,1,1,2,0,"MA",0.013
"6204",514,"200791.9290.42","MA",2007,5,16,136,20,42.0035,-70.262,0,0,0,0,0,"MA",0.013
"6205",514,"200791.9270.43","MA",2007,5,16,136,13,42.0205,-70.1415,1,0,1,1,0,"MA",0.013
"6206",514,"200791.9280.44","MA",2007,5,16,136,20,41.946,-70.2435,0,0,0,0,0,"MA",0.013
"6207",514,"200791.9280.45","MA",2007,5,16,136,20,41.9347,-70.192,1,0,1,1,0,"MA",0.013
"6208",514,"200791.9260.46","MA",2007,5,16,136,20,41.9088,-70.13,1,1,0,1,0,"MA",0.013
"6209",514,"200791.9270.47","MA",2007,5,16,136,20,41.8948,-70.1702,0,0,0,0,0,"MA",0.013
"6210",514,"200791.9210.82","MA",2007,5,23,143,20,42.11,-70.2203,1,0,1,1,0,"MA",0.013
"6211",514,"200791.9200.83","MA",2007,5,23,143,20,42.1003,-70.14,3,1,2,2,1,"MA",0.013
"6212",514,"200791.9170.84","MA",2007,5,23,143,13,42.0458,-70.0542,6,5,1,4,2,"MA",0.013
"6213",514,"200791.9200.85","MA",2007,5,23,143,20,42.0583,-70.0212,0,0,0,0,0,"MA",0.013
"6214",514,"200791.9180.86","MA",2007,5,23,143,13,42.0322,-70.0275,1,1,0,1,0,"MA",0.013
"6215",514,"200791.9210.87","MA",2007,5,23,143,20,42.0842,-70.0377,0,0,0,0,0,"MA",0.013
"6216",521,"200791.9170.88","MA",2007,5,23,143,20,41.9397,-69.972,8,5,3,4,4,"MA",0.013
"6217",521,"200791.9180.89","MA",2007,5,23,143,20,41.8822,-69.9442,8,1,7,8,0,"MA",0.013
"6218",521,"200791.9190.90","MA",2007,5,23,143,13,41.7225,-69.8818,1,0,1,1,0,"MA",0.013
"6219",521,"200791.9180.91","MA",2007,5,24,144,20,41.3703,-69.9545,0,0,0,0,0,"MA",0.013
"6220",514,"200891.9260.1","MA",2008,5,5,126,20,41.8498,-70.4942,2,0,2,2,0,"MA",0.013
"6221",514,"200891.9280.2","MA",2008,5,5,126,20,41.9098,-70.4388,1,1,0,1,0,"MA",0.013
"6222",514,"200891.9280.3","MA",2008,5,5,126,20,41.9407,-70.4775,7,2,5,7,0,"MA",0.013
"6223",514,"200891.9280.4","MA",2008,5,5,126,18.5,42.0048,-70.4887,4,1,3,4,0,"MA",0.013
"6224",514,"200891.9250.5","MA",2008,5,5,126,20,41.9638,-70.601,3,0,3,3,0,"MA",0.013
"6225",514,"200891.9250.6","MA",2008,5,5,126,20,41.82,-70.52,0,0,0,0,0,"MA",0.013
"6226",514,"200891.9270.7","MA",2008,5,6,127,20,41.7815,-70.4173,7,4,3,5,2,"MA",0.013
"6227",514,"200891.9260.8","MA",2008,5,6,127,20,41.7632,-70.384,3,2,1,3,0,"MA",0.013
"6228",514,"200891.9260.9","MA",2008,5,6,127,20,41.771,-70.3262,3,3,0,3,0,"MA",0.013
"6229",514,"200891.9250.10","MA",2008,5,6,127,20,41.8128,-70.0713,0,0,0,0,0,"MA",0.013
"6230",514,"200891.9260.11","MA",2008,5,6,127,20,41.8162,-70.1418,1,1,0,1,0,"MA",0.013
"6231",514,"200891.9260.12","MA",2008,5,6,127,20,41.8393,-70.2022,1,0,1,1,0,"MA",0.013
"6232",514,"200891.9250.13","MA",2008,5,6,127,20,41.8623,-70.1408,0,0,0,0,0,"MA",0.013
"6233",514,"200891.9270.14","MA",2008,5,6,127,20,41.8392,-70.3333,2,0,2,2,0,"MA",0.013
"6234",514,"200891.9270.15","MA",2008,5,7,128,20,42.1065,-70.5658,6,4,2,6,0,"MA",0.013
"6235",514,"200891.9340.16","MA",2008,5,7,128,16,42.3118,-70.7252,1,1,0,1,0,"MA",0.013
"6236",514,"200891.9330.17","MA",2008,5,7,128,20,42.307,-70.8093,12,6,6,9,3,"MA",0.013
"6237",514,"200891.9320.18","MA",2008,5,7,128,13,42.2842,-70.809,30,18,12,22,8,"MA",0.013
"6238",514,"200891.9320.19","MA",2008,5,7,128,20,42.2993,-70.8335,25,10,15,22,3,"MA",0.013
"6239",514,"200891.9310.20","MA",2008,5,7,128,20,42.2785,-70.8517,22,5,17,16,6,"MA",0.013
"6240",514,"200891.9330.21","MA",2008,5,8,129,20,42.45,-70.8753,11,6,5,10,1,"MA",0.013
"6241",514,"200891.9340.22","MA",2008,5,8,129,20,42.4392,-70.8437,10,2,8,9,1,"MA",0.013
"6242",514,"200891.9360.23","MA",2008,5,8,129,20,42.4237,-70.6633,2,1,1,2,0,"MA",0.013
"6243",514,"200891.9350.24","MA",2008,5,8,129,20,42.4788,-70.7628,4,2,2,4,0,"MA",0.013
"6244",514,"200891.9350.25","MA",2008,5,8,129,19,42.5228,-70.7137,3,2,1,3,0,"MA",0.013
"6245",514,"200891.9350.26","MA",2008,5,8,129,15,42.5998,-70.5725,3,1,2,3,0,"MA",0.013
"6246",514,"200891.9360.27","MA",2008,5,8,129,20,42.621,-70.5362,10,3,7,10,0,"MA",0.013
"6247",514,"200891.9340.28","MA",2008,5,8,129,20,42.6542,-70.5698,38,23,15,35,3,"MA",0.013
"6248",514,"200891.9350.29","MA",2008,5,9,130,20,42.7083,-70.633,15,13,2,13,2,"MA",0.013
"6249",514,"200891.9340.30","MA",2008,5,9,130,20,42.7157,-70.677,5,2,3,5,0,"MA",0.013
"6250",514,"200891.9310.31","MA",2008,5,9,130,20,42.7195,-70.7573,3,3,0,3,0,"MA",0.013
"6251",514,"200891.9330.32","MA",2008,5,9,130,20,42.7858,-70.7683,2,1,1,2,0,"MA",0.013
"6252",514,"200891.9320.33","MA",2008,5,9,130,20,42.7967,-70.7945,34,19,15,27,7,"MA",0.013
"6253",513,"200891.9310.34","MA",2008,5,9,130,20,42.838,-70.806,8,4,4,3,5,"MA",0.013
"6254",513,"200891.9330.35","MA",2008,5,9,130,20,42.8348,-70.7782,5,1,4,4,1,"MA",0.013
"6255",514,"200891.9290.36","MA",2008,5,11,132,20,41.984,-70.3152,0,0,0,0,0,"MA",0.013
"6256",514,"200891.9290.37","MA",2008,5,11,132,20,41.961,-70.3047,0,0,0,0,0,"MA",0.013
"6257",514,"200891.9270.38","MA",2008,5,11,132,20,42.0083,-70.1535,0,0,0,0,0,"MA",0.013
"6258",514,"200891.9270.39","MA",2008,5,11,132,20,41.9792,-70.1362,2,0,2,2,0,"MA",0.013
"6259",514,"200891.9280.40","MA",2008,5,11,132,20,41.9085,-70.199,0,0,0,0,0,"MA",0.013
"6260",521,"200891.9180.59","MA",2008,5,16,137,20,41.374,-69.9577,0,0,0,0,0,"MA",0.013
"6261",521,"200891.9170.60","MA",2008,5,16,137,20,41.3822,-69.992,0,0,0,0,0,"MA",0.013
"6262",521,"200891.9170.61","MA",2008,5,16,137,20,41.407,-69.9675,0,0,0,0,0,"MA",0.013
"6263",521,"200891.9190.78","MA",2008,5,19,140,20,41.7098,-69.8617,2,0,2,1,1,"MA",0.013
"6264",521,"200891.9200.79","MA",2008,5,19,140,20,41.7665,-69.8643,0,0,0,0,0,"MA",0.013
"6265",521,"200891.9210.80","MA",2008,5,19,140,20,41.82,-69.8722,1,1,0,1,0,"MA",0.013
"6266",521,"200891.9200.81","MA",2008,5,19,140,20,41.8313,-69.8868,1,1,0,1,0,"MA",0.013
"6267",521,"200891.9180.82","MA",2008,5,19,140,18,41.8137,-69.9208,13,10,3,13,0,"MA",0.013
"6268",521,"200891.9180.83","MA",2008,5,19,140,20,41.8838,-69.9438,36,18,18,33,3,"MA",0.013
"6269",521,"200891.9170.84","MA",2008,5,20,141,20,41.961,-69.9833,29,22,7,28,1,"MA",0.013
"6270",514,"200891.9210.85","MA",2008,5,20,141,20,42.0667,-70.0048,1,1,0,1,0,"MA",0.013
"6271",514,"200891.9170.86","MA",2008,5,20,141,20,42.0653,-70.0887,50,29,21,48,2,"MA",0.013
"6272",514,"200891.9210.87","MA",2008,5,20,141,17,42.1088,-70.2238,1,0,1,1,0,"MA",0.013
"6273",514,"200891.9300.88","MA",2008,5,20,141,20,42.0707,-70.3775,1,1,0,1,0,"MA",0.013
"6274",514,"200891.9300.89","MA",2008,5,20,141,20,42.074,-70.3013,0,0,0,0,0,"MA",0.013
"6275",514,"200891.9290.90","MA",2008,5,21,142,20,42.07,-70.4737,3,1,2,3,0,"MA",0.013
"6276",514,"200891.9290.91","MA",2008,5,21,142,20,42.0377,-70.4612,4,1,3,4,0,"MA",0.013
"6277",514,"200891.9290.92","MA",2008,5,21,142,20,42.003,-70.4113,2,1,1,2,0,"MA",0.013
"6278",514,"200891.9280.93","MA",2008,5,21,142,20,41.9073,-70.2325,1,0,1,1,0,"MA",0.013
"6279",514,"200991.9250.1","MA",2009,5,4,124,20,41.8328,-70.5105,3,0,3,3,0,"MA",0.013
"6280",514,"200991.9270.2","MA",2009,5,4,124,16,41.888,-70.48,1,1,0,1,0,"MA",0.013
"6281",514,"200991.9280.3","MA",2009,5,4,124,20,41.934,-70.4673,4,2,2,4,0,"MA",0.013
"6282",514,"200991.9270.4","MA",2009,5,4,124,20,41.9748,-70.5538,4,2,2,4,0,"MA",0.013
"6283",514,"200991.9250.5","MA",2009,5,4,124,20,41.9602,-70.6087,0,0,0,0,0,"MA",0.013
"6284",514,"200991.9290.6","MA",2009,5,4,124,20,41.9303,-70.376,1,0,1,1,0,"MA",0.013
"6285",514,"200991.9280.7","MA",2009,5,4,124,20,41.9108,-70.3455,1,1,0,1,0,"MA",0.013
"6286",514,"200991.9280.8","MA",2009,5,4,124,20,41.8682,-70.3182,4,1,3,4,0,"MA",0.013
"6287",514,"200991.9270.9","MA",2009,5,5,125,20,41.7945,-70.4159,3,1,2,2,1,"MA",0.013
"6288",514,"200991.9260.10","MA",2009,5,5,125,20,41.7663,-70.4127,4,3,1,4,0,"MA",0.013
"6289",514,"200991.9260.11","MA",2009,5,5,125,20,41.7616,-70.3209,3,0,3,3,0,"MA",0.013
"6290",514,"200991.9260.12","MA",2009,5,5,125,20,41.7867,-70.269,2,0,2,2,0,"MA",0.013
"6291",514,"200991.9250.13","MA",2009,5,5,125,20,41.8177,-70.05,0,0,0,0,0,"MA",0.013
"6292",514,"200991.9280.14","MA",2009,5,5,125,20,41.8703,-70.2602,0,0,0,0,0,"MA",0.013
"6293",514,"200991.9290.15","MA",2009,5,6,126,18,42.0327,-70.5112,3,2,1,1,2,"MA",0.013
"6294",514,"200991.9340.16","MA",2009,5,6,126,14,42.3165,-70.7233,2,1,1,2,0,"MA",0.013
"6295",514,"200991.9330.17","MA",2009,5,6,126,20,42.3083,-70.8143,3,1,2,3,0,"MA",0.013
"6296",514,"200991.9320.18","MA",2009,5,6,126,20,42.2973,-70.85,5,2,3,5,0,"MA",0.013
"6297",514,"200991.9310.19","MA",2009,5,6,126,20,42.2793,-70.8535,10,3,7,6,4,"MA",0.013
"6298",514,"200991.9350.20","MA",2009,5,7,127,14,42.3715,-70.705,2,1,1,2,0,"MA",0.013
"6299",514,"200991.9340.21","MA",2009,5,7,127,15,42.3938,-70.8238,9,6,3,9,0,"MA",0.013
"6300",514,"200991.9320.22","MA",2009,5,7,127,13,42.4427,-70.9107,25,6,19,21,4,"MA",0.013
"6301",514,"200991.9330.23","MA",2009,5,7,127,20,42.4499,-70.873,13,5,8,13,0,"MA",0.013
"6302",514,"200991.9350.24","MA",2009,5,8,128,13,42.5674,-70.6136,23,10,13,19,4,"MA",0.013
"6303",514,"200991.9360.25","MA",2009,5,8,128,17,42.6187,-70.5392,17,8,9,12,5,"MA",0.013
"6304",514,"200991.9350.26","MA",2009,5,8,128,20,42.7037,-70.5968,41,24,17,39,2,"MA",0.013
"6305",514,"200991.9350.27","MA",2009,5,8,128,20,42.7076,-70.6331,30,17,13,28,2,"MA",0.013
"6306",514,"200991.9340.28","MA",2009,5,8,128,20,42.724,-70.6695,4,1,3,4,0,"MA",0.013
"6307",514,"200991.9330.29","MA",2009,5,9,129,15,42.7019,-70.7021,3,1,2,3,0,"MA",0.013
"6308",514,"200991.9310.30","MA",2009,5,9,129,20,42.7065,-70.7451,2,0,2,2,0,"MA",0.013
"6309",514,"200991.9320.31","MA",2009,5,9,129,20,42.7334,-70.7553,3,1,2,3,0,"MA",0.013
"6310",514,"200991.9330.32","MA",2009,5,9,129,20,42.7975,-70.766,5,2,3,5,0,"MA",0.013
"6311",513,"200991.9340.33","MA",2009,5,9,129,20,42.8365,-70.7491,3,0,3,3,0,"MA",0.013
"6312",514,"200991.9360.34","MA",2009,5,10,130,13,42.4961,-70.6465,35,24,11,35,0,"MA",0.013
"6313",514,"200991.9300.35","MA",2009,5,10,130,13,42.1082,-70.3453,0,0,0,0,0,"MA",0.013
"6314",514,"200991.9300.36","MA",2009,5,10,130,16,42.0837,-70.4196,1,1,0,0,1,"MA",0.013
"6315",514,"200991.9290.37","MA",2009,5,10,130,20,42.0284,-70.3467,3,1,2,3,0,"MA",0.013
"6316",514,"200991.9290.38","MA",2009,5,10,130,20,42.0296,-70.4234,2,1,1,2,0,"MA",0.013
"6317",514,"200991.9270.39","MA",2009,5,11,131,20,41.9102,-70.1632,0,0,0,0,0,"MA",0.013
"6318",514,"200991.9250.40","MA",2009,5,11,131,20,41.8947,-70.1157,1,1,0,1,0,"MA",0.013
"6319",514,"200991.9260.41","MA",2009,5,11,131,20,41.958,-70.1158,3,0,3,3,0,"MA",0.013
"6320",514,"200991.9270.42","MA",2009,5,11,131,20,41.972,-70.136,4,0,4,4,0,"MA",0.013
"6321",514,"200991.9260.43","MA",2009,5,11,131,20,41.9982,-70.1125,6,2,4,6,0,"MA",0.013
"6322",514,"200991.9280.44","MA",2009,5,11,131,20,41.9893,-70.2093,1,1,0,1,0,"MA",0.013
"6323",514,"200991.9290.45","MA",2009,5,11,131,20,42.0422,-70.2648,1,0,1,1,0,"MA",0.013
"6324",514,"200991.9200.46","MA",2009,5,12,132,20,42.1007,-70.1535,2,2,0,2,0,"MA",0.013
"6325",514,"200991.9210.47","MA",2009,5,12,132,20,42.1247,-70.1853,0,0,0,0,0,"MA",0.013
"6326",514,"200991.9210.48","MA",2009,5,12,132,20,42.0752,-70.0207,0,0,0,0,0,"MA",0.013
"6327",514,"200991.9170.49","MA",2009,5,12,132,20,42.0502,-70.06,3,1,2,2,1,"MA",0.013
"6328",521,"200991.9170.50","MA",2009,5,12,132,20,41.9667,-69.9875,3,0,3,2,1,"MA",0.013
"6329",521,"200991.9200.51","MA",2009,5,12,132,20,41.8172,-69.8875,0,0,0,0,0,"MA",0.013
"6330",521,"200991.9180.52","MA",2009,5,12,132,20,41.8248,-69.9223,4,3,1,4,0,"MA",0.013
"6331",521,"200991.9180.53","MA",2009,5,13,133,16.5,41.7403,-69.9105,4,1,3,4,0,"MA",0.013
"6332",521,"200991.9190.54","MA",2009,5,13,133,20,41.7022,-69.8813,7,6,1,7,0,"MA",0.013
"6333",521,"200991.9170.55","MA",2009,5,13,133,20,41.375,-69.9897,0,0,0,0,0,"MA",0.013
"6334",521,"200991.9180.56","MA",2009,5,13,133,20,41.3728,-69.9558,1,0,1,1,0,"MA",0.013
"6335",514,"201091.9260.1","MA",2010,5,3,123,20.1,41.7963,-70.4754,4,1,3,3,1,"MA",0.013065
"6336",514,"201091.9250.2","MA",2010,5,3,123,20.1,41.8368,-70.5102,0,0,0,0,0,"MA",0.013065
"6337",514,"201091.9260.3","MA",2010,5,3,123,20,41.856,-70.4947,3,0,3,2,1,"MA",0.013
"6338",514,"201091.9280.4","MA",2010,5,3,123,20.2,41.8855,-70.3137,2,0,2,2,0,"MA",0.01313
"6339",514,"201091.9280.5","MA",2010,5,3,123,20,41.866,-70.3195,4,1,3,4,0,"MA",0.013
"6340",514,"201091.9270.6","MA",2010,5,3,123,20.1,41.8458,-70.3011,10,5,5,10,0,"MA",0.013065
"6341",514,"201091.9270.7","MA",2010,5,3,123,20,41.8062,-70.3546,1,0,1,1,0,"MA",0.013
"6342",514,"201091.9270.8","MA",2010,5,3,123,13.7,41.8022,-70.4159,0,0,0,0,0,"MA",0.013
"6343",514,"201091.9250.9","MA",2010,5,4,124,20.2,41.7442,-70.33,5,3,2,4,1,"MA",0.01313
"6344",514,"201091.9260.10","MA",2010,5,4,124,20,41.7705,-70.3244,0,0,0,0,0,"MA",0.013
"6345",514,"201091.9260.11","MA",2010,5,4,124,20,41.8439,-70.1791,4,2,2,4,0,"MA",0.013
"6346",514,"201091.9250.12","MA",2010,5,4,124,20.1,41.8392,-70.1641,0,0,0,0,0,"MA",0.013065
"6347",514,"201091.9250.13","MA",2010,5,4,124,20.2,41.8955,-70.1159,0,0,0,0,0,"MA",0.01313
"6348",514,"201091.9280.14","MA",2010,5,4,124,20.3,41.9614,-70.1802,2,0,2,2,0,"MA",0.013195
"6349",514,"201091.9290.15","MA",2010,5,4,124,20,41.9617,-70.3096,2,0,2,2,0,"MA",0.013
"6350",514,"201091.9280.16","MA",2010,5,4,124,20,41.9313,-70.2911,5,1,4,5,0,"MA",0.013
"6351",514,"201091.9290.17","MA",2010,5,5,125,20.3,41.9945,-70.4584,4,2,2,3,1,"MA",0.013195
"6352",514,"201091.9280.18","MA",2010,5,5,125,17,42.1066,-70.5183,2,1,1,2,0,"MA",0.013
"6353",514,"201091.9320.19","MA",2010,5,5,125,16.1,42.2348,-70.7422,7,2,5,5,2,"MA",0.013
"6354",514,"201091.9340.20","MA",2010,5,5,125,19.7,42.3123,-70.7224,8,5,3,8,0,"MA",0.013
"6355",514,"201091.9320.22","MA",2010,5,5,125,20.2,42.292,-70.8635,15,7,8,4,11,"MA",0.01313
"6356",514,"201091.9310.23","MA",2010,5,5,125,20,42.2886,-70.8639,7,2,5,6,1,"MA",0.013
"6357",514,"201091.9340.25","MA",2010,5,6,126,13.1,42.3928,-70.8221,10,4,6,10,0,"MA",0.013
"6358",514,"201091.9330.26","MA",2010,5,6,126,20,42.3916,-70.9106,9,3,6,8,1,"MA",0.013
"6359",514,"201091.9330.27","MA",2010,5,6,126,20.1,42.4517,-70.8735,13,4,9,13,0,"MA",0.013065
"6360",514,"201091.9350.28","MA",2010,5,6,126,20,42.3811,-70.6969,0,0,0,0,0,"MA",0.013
"6361",514,"201091.9360.29","MA",2010,5,6,126,20,42.4295,-70.6612,2,1,1,2,0,"MA",0.013
"6362",514,"201091.9350.30","MA",2010,5,6,126,20,42.5117,-70.7085,1,1,0,1,0,"MA",0.013
"6363",514,"201091.9350.31","MA",2010,5,6,126,20,42.5321,-70.6663,2,1,1,2,0,"MA",0.013
"6364",514,"201091.9350.32","MA",2010,5,7,127,20.1,42.5985,-70.5698,4,2,2,4,0,"MA",0.013065
"6365",514,"201091.9360.33","MA",2010,5,7,127,20.3,42.624,-70.5177,9,4,5,8,1,"MA",0.013195
"6366",514,"201091.9340.34","MA",2010,5,7,127,13.3,42.65,-70.5767,41,19,22,37,4,"MA",0.013
"6367",514,"201091.9350.35","MA",2010,5,7,127,20.1,42.695,-70.5733,12,4,8,11,1,"MA",0.013065
"6368",514,"201091.9340.36","MA",2010,5,7,127,20.1,42.7174,-70.6592,5,1,4,5,0,"MA",0.013065
"6369",514,"201091.9330.37","MA",2010,5,7,127,20.1,42.7152,-70.7178,1,1,0,1,0,"MA",0.013065
"6370",514,"201091.9330.38","MA",2010,5,8,128,20.1,42.7461,-70.7483,1,1,0,1,0,"MA",0.013065
"6371",514,"201091.9320.39","MA",2010,5,8,128,20,42.7505,-70.771,4,1,3,4,0,"MA",0.013
"6372",514,"201091.9310.40","MA",2010,5,8,128,20,42.7642,-70.7903,5,3,2,5,0,"MA",0.013
"6373",514,"201091.9310.41","MA",2010,5,8,128,20.4,42.7172,-70.7598,4,3,1,4,0,"MA",0.01326
"6374",514,"201091.9270.42","MA",2010,5,10,130,20.3,41.9918,-70.136,1,0,1,1,0,"MA",0.013195
"6375",514,"201091.9260.44","MA",2010,5,10,130,20.1,41.9691,-70.1071,11,5,6,9,2,"MA",0.013065
"6376",514,"201091.9270.45","MA",2010,5,10,130,20.1,41.9514,-70.1398,9,1,8,7,2,"MA",0.013065
"6377",514,"201091.9290.46","MA",2010,5,10,130,20,42.0341,-70.3432,3,1,2,3,0,"MA",0.013
"6378",514,"201091.9300.47","MA",2010,5,10,130,20.2,42.0767,-70.4064,8,2,6,6,2,"MA",0.01313
"6379",514,"201091.9290.48","MA",2010,5,10,130,20.1,42.0647,-70.4738,5,2,3,4,1,"MA",0.013065
"6380",514,"201091.9290.49","MA",2010,5,10,130,20.2,42.1238,-70.4917,1,1,0,1,0,"MA",0.01313
"6381",514,"201091.9300.50","MA",2010,5,10,130,16,42.1128,-70.4141,11,1,10,9,2,"MA",0.013
"6382",514,"201091.9210.51","MA",2010,5,11,131,20.3,42.0914,-70.2348,5,2,3,5,0,"MA",0.013195
"6383",514,"201091.9210.52","MA",2010,5,11,131,18.5,42.1042,-70.2352,3,1,2,3,0,"MA",0.013
"6384",514,"201091.9200.53","MA",2010,5,11,131,20.1,42.1007,-70.1443,3,2,1,3,0,"MA",0.013065
"6385",514,"201091.9170.54","MA",2010,5,11,131,17.7,42.09,-70.1695,4,1,3,3,1,"MA",0.013
"6386",514,"201091.9180.55","MA",2010,5,11,131,20.2,42.03,-70.0258,5,2,3,5,0,"MA",0.01313
"6387",514,"201091.9170.56","MA",2010,5,11,131,20.1,42.0015,-70.0106,2,1,1,2,0,"MA",0.013065
"6388",521,"201091.9190.57","MA",2010,5,11,131,20.1,41.8175,-69.9057,3,2,1,3,0,"MA",0.013065
"6389",521,"201091.9200.58","MA",2010,5,11,131,20.1,41.7956,-69.8789,0,0,0,0,0,"MA",0.013065
"6390",521,"201091.9180.59","MA",2010,5,12,132,20.1,41.649,-69.9192,0,0,0,0,0,"MA",0.013065
"6391",521,"201091.9170.60","MA",2010,5,12,132,20,41.393,-69.99,0,0,0,0,0,"MA",0.013
"6392",521,"201091.9180.61","MA",2010,5,12,132,20.1,41.4398,-69.99,0,0,0,0,0,"MA",0.013065
"6393",514,"201191.9260.1","MA",2011,5,3,123,20,41.8277,-70.4768,1,1,0,1,0,"MA",0.013
"6394",514,"201191.9250.2","MA",2011,5,3,123,20.1,41.8525,-70.5135,2,0,2,1,1,"MA",0.013065
"6395",514,"201191.9270.3","MA",2011,5,3,123,19.9,41.9579,-70.5356,11,9,2,9,2,"MA",0.013
"6396",514,"201191.9250.4","MA",2011,5,3,123,20,41.9637,-70.6092,3,1,2,2,1,"MA",0.013
"6397",514,"201191.9280.5","MA",2011,5,3,123,20.1,41.8894,-70.4338,9,3,6,7,2,"MA",0.013065
"6398",514,"201191.9270.6","MA",2011,5,4,124,20,41.8315,-70.3742,1,0,1,1,0,"MA",0.013
"6399",514,"201191.9260.7","MA",2011,5,4,124,20,41.7858,-70.3064,0,0,0,0,0,"MA",0.013
"6400",514,"201191.9260.8","MA",2011,5,4,124,20,41.7982,-70.2317,2,0,2,1,1,"MA",0.013
"6401",514,"201191.9260.9","MA",2011,5,4,124,20.1,41.7815,-70.1635,0,0,0,0,0,"MA",0.013065
"6402",514,"201191.9250.10","MA",2011,5,4,124,20.1,41.7933,-70.1205,1,0,1,1,0,"MA",0.013065
"6403",514,"201191.9250.11","MA",2011,5,4,124,20,41.849,-70.1506,1,0,1,1,0,"MA",0.013
"6404",514,"201191.9260.12","MA",2011,5,4,124,20.1,41.8966,-70.1315,2,2,0,2,0,"MA",0.013065
"6405",514,"201191.9270.13","MA",2011,5,4,124,20.1,41.8429,-70.2442,5,1,4,5,0,"MA",0.013065
"6406",514,"201191.9270.14","MA",2011,5,4,124,20.1,41.8523,-70.4103,6,3,3,6,0,"MA",0.013065
"6407",514,"201191.9290.15","MA",2011,5,5,125,20.2,42.0131,-70.4538,7,2,5,6,1,"MA",0.01313
"6408",514,"201191.9290.16","MA",2011,5,5,125,20.1,42.071,-70.5259,8,5,3,6,2,"MA",0.013065
"6409",514,"201191.9320.18","MA",2011,5,5,125,17.4,42.2268,-70.7352,7,2,5,3,4,"MA",0.013
"6410",514,"201191.9340.19","MA",2011,5,5,125,15.1,42.3098,-70.7187,57,41,16,54,3,"MA",0.013
"6411",514,"201191.9320.20","MA",2011,5,5,125,20,42.3005,-70.8375,16,8,8,14,2,"MA",0.013
"6412",514,"201191.9310.21","MA",2011,5,5,125,20,42.2786,-70.8523,19,11,8,5,14,"MA",0.013
"6413",514,"201191.9330.22","MA",2011,5,6,126,13,42.3136,-70.7979,54,31,23,40,14,"MA",0.013
"6414",514,"201191.9330.23","MA",2011,5,6,126,20,42.3977,-70.8928,24,12,12,18,6,"MA",0.013
"6415",514,"201191.9360.24","MA",2011,5,6,126,13.5,42.4122,-70.6518,7,6,1,7,0,"MA",0.013
"6416",514,"201191.9350.26","MA",2011,5,6,126,15.1,42.473,-70.7405,26,20,6,26,0,"MA",0.013
"6417",514,"201191.9340.27","MA",2011,5,6,126,20,42.5478,-70.721,62,38,24,55,7,"MA",0.013
"6418",514,"201191.9350.28","MA",2011,5,7,127,20,42.5713,-70.6079,11,6,5,10,1,"MA",0.013
"6419",514,"201191.9350.29","MA",2011,5,7,127,20,42.5953,-70.5731,10,7,3,9,1,"MA",0.013
"6420",514,"201191.9360.30","MA",2011,5,7,127,20,42.6021,-70.5433,11,2,9,10,1,"MA",0.013
"6421",514,"201191.9340.31","MA",2011,5,7,127,20.1,42.6548,-70.5689,39,18,21,36,3,"MA",0.013065
"6422",514,"201191.9350.32","MA",2011,5,7,127,20,42.7064,-70.6019,41,23,18,40,1,"MA",0.013
"6423",514,"201191.9340.33","MA",2011,5,7,127,20,42.7155,-70.6785,0,0,0,0,0,"MA",0.013
"6424",514,"201191.9330.34","MA",2011,5,8,128,20.1,42.7112,-70.7025,1,0,1,1,0,"MA",0.013065
"6425",514,"201191.9320.35","MA",2011,5,8,128,20.1,42.7107,-70.7307,2,2,0,1,1,"MA",0.013065
"6426",514,"201191.9310.36","MA",2011,5,8,128,20.1,42.7002,-70.7415,2,2,0,2,0,"MA",0.013065
"6427",513,"201191.9310.37","MA",2011,5,8,128,20.2,42.8459,-70.8085,4,3,1,3,1,"MA",0.01313
"6428",514,"201191.9330.38","MA",2011,5,8,128,20.1,42.7709,-70.7615,2,1,1,2,0,"MA",0.013065
"6429",514,"201191.9280.60","MA",2011,5,14,134,20,41.8604,-70.3375,5,3,2,4,1,"MA",0.013
"6430",514,"201191.9280.61","MA",2011,5,14,134,20.4,41.9021,-70.3708,42,13,29,35,7,"MA",0.01326
"6431",514,"201191.9290.62","MA",2011,5,14,134,20,41.9317,-70.3835,55,18,37,38,17,"MA",0.013
"6432",514,"201191.9280.63","MA",2011,5,14,134,20,41.9202,-70.2597,8,3,5,6,2,"MA",0.013
"6433",514,"201191.9280.64","MA",2011,5,14,134,20,41.9346,-70.1923,3,1,2,3,0,"MA",0.013
"6434",514,"201191.9290.65","MA",2011,5,14,134,20.2,41.9526,-70.341,30,6,24,26,4,"MA",0.01313
"6435",514,"201191.9290.66","MA",2011,5,14,134,20.1,41.9871,-70.3402,6,2,4,6,0,"MA",0.013065
"6436",514,"201191.9300.67","MA",2011,5,14,134,20,42.0856,-70.4194,3,0,3,2,1,"MA",0.013
"6437",514,"201191.9300.68","MA",2011,5,14,134,20.1,42.0825,-70.3738,0,0,0,0,0,"MA",0.013065
"6438",514,"201191.9270.69","MA",2011,5,15,135,20.3,42.0077,-70.1471,0,0,0,0,0,"MA",0.013195
"6439",514,"201191.9210.70","MA",2011,5,15,135,20.2,42.0965,-70.2268,15,12,3,15,0,"MA",0.01313
"6440",514,"201191.9170.71","MA",2011,5,15,135,20,42.0587,-70.0746,21,4,17,21,0,"MA",0.013
"6441",514,"201191.9180.72","MA",2011,5,15,135,19.7,42.0398,-70.0417,7,2,5,7,0,"MA",0.013
"6442",514,"201191.9210.73","MA",2011,5,15,135,20.1,42.0746,-70.0162,0,0,0,0,0,"MA",0.013065
"6443",514,"201191.9200.74","MA",2011,5,15,135,20.1,42.0687,-70.0307,0,0,0,0,0,"MA",0.013065
"6444",521,"201191.9190.75","MA",2011,5,15,135,20,41.9031,-69.9383,2,0,2,2,0,"MA",0.013
"6445",521,"201191.9170.76","MA",2011,5,15,135,19.8,41.9399,-69.9721,16,6,10,15,1,"MA",0.013
"6446",521,"201191.9200.77","MA",2011,5,16,136,20.1,41.8362,-69.889,0,0,0,0,0,"MA",0.013065
"6447",521,"201191.9180.78","MA",2011,5,16,136,20.1,41.7144,-69.8959,0,0,0,0,0,"MA",0.013065
"6448",521,"201191.9170.80","MA",2011,5,16,136,19.9,41.3913,-69.9914,0,0,0,0,0,"MA",0.013
"6449",514,"201291.9270.1","MA",2012,5,7,128,20,41.8541,-70.4099,16,7,9,9,7,"MA",0.013
"6450",514,"201291.9270.2","MA",2012,5,7,128,20.1,41.8617,-70.4479,1,0,1,1,0,"MA",0.013065
"6451",514,"201291.9250.3","MA",2012,5,7,128,20,41.8376,-70.5074,1,1,0,1,0,"MA",0.013
"6452",514,"201291.9260.4","MA",2012,5,7,128,20.1,41.9841,-70.5853,8,6,2,4,4,"MA",0.013065
"6453",514,"201291.9250.5","MA",2012,5,7,128,20,42.053,-70.6364,19,9,10,9,10,"MA",0.013
"6454",514,"201291.9280.6","MA",2012,5,7,128,20.1,41.9702,-70.5094,6,2,4,3,3,"MA",0.013065
"6455",514,"201291.9290.7","MA",2012,5,7,128,20.1,41.9907,-70.4116,5,3,2,5,0,"MA",0.013065
"6456",514,"201291.9280.8","MA",2012,5,8,129,20,41.9039,-70.3844,17,10,7,12,5,"MA",0.013
"6457",514,"201291.9270.9","MA",2012,5,8,129,20,41.8361,-70.3479,7,2,5,5,2,"MA",0.013
"6458",514,"201291.9270.10","MA",2012,5,8,129,20,41.87,-70.2187,5,1,4,5,0,"MA",0.013
"6459",514,"201291.9260.11","MA",2012,5,8,129,21,41.862,-70.1585,8,3,5,7,1,"MA",0.01365
"6460",514,"201291.9250.12","MA",2012,5,8,129,20.1,41.8152,-70.0887,0,0,0,0,0,"MA",0.013065
"6461",514,"201291.9260.13","MA",2012,5,8,129,20.2,41.7835,-70.1606,0,0,0,0,0,"MA",0.01313
"6462",514,"201291.9260.14","MA",2012,5,8,129,13.2,41.7664,-70.3118,1,1,0,1,0,"MA",0.013
"6463",514,"201291.9280.15","MA",2012,5,9,130,20,42.1271,-70.5229,7,6,1,7,0,"MA",0.013
"6464",514,"201291.9320.16","MA",2012,5,9,130,19.9,42.2383,-70.7443,11,6,5,10,1,"MA",0.013
"6465",514,"201291.9320.19","MA",2012,5,9,130,12.9,42.2893,-70.8161,37,25,12,14,23,"MA",0.013
"6466",514,"201291.9310.20","MA",2012,5,9,130,20,42.2906,-70.8654,12,5,7,8,4,"MA",0.013
"6467",514,"201291.9330.21","MA",2012,5,9,130,20,42.3131,-70.7964,5,2,3,4,1,"MA",0.013
"6468",514,"201291.9330.22","MA",2012,5,10,131,20,42.3976,-70.8927,18,9,9,13,5,"MA",0.013
"6469",514,"201291.9340.23","MA",2012,5,10,131,20,42.4389,-70.8327,16,9,7,12,4,"MA",0.013
"6470",514,"201291.9350.26","MA",2012,5,10,131,17,42.4683,-70.7743,12,8,4,10,2,"MA",0.013
"6471",514,"201291.9340.27","MA",2012,5,10,131,13.1,42.4739,-70.7785,30,19,11,30,0,"MA",0.013
"6472",514,"201291.9360.28","MA",2012,5,10,131,15,42.4841,-70.6455,10,2,8,9,1,"MA",0.013
"6473",514,"201291.9330.29","MA",2012,5,11,132,15,42.6128,-70.6005,4,2,2,4,0,"MA",0.013
"6474",514,"201291.9350.30","MA",2012,5,11,132,13.9,42.6502,-70.5408,12,3,9,12,0,"MA",0.013
"6475",514,"201291.9360.31","MA",2012,5,11,132,20,42.7041,-70.5411,20,13,7,15,5,"MA",0.013
"6476",514,"201291.9350.32","MA",2012,5,11,132,13,42.6866,-70.568,15,4,11,13,2,"MA",0.013
"6477",514,"201291.9340.33","MA",2012,5,11,132,20.1,42.6954,-70.5966,6,1,5,6,0,"MA",0.013065
"6478",514,"201291.9340.34","MA",2012,5,11,132,20,42.7174,-70.6542,3,3,0,3,0,"MA",0.013
"6479",514,"201291.9320.35","MA",2012,5,12,133,20,42.7981,-70.7945,9,2,7,6,3,"MA",0.013
"6480",514,"201291.9330.36","MA",2012,5,12,133,20.1,42.7714,-70.7613,0,0,0,0,0,"MA",0.013065
"6481",514,"201291.9310.37","MA",2012,5,12,133,20,42.7157,-70.7577,2,1,1,2,0,"MA",0.013
"6482",514,"201291.9310.38","MA",2012,5,12,133,20.1,42.6759,-70.6872,1,1,0,1,0,"MA",0.013065
"6483",514,"201291.9300.39","MA",2012,5,13,134,20,42.0949,-70.3607,2,2,0,2,0,"MA",0.013
"6484",514,"201291.9290.40","MA",2012,5,13,134,20,42.045,-70.3638,2,1,1,2,0,"MA",0.013
"6485",514,"201291.9290.41","MA",2012,5,13,134,20.1,42.0141,-70.4113,3,1,2,2,1,"MA",0.013065
"6486",514,"201291.9290.42","MA",2012,5,13,134,20,41.9345,-70.3594,4,2,2,3,1,"MA",0.013
"6487",514,"201291.9280.43","MA",2012,5,13,134,20,41.9154,-70.3016,3,1,2,3,0,"MA",0.013
"6488",514,"201291.9280.44","MA",2012,5,14,135,20,41.933,-70.2203,5,1,4,5,0,"MA",0.013
"6489",514,"201291.9250.45","MA",2012,5,14,135,16.6,41.9168,-70.1024,4,2,2,4,0,"MA",0.013
"6490",514,"201291.9270.46","MA",2012,5,14,135,20,41.9575,-70.1452,0,0,0,0,0,"MA",0.013
"6491",514,"201291.9290.47","MA",2012,5,14,135,20.3,41.984,-70.2814,4,0,4,4,0,"MA",0.013195
"6492",514,"201291.9300.48","MA",2012,5,14,135,20,42.0617,-70.264,6,2,4,6,0,"MA",0.013
"6493",514,"201291.9210.49","MA",2012,5,14,135,20.1,42.0964,-70.2066,85,28,57,84,1,"MA",0.013065
"6494",514,"201291.9210.50","MA",2012,5,14,135,20,42.1074,-70.171,4,0,4,4,0,"MA",0.013
"6495",514,"201291.9200.51","MA",2012,5,14,135,13.2,42.0994,-70.1262,59,19,40,59,0,"MA",0.013
"6496",514,"201291.9190.52","MA",2012,5,14,135,15,42.0983,-70.1711,28,9,19,28,0,"MA",0.013
"6497",514,"201291.9200.53","MA",2012,5,15,136,20,42.0553,-70.0198,3,2,1,3,0,"MA",0.013
"6498",514,"201291.9180.54","MA",2012,5,15,136,12.9,42.0273,-70.0306,2,1,1,2,0,"MA",0.013
"6499",521,"201291.9180.55","MA",2012,5,15,136,20.1,41.882,-69.9459,1,1,0,1,0,"MA",0.013065
"6500",521,"201291.9170.56","MA",2012,5,15,136,20,41.8315,-69.9316,1,0,1,1,0,"MA",0.013
"6501",521,"201291.9170.57","MA",2012,5,15,136,20,41.6329,-69.9389,0,0,0,0,0,"MA",0.013
"6502",521,"201291.9170.58","MA",2012,5,15,136,20,41.4053,-69.9702,0,0,0,0,0,"MA",0.013
"6503",521,"201291.9170.59","MA",2012,5,15,136,20,41.3618,-69.9812,0,0,0,0,0,"MA",0.013
"6504",521,"201291.9180.64","MA",2012,5,16,137,20,41.4377,-69.9776,0,0,0,0,0,"MA",0.013
"6505",514,"201391.9260.1","MA",2013,5,6,126,20,41.7707,-70.413,2,0,2,2,0,"MA",0.013
"6506",514,"201391.9260.2","MA",2013,5,6,126,20,41.7584,-70.3399,5,3,2,4,1,"MA",0.013
"6507",514,"201391.9250.3","MA",2013,5,6,126,20,41.7474,-70.3025,1,1,0,1,0,"MA",0.013
"6508",514,"201391.9250.4","MA",2013,5,6,126,20,41.7814,-70.137,0,0,0,0,0,"MA",0.013
"6509",514,"201391.9250.5","MA",2013,5,6,126,20.2,41.8053,-70.0673,0,0,0,0,0,"MA",0.01313
"6510",514,"201391.9260.6","MA",2013,5,6,126,20,41.839,-70.1906,3,2,1,3,0,"MA",0.013
"6511",514,"201391.9270.7","MA",2013,5,6,126,20,41.8356,-70.273,2,0,2,2,0,"MA",0.013
"6512",514,"201391.9280.8","MA",2013,5,6,126,20,41.8741,-70.3186,5,3,2,5,0,"MA",0.013
"6513",514,"201391.9270.9","MA",2013,5,7,127,20.1,41.8488,-70.4335,5,3,2,4,1,"MA",0.013065
"6514",514,"201391.9280.10","MA",2013,5,7,127,20,41.9357,-70.4845,22,10,12,19,3,"MA",0.013
"6515",514,"201391.9290.11","MA",2013,5,7,127,20.1,41.9825,-70.4685,4,3,1,3,1,"MA",0.013065
"6516",514,"201391.9290.12","MA",2013,5,7,127,20,42.0227,-70.3962,1,0,1,0,1,"MA",0.013
"6517",514,"201391.9290.13","MA",2013,5,7,127,20,41.9499,-70.4082,7,4,3,3,4,"MA",0.013
"6518",514,"201391.9280.14","MA",2013,5,7,127,20,41.8958,-70.3752,15,8,7,12,3,"MA",0.013
"6519",514,"201391.9270.15","MA",2013,5,7,127,20,41.8456,-70.3524,1,1,0,1,0,"MA",0.013
"6520",514,"201391.9250.16","MA",2013,5,8,128,20,42.0546,-70.6369,16,7,9,6,10,"MA",0.013
"6521",514,"201391.9320.17","MA",2013,5,8,128,20,42.2384,-70.7448,15,6,9,10,5,"MA",0.013
"6522",514,"201391.9340.18","MA",2013,5,8,128,15,42.3105,-70.734,11,6,5,9,2,"MA",0.013
"6523",514,"201391.9330.19","MA",2013,5,8,128,20,42.3138,-70.8004,15,7,8,11,4,"MA",0.013
"6524",514,"201391.9320.20","MA",2013,5,8,128,13,42.2831,-70.8101,56,27,29,46,10,"MA",0.013
"6525",514,"201391.9340.22","MA",2013,5,9,129,13,42.3908,-70.8277,34,27,7,30,4,"MA",0.013
"6526",514,"201391.9310.23","MA",2013,5,9,129,20,42.4172,-70.9554,26,9,17,12,14,"MA",0.013
"6527",514,"201391.9330.24","MA",2013,5,9,129,20,42.3935,-70.9063,24,8,16,20,4,"MA",0.013
"6528",514,"201391.9350.25","MA",2013,5,9,129,13.1,42.4615,-70.8071,39,22,17,37,2,"MA",0.013
"6529",514,"201391.9360.26","MA",2013,5,9,129,20,42.473,-70.63,17,6,11,16,1,"MA",0.013
"6530",514,"201391.9350.27","MA",2013,5,9,129,19.9,42.5101,-70.6935,14,4,10,12,2,"MA",0.013
"6531",514,"201391.9350.28","MA",2013,5,10,130,20,42.5911,-70.5798,15,6,9,14,1,"MA",0.013
"6532",514,"201391.9360.29","MA",2013,5,10,130,20,42.6533,-70.5184,25,11,14,17,8,"MA",0.013
"6533",514,"201391.9350.30","MA",2013,5,10,130,20,42.6877,-70.5669,38,27,11,34,4,"MA",0.013
"6534",514,"201391.9340.31","MA",2013,5,11,131,20,42.6966,-70.5991,26,16,10,23,3,"MA",0.013
"6535",514,"201391.9340.32","MA",2013,5,11,131,20,42.704,-70.6229,36,23,13,32,4,"MA",0.013
"6536",514,"201391.9350.33","MA",2013,5,11,131,19.9,42.7158,-70.6209,34,15,19,33,1,"MA",0.013
"6537",514,"201391.9310.34","MA",2013,5,11,131,20,42.6989,-70.7323,11,2,9,11,0,"MA",0.013
"6538",514,"201391.9320.35","MA",2013,5,11,131,20,42.696,-70.7119,3,1,2,3,0,"MA",0.013
"6539",514,"201391.9330.36","MA",2013,5,11,131,20,42.7579,-70.7497,1,1,0,1,0,"MA",0.013
"6540",513,"201391.9330.37","MA",2013,5,11,131,20,42.8362,-70.7732,14,3,11,14,0,"MA",0.013
"6541",513,"201391.9310.38","MA",2013,5,11,131,20,42.8422,-70.809,22,9,13,22,0,"MA",0.013
"6542",514,"201391.9300.39","MA",2013,5,12,132,20,42.0753,-70.404,1,1,0,1,0,"MA",0.013
"6543",514,"201391.9300.40","MA",2013,5,12,132,20.1,42.0833,-70.3091,1,0,1,1,0,"MA",0.013065
"6544",514,"201391.9290.41","MA",2013,5,12,132,20,42.015,-70.3029,1,0,1,1,0,"MA",0.013
"6545",514,"201391.9280.42","MA",2013,5,13,133,20,41.9119,-70.2363,9,2,7,9,0,"MA",0.013
"6546",514,"201391.9280.43","MA",2013,5,13,133,20.1,41.952,-70.2116,9,0,9,9,0,"MA",0.013065
"6547",514,"201391.9290.44","MA",2013,5,13,133,20,41.9752,-70.2622,17,3,14,17,0,"MA",0.013
"6548",514,"201391.9270.45","MA",2013,5,13,133,20,41.9511,-70.1454,3,1,2,3,0,"MA",0.013
"6549",514,"201391.9260.46","MA",2013,5,13,133,20,42.0102,-70.1137,2,0,2,2,0,"MA",0.013
"6550",514,"201391.9270.47","MA",2013,5,13,133,20,42.0166,-70.1387,3,1,2,3,0,"MA",0.013
"6551",521,"201391.9180.74","MA",2013,5,17,137,20,41.4251,-69.9989,0,0,0,0,0,"MA",0.013
"6552",521,"201391.9180.75","MA",2013,5,17,137,20,41.3733,-69.9573,0,0,0,0,0,"MA",0.013
"6553",521,"201391.9170.76","MA",2013,5,17,137,20,41.3715,-69.9907,0,0,0,0,0,"MA",0.013
"6554",521,"201391.9170.78","MA",2013,5,18,138,20,41.5239,-69.9337,0,0,0,0,0,"MA",0.013
"6555",521,"201391.9170.79","MA",2013,5,18,138,14,41.6344,-69.9286,0,0,0,0,0,"MA",0.013
"6556",521,"201391.9190.82","MA",2013,5,18,138,20,41.7288,-69.8745,1,0,1,1,0,"MA",0.013
"6557",521,"201391.9180.83","MA",2013,5,18,138,20.1,41.7381,-69.901,0,0,0,0,0,"MA",0.013065
"6558",521,"201391.9210.84","MA",2013,5,18,138,20,41.8039,-69.8708,0,0,0,0,0,"MA",0.013
"6559",521,"201391.9200.85","MA",2013,5,18,138,20,41.8005,-69.8741,1,1,0,1,0,"MA",0.013
"6560",521,"201391.9200.86","MA",2013,5,19,139,20,41.8172,-69.8874,1,0,1,1,0,"MA",0.013
"6561",521,"201391.9170.87","MA",2013,5,19,139,20.1,41.8962,-69.9533,5,3,2,5,0,"MA",0.013065
"6562",514,"201391.9180.88","MA",2013,5,19,139,20,42.0751,-70.1046,63,22,41,61,2,"MA",0.013
"6563",514,"201391.9210.89","MA",2013,5,19,139,20,42.1097,-70.1479,5,3,2,5,0,"MA",0.013
"6564",514,"201491.9250.1","MA",2014,5,5,125,20.2,41.84,-70.5182,0,0,0,0,0,"MA",0.01313
"6565",514,"201491.9270.2","MA",2014,5,5,125,20.5,41.8775,-70.4856,0,0,0,0,0,"MA",0.013325
"6566",514,"201491.9280.3","MA",2014,5,5,125,20.1,41.9285,-70.4752,13,8,5,9,4,"MA",0.013065
"6567",514,"201491.9260.4","MA",2014,5,5,125,20,41.9574,-70.5702,0,0,0,0,0,"MA",0.013
"6568",514,"201491.9290.5","MA",2014,5,5,125,20,41.9335,-70.4356,21,10,11,17,4,"MA",0.013
"6569",514,"201491.9280.6","MA",2014,5,5,125,20,41.9289,-70.3273,5,3,2,3,2,"MA",0.013
"6570",514,"201491.9280.7","MA",2014,5,5,125,20.1,41.8859,-70.3833,19,6,13,18,1,"MA",0.013065
"6571",514,"201491.9270.8","MA",2014,5,5,125,20.1,41.8369,-70.4126,3,0,3,3,0,"MA",0.013065
"6572",514,"201491.9260.9","MA",2014,5,6,126,20.1,41.7619,-70.379,1,0,1,1,0,"MA",0.013065
"6573",514,"201491.9250.10","MA",2014,5,6,126,20,41.7443,-70.3219,0,0,0,0,0,"MA",0.013
"6574",514,"201491.9260.11","MA",2014,5,6,126,20.1,41.762,-70.2488,0,0,0,0,0,"MA",0.013065
"6575",514,"201491.9250.12","MA",2014,5,6,126,20,41.7778,-70.1417,0,0,0,0,0,"MA",0.013
"6576",514,"201491.9270.13","MA",2014,5,6,126,20.1,41.8306,-70.2484,5,3,2,5,0,"MA",0.013065
"6577",514,"201491.9270.14","MA",2014,5,6,126,20.7,41.8622,-70.2416,5,2,3,5,0,"MA",0.013455
"6578",514,"201491.9290.15","MA",2014,5,7,127,20.1,42.0466,-70.4509,19,4,15,16,3,"MA",0.013065
"6579",514,"201491.9290.16","MA",2014,5,7,127,20.1,42.0565,-70.4676,2,0,2,2,0,"MA",0.013065
"6580",514,"201491.9350.18","MA",2014,5,7,127,20,42.3203,-70.716,14,5,9,13,1,"MA",0.013
"6581",514,"201491.9340.19","MA",2014,5,7,127,13,42.3196,-70.7326,15,5,10,13,2,"MA",0.013
"6582",514,"201491.9320.20","MA",2014,5,8,128,20,42.2994,-70.8413,2,2,0,2,0,"MA",0.013
"6583",514,"201491.9310.21","MA",2014,5,8,128,20,42.2772,-70.8503,1,1,0,1,0,"MA",0.013
"6584",514,"201491.9330.22","MA",2014,5,8,128,20,42.3123,-70.7986,4,4,0,4,0,"MA",0.013
"6585",514,"201491.9340.23","MA",2014,5,8,128,17,42.3927,-70.8251,13,8,5,13,0,"MA",0.013
"6586",514,"201491.9330.24","MA",2014,5,8,128,20.1,42.3985,-70.8915,13,5,8,11,2,"MA",0.013065
"6587",514,"201491.9320.25","MA",2014,5,8,128,20,42.4526,-70.9106,3,1,2,3,0,"MA",0.013
"6588",514,"201491.9350.26","MA",2014,5,8,128,20.4,42.3823,-70.6955,8,3,5,8,0,"MA",0.01326
"6589",514,"201491.9350.27","MA",2014,5,8,128,15,42.5084,-70.6968,4,3,1,1,3,"MA",0.013
"6590",514,"201491.9360.28","MA",2014,5,9,129,20.1,42.5164,-70.6262,14,5,9,14,0,"MA",0.013065
"6591",514,"201491.9360.30","MA",2014,5,9,129,20.1,42.6295,-70.5265,29,14,15,17,12,"MA",0.013065
"6592",514,"201491.9340.31","MA",2014,5,9,129,19.7,42.6555,-70.5703,18,9,9,16,2,"MA",0.013
"6593",514,"201491.9350.32","MA",2014,5,8,128,20.2,42.6852,-70.5597,41,23,18,34,7,"MA",0.01313
"6594",514,"201491.9350.33","MA",2014,5,9,129,20,42.707,-70.6026,50,30,20,46,4,"MA",0.013
"6595",514,"201491.9340.34","MA",2014,5,10,130,20,42.7194,-70.6602,5,3,2,5,0,"MA",0.013
"6596",514,"201491.9320.35","MA",2014,5,10,130,20.2,42.6893,-70.6845,4,3,1,4,0,"MA",0.01313
"6597",514,"201491.9310.36","MA",2014,5,10,130,20.1,42.6767,-70.6937,8,4,4,7,1,"MA",0.013065
"6598",514,"201491.9310.37","MA",2014,5,10,130,20.1,42.7524,-70.7843,10,8,2,9,1,"MA",0.013065
"6599",514,"201491.9330.38","MA",2014,5,10,130,20.1,42.7575,-70.7525,8,2,6,7,1,"MA",0.013065
"6600",514,"201491.9330.40","MA",2014,5,10,130,20.1,42.7871,-70.7643,5,1,4,3,2,"MA",0.013065
"6601",514,"201491.9300.41","MA",2014,5,11,131,20.1,42.1157,-70.4114,0,0,0,0,0,"MA",0.013065
"6602",514,"201491.9300.42","MA",2014,5,11,131,20.1,42.1136,-70.3699,0,0,0,0,0,"MA",0.013065
"6603",514,"201491.9290.43","MA",2014,5,11,131,20,42.0417,-70.3122,0,0,0,0,0,"MA",0.013
"6604",514,"201491.9290.44","MA",2014,5,11,131,20,42.0317,-70.3769,0,0,0,0,0,"MA",0.013
"6605",514,"201491.9260.45","MA",2014,5,12,132,20,41.8732,-70.1518,4,1,3,4,0,"MA",0.013
"6606",514,"201491.9280.46","MA",2014,5,12,132,20,41.9331,-70.1983,11,0,11,11,0,"MA",0.013
"6607",514,"201491.9280.47","MA",2014,5,12,132,20,41.9588,-70.2051,5,1,4,5,0,"MA",0.013
"6608",514,"201491.9260.48","MA",2014,5,12,132,20,41.9562,-70.1165,6,1,5,6,0,"MA",0.013
"6609",514,"201491.9270.49","MA",2014,5,12,132,20,41.9758,-70.1343,15,2,13,14,1,"MA",0.013
"6610",514,"201491.9250.50","MA",2014,5,12,132,19.4,42.0407,-70.1191,2,0,2,1,1,"MA",0.013
"6611",514,"201491.9210.51","MA",2014,5,13,133,20,42.096,-70.2255,7,4,3,7,0,"MA",0.013
"6612",514,"201491.9170.52","MA",2014,5,13,133,20,42.092,-70.1919,20,7,13,19,1,"MA",0.013
"6613",514,"201491.9210.53","MA",2014,5,13,133,20,42.1248,-70.1821,2,0,2,2,0,"MA",0.013
"6614",514,"201491.9200.54","MA",2014,5,13,133,20,42.1012,-70.1329,6,0,6,6,0,"MA",0.013
"6615",514,"201491.9200.55","MA",2014,5,14,134,20,42.069,-70.0288,0,0,0,0,0,"MA",0.013
"6616",521,"201491.9180.56","MA",2014,5,14,134,13,41.9765,-69.9887,6,6,0,6,0,"MA",0.013
"6617",521,"201491.9190.57","MA",2014,5,14,134,20,41.8906,-69.9338,5,1,4,5,0,"MA",0.013
"6618",521,"201491.9180.58","MA",2014,5,14,134,20.1,41.6991,-69.9025,1,1,0,1,0,"MA",0.013065
"6619",521,"201491.9170.59","MA",2014,5,14,134,20.1,41.5888,-69.931,0,0,0,0,0,"MA",0.013065
"6620",521,"201491.9180.64","MA",2014,5,15,135,20.1,41.4397,-69.9844,0,0,0,0,0,"MA",0.013065
"6621",521,"201491.9170.65","MA",2014,5,15,135,20,41.3715,-69.9911,0,0,0,0,0,"MA",0.013
"6622",514,"201591.9280.1","MA",2015,5,4,124,20.1,41.9022,-70.4342,31,16,15,30,1,"MA",0.013065
"6623",514,"201591.9280.2","MA",2015,5,4,124,20.2,41.9029,-70.3858,68,26,42,64,4,"MA",0.01313
"6624",514,"201591.9290.3","MA",2015,5,4,124,20,41.9834,-70.4189,26,13,13,25,1,"MA",0.013
"6625",514,"201591.9280.4","MA",2015,5,4,124,20,41.974,-70.5126,12,5,7,10,2,"MA",0.013
"6626",514,"201591.9250.5","MA",2015,5,4,124,20,41.9698,-70.603,1,0,1,1,0,"MA",0.013
"6627",514,"201591.9270.6","MA",2015,5,4,124,20.1,41.8578,-70.4649,2,2,0,2,0,"MA",0.013065
"6628",514,"201591.9290.7","MA",2015,5,5,125,20,42.0587,-70.5006,42,20,22,38,4,"MA",0.013
"6629",514,"201591.9270.8","MA",2015,5,5,125,15,42.0989,-70.5797,7,4,3,7,0,"MA",0.013
"6630",514,"201591.9320.9","MA",2015,5,5,125,16.6,42.2286,-70.7363,0,0,0,0,0,"MA",0.013
"6631",514,"201591.9330.12","MA",2015,5,5,125,13,42.3086,-70.8032,1,1,0,1,0,"MA",0.013
"6632",514,"201591.9320.13","MA",2015,5,5,125,20,42.2928,-70.8589,1,1,0,1,0,"MA",0.013
"6633",514,"201591.9310.14","MA",2015,5,6,126,20.1,42.29,-70.8635,7,1,6,6,1,"MA",0.013065
"6634",514,"201591.9340.15","MA",2015,5,6,126,20,42.3938,-70.8232,25,13,12,19,6,"MA",0.013
"6635",514,"201591.9330.16","MA",2015,5,6,126,20,42.3925,-70.9079,20,11,9,18,2,"MA",0.013
"6636",514,"201591.9340.17","MA",2015,5,6,126,15,42.4406,-70.8678,39,19,20,35,4,"MA",0.013
"6637",514,"201591.9350.18","MA",2015,5,6,126,13,42.454,-70.8197,58,25,33,43,15,"MA",0.013
"6638",514,"201591.9350.19","MA",2015,5,6,126,13,42.4963,-70.7072,72,37,35,67,5,"MA",0.013
"6639",514,"201591.9350.20","MA",2015,5,6,126,20,42.5196,-70.6771,39,19,20,37,2,"MA",0.013
"6640",514,"201591.9350.21","MA",2015,5,7,127,14.4,42.5958,-70.5945,28,16,12,28,0,"MA",0.013
"6641",514,"201591.9350.22","MA",2015,5,7,127,20,42.6088,-70.5605,64,30,34,53,11,"MA",0.013
"6642",514,"201591.9360.23","MA",2015,5,7,127,20.1,42.6336,-70.5268,43,18,25,38,5,"MA",0.013065
"6643",514,"201591.9340.24","MA",2015,5,7,127,20.2,42.7115,-70.6861,12,10,2,12,0,"MA",0.01313
"6644",514,"201591.9330.25","MA",2015,5,7,127,20.2,42.7223,-70.7166,4,1,3,4,0,"MA",0.01313
"6645",514,"201591.9310.26","MA",2015,5,7,127,20,42.7172,-70.7549,6,5,1,5,1,"MA",0.013
"6646",514,"201591.9310.27","MA",2015,5,7,127,20,42.6814,-70.7001,2,1,1,2,0,"MA",0.013
"6647",514,"201591.9330.28","MA",2015,5,8,128,20.2,42.7786,-70.7683,1,0,1,1,0,"MA",0.01313
"6648",514,"201591.9360.30","MA",2015,5,9,129,13.1,42.4211,-70.6516,32,12,20,32,0,"MA",0.013
"6649",514,"201591.9290.31","MA",2015,5,9,129,20,42.1075,-70.4563,27,9,18,25,2,"MA",0.013
"6650",514,"201591.9300.32","MA",2015,5,9,129,20,42.0728,-70.3474,3,1,2,3,0,"MA",0.013
"6651",514,"201591.9290.33","MA",2015,5,9,129,20,42.0403,-70.4301,13,6,7,13,0,"MA",0.013
"6652",514,"201591.9260.34","MA",2015,5,10,130,20.1,41.7734,-70.4369,4,3,1,4,0,"MA",0.013065
"6653",514,"201591.9270.35","MA",2015,5,10,130,20,41.7928,-70.3291,3,1,2,3,0,"MA",0.013
"6654",514,"201591.9270.36","MA",2015,5,10,130,20,41.8961,-70.1674,4,0,4,4,0,"MA",0.013
"6655",514,"201591.9260.37","MA",2015,5,10,130,20,41.8973,-70.1264,4,1,3,4,0,"MA",0.013
"6656",514,"201591.9250.38","MA",2015,5,10,130,19.9,41.8444,-70.1586,6,2,4,6,0,"MA",0.013
"6657",514,"201591.9260.39","MA",2015,5,10,130,20,41.8451,-70.1931,7,1,6,7,0,"MA",0.013
"6658",514,"201591.9260.40","MA",2015,5,10,130,20,41.7743,-70.3361,4,2,2,4,0,"MA",0.013
"6659",514,"201591.9260.41","MA",2015,5,10,130,19.6,41.8202,-70.4803,5,1,4,4,1,"MA",0.013
"6660",514,"201591.9300.42","MA",2015,5,11,131,20,42.1048,-70.3014,5,1,4,5,0,"MA",0.013
"6661",514,"201591.9210.43","MA",2015,5,11,131,14.7,42.119,-70.2187,2,2,0,2,0,"MA",0.013
"6662",514,"201591.9200.45","MA",2015,5,11,131,20,42.1054,-70.154,8,3,5,8,0,"MA",0.013
"6663",514,"201591.9180.46","MA",2015,5,11,131,13,42.0751,-70.101,33,12,21,33,0,"MA",0.013
"6664",514,"201591.9170.47","MA",2015,5,11,131,20,42.0662,-70.0884,5,2,3,5,0,"MA",0.013
"6665",514,"201591.9290.48","MA",2015,5,12,132,20,42.0344,-70.2651,6,1,5,6,0,"MA",0.013
"6666",514,"201591.9280.49","MA",2015,5,12,132,20,41.9692,-70.2018,3,0,3,3,0,"MA",0.013
"6667",514,"201591.9280.50","MA",2015,5,12,132,20,41.9432,-70.1895,2,0,2,2,0,"MA",0.013
"6668",514,"201591.9270.51","MA",2015,5,12,132,20,41.9683,-70.1362,4,0,4,4,0,"MA",0.013
"6669",514,"201591.9250.52","MA",2015,5,12,132,20,41.9645,-70.093,1,0,1,0,1,"MA",0.013
"6670",521,"201591.9190.53","MA",2015,5,13,133,20,41.8223,-69.9033,2,2,0,2,0,"MA",0.013
"6671",521,"201591.9210.54","MA",2015,5,13,133,20,41.8178,-69.8724,0,0,0,0,0,"MA",0.013
"6672",521,"201591.9200.55","MA",2015,5,13,133,20,41.7652,-69.8671,1,0,1,1,0,"MA",0.013
"6673",521,"201591.9180.56","MA",2015,5,13,133,19.1,41.645,-69.8964,0,0,0,0,0,"MA",0.013
"6674",521,"201591.9170.57","MA",2015,5,13,133,20,41.6031,-69.937,0,0,0,0,0,"MA",0.013
"6675",521,"201591.9170.61","MA",2015,5,14,134,20,41.3969,-69.9866,0,0,0,0,0,"MA",0.013
"6676",521,"201591.9170.62","MA",2015,5,14,134,20,41.3665,-69.9854,0,0,0,0,0,"MA",0.013
"6677",514,"201691.9170.50","MA",2016,NA,NA,NA,NA,42.0892,-70.1598,36,10,26,36,0,"MA",NA
"6678",521,"201691.9180.53","MA",2016,NA,NA,NA,NA,41.8727,-69.9407,19,6,13,19,0,"MA",NA
"6679",521,"201691.9180.57","MA",2016,NA,NA,NA,NA,41.6977,-69.8722,2,0,2,2,0,"MA",NA
"6680",521,"201691.9200.56","MA",2016,NA,NA,NA,NA,41.786,-69.8681,1,1,0,1,0,"MA",NA
"6681",514,"201691.9210.52","MA",2016,NA,NA,NA,NA,42.0941,-70.0511,1,1,0,1,0,"MA",NA
"6682",514,"201691.9250.10","MA",2016,NA,NA,NA,NA,41.7491,-70.2851,1,0,1,1,0,"MA",NA
"6683",514,"201691.9250.2","MA",2016,NA,NA,NA,NA,41.8512,-70.5121,1,0,1,1,0,"MA",NA
"6684",514,"201691.9260.1","MA",2016,NA,NA,NA,NA,41.8129,-70.5019,6,3,3,6,0,"MA",NA
"6685",514,"201691.9260.11","MA",2016,NA,NA,NA,NA,41.7748,-70.2746,6,2,4,5,1,"MA",NA
"6686",514,"201691.9260.12","MA",2016,NA,NA,NA,NA,41.7825,-70.1616,2,1,1,2,0,"MA",NA
"6687",514,"201691.9260.15","MA",2016,NA,NA,NA,NA,41.8541,-70.1906,5,0,5,5,0,"MA",NA
"6688",514,"201691.9260.9","MA",2016,NA,NA,NA,NA,41.777,-70.4361,7,4,3,7,0,"MA",NA
"6689",514,"201691.9270.16","MA",2016,NA,NA,NA,NA,41.8454,-70.2784,10,6,4,9,1,"MA",NA
"6690",514,"201691.9270.17","MA",2016,NA,NA,NA,NA,41.8281,-70.3162,15,5,10,15,0,"MA",NA
"6691",514,"201691.9270.44","MA",2016,NA,NA,NA,NA,41.9957,-70.1527,6,1,5,6,0,"MA",NA
"6692",514,"201691.9270.49","MA",2016,NA,NA,NA,NA,41.8978,-70.1763,28,11,17,28,0,"MA",NA
"6693",514,"201691.9270.8","MA",2016,NA,NA,NA,NA,41.8428,-70.4136,33,10,23,31,2,"MA",NA
"6694",514,"201691.9280.3","MA",2016,NA,NA,NA,NA,41.9323,-70.4763,59,22,37,49,10,"MA",NA
"6695",514,"201691.9280.4","MA",2016,NA,NA,NA,NA,41.9941,-70.5398,43,24,19,38,5,"MA",NA
"6696",514,"201691.9280.47","MA",2016,NA,NA,NA,NA,41.9413,-70.2477,8,2,6,8,0,"MA",NA
"6697",514,"201691.9280.48","MA",2016,NA,NA,NA,NA,41.9041,-70.2715,6,1,5,5,1,"MA",NA
"6698",514,"201691.9280.7","MA",2016,NA,NA,NA,NA,41.9164,-70.3652,10,4,6,8,2,"MA",NA
"6699",514,"201691.9290.18","MA",2016,NA,NA,NA,NA,42.0808,-70.5238,40,22,18,31,9,"MA",NA
"6700",514,"201691.9290.42","MA",2016,NA,NA,NA,NA,42.1082,-70.4565,14,8,6,14,0,"MA",NA
"6701",514,"201691.9290.45","MA",2016,NA,NA,NA,NA,42.0344,-70.2611,7,3,4,7,0,"MA",NA
"6702",514,"201691.9290.5","MA",2016,NA,NA,NA,NA,41.9999,-70.4214,26,12,14,21,5,"MA",NA
"6703",514,"201691.9290.6","MA",2016,NA,NA,NA,NA,41.9489,-70.404,29,12,17,25,4,"MA",NA
"6704",514,"201691.9300.43","MA",2016,NA,NA,NA,NA,42.0774,-70.4066,4,3,1,4,0,"MA",NA
"6705",514,"201691.9300.46","MA",2016,NA,NA,NA,NA,42.0869,-70.2606,1,1,0,1,0,"MA",NA
"6706",514,"201691.9310.24","MA",2016,NA,NA,NA,NA,42.2914,-70.864,8,1,7,8,0,"MA",NA
"6707",514,"201691.9310.32","MA",2016,NA,NA,NA,NA,42.8273,-70.8025,85,37,48,72,13,"MA",NA
"6708",514,"201691.9310.36","MA",2016,NA,NA,NA,NA,42.7388,-70.7783,84,39,45,73,11,"MA",NA
"6709",514,"201691.9320.19","MA",2016,NA,NA,NA,NA,42.2352,-70.7447,39,7,32,34,5,"MA",NA
"6710",514,"201691.9320.23","MA",2016,NA,NA,NA,NA,42.2998,-70.8398,123,39,84,101,22,"MA",NA
"6711",514,"201691.9320.35","MA",2016,NA,NA,NA,NA,42.7684,-70.7784,38,13,25,37,1,"MA",NA
"6712",514,"201691.9330.22","MA",2016,NA,NA,NA,NA,42.3035,-70.815,123,49,74,98,25,"MA",NA
"6713",514,"201691.9330.25","MA",2016,NA,NA,NA,NA,42.4485,-70.8896,226,85,141,138,88,"MA",NA
"6714",514,"201691.9330.34","MA",2016,NA,NA,NA,NA,42.7854,-70.7618,7,2,5,7,0,"MA",NA
"6715",514,"201691.9330.37","MA",2016,NA,NA,NA,NA,42.6999,-70.6669,25,13,12,22,3,"MA",NA
"6716",514,"201691.9340.21","MA",2016,NA,NA,NA,NA,42.3158,-70.7241,97,54,43,79,18,"MA",NA
"6717",514,"201691.9340.29","MA",2016,NA,NA,NA,NA,42.5456,-70.7227,253,120,133,179,74,"MA",NA
"6718",513,"201691.9340.31","MA",2016,NA,NA,NA,NA,42.8578,-70.7547,41,19,22,39,2,"MA",NA
"6719",514,"201691.9340.38","MA",2016,NA,NA,NA,NA,42.6907,-70.5815,89,55,34,77,12,"MA",NA
"6720",514,"201691.9350.20","MA",2016,NA,NA,NA,NA,42.3184,-70.7186,26,11,15,26,0,"MA",NA
"6721",514,"201691.9350.30","MA",2016,NA,NA,NA,NA,42.5603,-70.6243,26,17,9,17,9,"MA",NA
"6722",514,"201691.9350.39","MA",2016,NA,NA,NA,NA,42.6622,-70.5432,76,34,42,34,42,"MA",NA
"6723",514,"201691.9350.40","MA",2016,NA,NA,NA,NA,42.6993,-70.5853,127,71,56,114,13,"MA",NA
"6724",514,"201691.9360.28","MA",2016,NA,NA,NA,NA,42.4757,-70.6288,36,19,17,36,0,"MA",NA
"6725",514,"201691.9360.41","MA",2016,NA,NA,NA,NA,42.7044,-70.5414,37,18,19,30,7,"MA",NA
"6726",521,"201692.9170.63","MA",2016,NA,NA,NA,NA,41.5854,-69.9394,1,1,0,1,0,"MA",NA
"6727",514,"201692.9170.68","MA",2016,NA,NA,NA,NA,42.0891,-70.156,1,1,0,1,0,"MA",NA
"6728",514,"201692.9210.67","MA",2016,NA,NA,NA,NA,42.0787,-70.0253,2,2,0,2,0,"MA",NA
"6729",514,"201692.9210.70","MA",2016,NA,NA,NA,NA,42.1073,-70.2404,3,3,0,3,0,"MA",NA
"6730",514,"201692.9250.2","MA",2016,NA,NA,NA,NA,41.745,-70.3366,1,1,0,1,0,"MA",NA
"6731",514,"201692.9250.32","MA",2016,NA,NA,NA,NA,41.8277,-70.1136,1,1,0,1,0,"MA",NA
"6732",514,"201692.9250.6","MA",2016,NA,NA,NA,NA,41.9685,-70.6028,8,5,3,6,2,"MA",NA
"6733",514,"201692.9260.1","MA",2016,NA,NA,NA,NA,41.779,-70.4461,14,8,6,11,3,"MA",NA
"6734",514,"201692.9260.33","MA",2016,NA,NA,NA,NA,41.932,-70.1137,10,8,2,10,0,"MA",NA
"6735",514,"201692.9260.5","MA",2016,NA,NA,NA,NA,41.8562,-70.488,35,14,21,33,2,"MA",NA
"6736",514,"201692.9260.7","MA",2016,NA,NA,NA,NA,41.97,-70.5778,235,108,127,181,54,"MA",NA
"6737",514,"201692.9270.3","MA",2016,NA,NA,NA,NA,41.7936,-70.3376,8,3,5,8,0,"MA",NA
"6738",514,"201692.9270.30","MA",2016,NA,NA,NA,NA,41.8765,-70.1947,36,23,13,36,0,"MA",NA
"6739",514,"201692.9270.4","MA",2016,NA,NA,NA,NA,41.8337,-70.4469,45,26,19,42,3,"MA",NA
"6740",514,"201692.9280.27","MA",2016,NA,NA,NA,NA,41.8644,-70.3672,45,20,25,40,5,"MA",NA
"6741",514,"201692.9280.28","MA",2016,NA,NA,NA,NA,41.8769,-70.307,19,15,4,19,0,"MA",NA
"6742",514,"201692.9280.29","MA",2016,NA,NA,NA,NA,41.8764,-70.2316,2,1,1,2,0,"MA",NA
"6743",514,"201692.9280.37","MA",2016,NA,NA,NA,NA,41.93,-70.3231,8,2,6,7,1,"MA",NA
"6744",514,"201692.9280.72","MA",2016,NA,NA,NA,NA,41.9604,-70.1768,6,4,2,6,0,"MA",NA
"6745",514,"201692.9290.36","MA",2016,NA,NA,NA,NA,42.0412,-70.3128,8,3,5,8,0,"MA",NA
"6746",514,"201692.9290.38","MA",2016,NA,NA,NA,NA,41.9444,-70.4115,20,14,6,19,1,"MA",NA
"6747",514,"201692.9290.71","MA",2016,NA,NA,NA,NA,42.0143,-70.2694,3,3,0,3,0,"MA",NA
"6748",514,"201692.9300.34","MA",2016,NA,NA,NA,NA,42.1049,-70.301,5,2,3,5,0,"MA",NA
"6749",514,"201692.9300.35","MA",2016,NA,NA,NA,NA,42.1036,-70.3771,6,1,5,6,0,"MA",NA
"6750",514,"201692.9310.12","MA",2016,NA,NA,NA,NA,42.4415,-70.9221,99,45,54,81,18,"MA",NA
"6751",514,"201692.9310.19","MA",2016,NA,NA,NA,NA,42.7875,-70.7982,34,12,22,21,13,"MA",NA
"6752",514,"201692.9320.10","MA",2016,NA,NA,NA,NA,42.2837,-70.8555,222,94,128,114,108,"MA",NA
"6753",514,"201692.9320.22","MA",2016,NA,NA,NA,NA,42.7198,-70.7513,199,65,134,166,33,"MA",NA
"6754",514,"201692.9320.8","MA",2016,NA,NA,NA,NA,42.233,-70.7462,296,127,169,138,158,"MA",NA
"6755",514,"201692.9330.11","MA",2016,NA,NA,NA,NA,42.448,-70.8787,737,405,332,288,449,"MA",NA
"6756",514,"201692.9330.21","MA",2016,NA,NA,NA,NA,42.7378,-70.7388,64,41,23,62,2,"MA",NA
"6757",514,"201692.9330.23","MA",2016,NA,NA,NA,NA,42.7073,-70.7023,34,19,15,31,3,"MA",NA
"6758",514,"201692.9330.9","MA",2016,NA,NA,NA,NA,42.3096,-70.8068,384,190,194,261,123,"MA",NA
"6759",514,"201692.9340.18","MA",2016,NA,NA,NA,NA,42.7135,-70.6688,37,25,12,35,2,"MA",NA
"6760",514,"201692.9340.20","MA",2016,NA,NA,NA,NA,42.8316,-70.7402,31,22,9,31,0,"MA",NA
"6761",514,"201692.9340.24","MA",2016,NA,NA,NA,NA,42.5423,-70.7341,249,133,116,159,90,"MA",NA
"6762",514,"201692.9350.15","MA",2016,NA,NA,NA,NA,42.5889,-70.5831,104,55,49,67,37,"MA",NA
"6763",514,"201692.9350.17","MA",2016,NA,NA,NA,NA,42.7229,-70.6364,66,32,34,57,9,"MA",NA
"6764",514,"201692.9350.25","MA",2016,NA,NA,NA,NA,42.3761,-70.6967,34,16,18,30,4,"MA",NA
"6765",514,"201692.9360.14","MA",2016,NA,NA,NA,NA,42.4724,-70.6398,41,17,24,35,6,"MA",NA
"6766",514,"201692.9360.16","MA",2016,NA,NA,NA,NA,42.6559,-70.5196,35,19,16,24,11,"MA",NA
"6767",526,"198002.265.1110.1","NMFS",1980,4,18,109,NA,40.016667,-69.633333,1,1,0,0,1,"DE",0.038
"6768",526,"198002.266.1110.2","NMFS",1980,4,19,110,NA,40.05,-69.216667,4,1,3,3,1,"DE",0.038
"6769",526,"198002.267.1100.7","NMFS",1980,4,19,110,NA,40.166667,-69.466667,6,4,2,6,0,"DE",0.038
"6770",526,"198002.268.1100.6","NMFS",1980,4,19,110,NA,40.25,-69.716667,2,0,2,2,0,"DE",0.038
"6771",526,"198002.271.1100.1","NMFS",1980,4,19,110,NA,40.55,-69.9,0,0,0,0,0,"DE",0.038
"6772",526,"198002.272.1090.9","NMFS",1980,4,19,110,NA,40.65,-69.9,0,0,0,0,0,"DE",0.038
"6773",526,"198002.273.1100.8","NMFS",1980,4,19,110,NA,40.566667,-69.65,0,0,0,0,0,"DE",0.038
"6774",526,"198002.274.1090.10","NMFS",1980,4,19,110,NA,40.6,-69.433333,0,0,0,0,0,"DE",0.038
"6775",526,"198002.275.1090.5","NMFS",1980,4,19,110,NA,40.75,-69.4,0,0,0,0,0,"DE",0.038
"6776",526,"198002.276.3550.2","NMFS",1980,4,20,111,NA,41.016667,-69.666667,0,0,0,0,0,"DE",0.038
"6777",526,"198002.277.3550.1","NMFS",1980,4,20,111,NA,41.1,-69.633333,0,0,0,0,0,"DE",0.038
"6778",521,"198002.278.3550.3","NMFS",1980,4,20,111,NA,41.166667,-69.583333,0,0,0,0,0,"DE",0.038
"6779",521,"198002.279.3550.4","NMFS",1980,4,20,111,NA,41.25,-69.516667,0,0,0,0,0,"DE",0.038
"6780",521,"198002.280.1250.2","NMFS",1980,4,20,111,NA,41.2,-69.3,0,0,0,0,0,"DE",0.038
"6781",521,"198002.281.1250.1","NMFS",1980,4,20,111,NA,41.433333,-69.466667,0,0,0,0,0,"DE",0.038
"6782",521,"198002.285.1230.1","NMFS",1980,4,21,112,NA,41.816667,-69.833333,0,0,0,0,0,"DE",0.038
"6783",521,"198002.286.1240.6","NMFS",1980,4,21,112,NA,41.85,-69.716667,0,0,0,0,0,"DE",0.038
"6784",521,"198002.287.1230.3","NMFS",1980,4,21,112,NA,41.933333,-69.8,0,0,0,0,0,"DE",0.038
"6785",521,"198002.288.1270.4","NMFS",1980,4,21,112,NA,42.1,-69.783333,1,1,0,1,0,"DE",0.038
"6786",521,"198002.289.1260.3","NMFS",1980,4,21,112,NA,42.1,-69.966667,0,0,0,0,0,"DE",0.038
"6787",514,"198002.290.3610.1","NMFS",1980,4,21,112,NA,42.133333,-70.116667,0,0,0,0,0,"DE",0.038
"6788",514,"198002.291.1260.5","NMFS",1980,4,21,112,NA,42.1,-70.35,3,0,3,3,0,"DE",0.038
"6789",514,"198002.292.3610.2","NMFS",1980,4,21,112,NA,42.016667,-70.366667,4,1,3,4,0,"DE",0.038
"6790",514,"198002.293.3600.2","NMFS",1980,4,21,112,NA,42,-70.183333,0,0,0,0,0,"DE",0.038
"6791",514,"198002.294.3580.1","NMFS",1980,4,21,112,NA,42.016667,-70.116667,1,0,1,1,0,"DE",0.038
"6792",514,"198002.295.3590.1","NMFS",1980,4,21,112,NA,41.883333,-70.183333,0,0,0,0,0,"DE",0.038
"6793",514,"198002.296.3600.1","NMFS",1980,4,21,112,NA,41.95,-70.466667,2,0,2,2,0,"DE",0.038
"6794",514,"198002.297.3640.1","NMFS",1980,4,21,112,NA,42.25,-70.666667,2,2,0,2,0,"DE",0.038
"6795",514,"198002.298.3650.1","NMFS",1980,4,21,112,NA,42.3,-70.7,31,18,13,31,0,"DE",0.038
"6796",514,"198002.299.3660.1","NMFS",1980,4,22,113,NA,42.383333,-70.716667,18,14,4,18,0,"DE",0.038
"6797",514,"198002.300.1260.4","NMFS",1980,4,22,113,NA,42.333333,-70.566667,1,1,0,1,0,"DE",0.038
"6798",514,"198002.301.1260.1","NMFS",1980,4,22,113,NA,42.366667,-70.516667,0,0,0,0,0,"DE",0.038
"6799",514,"198002.302.1260.2","NMFS",1980,4,22,113,NA,42.466667,-70.166667,0,0,0,0,0,"DE",0.038
"6800",514,"198002.303.1270.3","NMFS",1980,4,22,113,NA,42.733333,-70,0,0,0,0,0,"DE",0.038
"6801",514,"198002.304.1270.2","NMFS",1980,4,22,113,NA,42.816667,-69.983333,0,0,0,0,0,"DE",0.038
"6802",514,"198002.305.3660.2","NMFS",1980,4,22,113,NA,42.733333,-70.616667,2,1,1,2,0,"DE",0.038
"6803",514,"198002.306.1400.1","NMFS",1980,4,22,113,NA,42.783333,-70.633333,1,0,1,1,0,"DE",0.038
"6804",514,"198002.307.3660.3","NMFS",1980,4,22,113,NA,42.833333,-70.7,4,1,3,4,0,"DE",0.038
"6805",513,"198002.308.1400.2","NMFS",1980,4,22,113,NA,42.866667,-70.466667,0,0,0,0,0,"DE",0.038
"6806",513,"198002.309.1370.1","NMFS",1980,4,23,114,NA,43.216667,-69.883333,0,0,0,0,0,"DE",0.038
"6807",513,"198002.310.1270.1","NMFS",1980,4,23,114,NA,43.383333,-70.033333,0,0,0,0,0,"DE",0.038
"6808",513,"198002.311.1380.1","NMFS",1980,4,23,114,NA,43.383333,-69.916667,0,0,0,0,0,"DE",0.038
"6809",513,"198002.312.1380.3","NMFS",1980,4,23,114,NA,43.433333,-69.366667,0,0,0,0,0,"DE",0.038
"6810",513,"198002.313.1380.2","NMFS",1980,4,24,115,NA,43.266667,-69.666667,0,0,0,0,0,"DE",0.038
"6811",513,"198002.314.1370.2","NMFS",1980,4,24,115,NA,43.1,-69.716667,0,0,0,0,0,"DE",0.038
"6812",513,"198002.315.1370.5","NMFS",1980,4,24,115,NA,43.066667,-69.566667,0,0,0,0,0,"DE",0.038
"6813",513,"198002.316.1370.3","NMFS",1980,4,24,115,NA,42.85,-69.533333,0,0,0,0,0,"DE",0.038
"6814",515,"198002.317.1280.5","NMFS",1980,4,24,115,NA,42.666667,-69.55,2,1,1,2,0,"DE",0.038
"6815",515,"198002.318.1370.4","NMFS",1980,4,24,115,NA,42.7,-69.3,0,0,0,0,0,"DE",0.038
"6816",515,"198002.319.1280.1","NMFS",1980,4,24,115,NA,42.583333,-69.216667,0,0,0,0,0,"DE",0.038
"6817",521,"198002.320.1280.2","NMFS",1980,4,24,115,NA,42.216667,-69.45,0,0,0,0,0,"DE",0.038
"6818",521,"198002.321.1280.4","NMFS",1980,4,24,115,NA,41.933333,-69.383333,2,2,0,2,0,"DE",0.038
"6819",521,"198002.322.1280.6","NMFS",1980,4,25,116,NA,42.083333,-69.633333,0,0,0,0,0,"DE",0.038
"6820",521,"198002.323.1280.3","NMFS",1980,4,25,116,NA,42.216667,-69.75,0,0,0,0,0,"DE",0.038
"6821",515,"198002.324.1280.7","NMFS",1980,5,1,122,NA,42.55,-68.783333,0,0,0,0,0,"DE",0.038
"6822",515,"198002.325.1290.4","NMFS",1980,5,1,122,NA,42.466667,-68.366667,0,0,0,0,0,"DE",0.038
"6823",522,"198002.326.1290.7","NMFS",1980,5,1,122,NA,42.2,-68.316667,0,0,0,0,0,"DE",0.038
"6824",522,"198002.327.1290.1","NMFS",1980,5,1,122,NA,42.266667,-68.216667,0,0,0,0,0,"DE",0.038
"6825",515,"198002.328.1290.5","NMFS",1980,5,1,122,NA,42.583333,-68.016667,0,0,0,0,0,"DE",0.038
"6826",515,"198002.329.1290.6","NMFS",1980,5,1,122,NA,42.7,-68.2,0,0,0,0,0,"DE",0.038
"6827",515,"198002.330.1360.8","NMFS",1980,5,1,122,NA,42.983333,-68.133333,0,0,0,0,0,"DE",0.038
"6828",465,"198002.331.1360.6","NMFS",1980,5,2,123,NA,43.3,-67.583333,0,0,0,0,0,"DE",0.038
"6829",465,"198002.332.1360.5","NMFS",1980,5,2,123,NA,43.183333,-67.483333,1,1,0,1,0,"DE",0.038
"6830",464,"198002.334.1310.5","NMFS",1980,5,3,124,NA,42.733333,-66.783333,0,0,0,0,0,"DE",0.038
"6831",464,"198002.335.1290.3","NMFS",1980,5,3,124,NA,42.433333,-66.483333,3,3,0,3,0,"DE",0.038
"6832",464,"198002.336.1290.2","NMFS",1980,5,3,124,NA,42.433333,-66.25,0,0,0,0,0,"DE",0.038
"6833",464,"198002.338.1310.6","NMFS",1980,5,3,124,NA,42.183333,-65.55,0,0,0,0,0,"DE",0.038
"6834",464,"198002.341.1320.3","NMFS",1980,5,4,125,NA,42.5,-65.666667,0,0,0,0,0,"DE",0.038
"6835",464,"198002.342.1320.5","NMFS",1980,5,4,125,NA,42.583333,-65.766667,0,0,0,0,0,"DE",0.038
"6836",464,"198002.343.1320.1","NMFS",1980,5,4,125,NA,42.616667,-65.683333,1,0,1,1,0,"DE",0.038
"6837",464,"198002.344.1320.2","NMFS",1980,5,4,125,NA,42.666667,-65.55,0,0,0,0,0,"DE",0.038
"6838",464,"198002.345.1310.7","NMFS",1980,5,4,125,NA,42.783333,-65.583333,0,0,0,0,0,"DE",0.038
"6839",464,"198002.346.1310.3","NMFS",1980,5,4,125,NA,42.733333,-65.75,2,0,2,2,0,"DE",0.038
"6840",464,"198002.347.1320.4","NMFS",1980,5,4,125,NA,42.733333,-66,0,0,0,0,0,"DE",0.038
"6841",464,"198002.348.1310.2","NMFS",1980,5,4,125,NA,42.883333,-66.533333,0,0,0,0,0,"DE",0.038
"6842",465,"198002.350.1330.1","NMFS",1980,5,4,125,NA,43.516667,-66.4,1,0,1,1,0,"DE",0.038
"6843",465,"198002.351.1340.6","NMFS",1980,5,5,126,NA,43.583333,-66.983333,0,0,0,0,0,"DE",0.038
"6844",465,"198002.352.1360.4","NMFS",1980,5,5,126,NA,43.466667,-67.266667,1,0,1,1,0,"DE",0.038
"6845",465,"198002.353.1360.2","NMFS",1980,5,5,126,NA,43.55,-67.233333,1,0,1,1,0,"DE",0.038
"6846",465,"198002.354.1360.3","NMFS",1980,5,5,126,NA,43.683333,-67.466667,0,0,0,0,0,"DE",0.038
"6847",512,"198002.355.1360.7","NMFS",1980,5,5,126,NA,43.666667,-67.816667,1,0,1,1,0,"DE",0.038
"6848",465,"198002.356.1360.1","NMFS",1980,5,5,126,NA,43.783333,-67.483333,2,2,0,2,0,"DE",0.038
"6849",465,"198002.357.1340.4","NMFS",1980,5,5,126,NA,43.766667,-67.233333,1,1,0,1,0,"DE",0.038
"6850",465,"198002.358.1340.1","NMFS",1980,5,5,126,NA,43.75,-67.083333,0,0,0,0,0,"DE",0.038
"6851",465,"198002.359.1340.2","NMFS",1980,5,5,126,NA,43.833333,-66.95,0,0,0,0,0,"DE",0.038
"6852",465,"198002.360.1340.5","NMFS",1980,5,5,126,NA,43.733333,-66.8,1,1,0,1,0,"DE",0.038
"6853",465,"198002.361.1340.3","NMFS",1980,5,6,127,NA,43.883333,-66.8,0,0,0,0,0,"DE",0.038
"6854",465,"198002.362.1330.3","NMFS",1980,5,6,127,NA,43.9,-66.633333,0,0,0,0,0,"DE",0.038
"6855",466,"198002.363.1330.4","NMFS",1980,5,5,126,NA,44.066667,-66.433333,2,0,2,2,0,"DE",0.038
"6856",466,"198002.364.1330.2","NMFS",1980,5,6,127,NA,44.1,-66.583333,0,0,0,0,0,"DE",0.038
"6857",466,"198002.365.1350.2","NMFS",1980,5,6,127,NA,44.116667,-66.833333,0,0,0,0,0,"DE",0.038
"6858",511,"198002.367.1350.1","NMFS",1980,5,6,127,NA,44.383333,-67.216667,0,0,0,0,0,"DE",0.038
"6859",511,"198002.368.1390.2","NMFS",1980,5,6,127,NA,44.333333,-67.7,1,0,1,1,0,"DE",0.038
"6860",512,"198002.370.1390.3","NMFS",1980,5,6,127,NA,43.983333,-68.416667,0,0,0,0,0,"DE",0.038
"6861",512,"198002.371.1390.1","NMFS",1980,5,6,127,NA,43.933333,-68.616667,4,2,2,3,1,"DE",0.038
"6862",512,"198002.375.1380.4","NMFS",1980,5,7,128,NA,43.55,-68.583333,0,0,0,0,0,"DE",0.038
"6863",512,"198002.376.1380.5","NMFS",1980,5,7,128,NA,43.366667,-68.683333,0,0,0,0,0,"DE",0.038
"6864",526,"198002.534.1100.14","NMFS",1980,4,10,101,NA,40.566667,-69.866667,0,0,0,0,0,"AL",0.038
"6865",526,"198002.535.1100.17","NMFS",1980,4,10,101,NA,40.516667,-69.85,0,0,0,0,0,"AL",0.038
"6866",526,"198002.536.1100.13","NMFS",1980,4,11,102,NA,40.35,-69.666667,0,0,0,0,0,"AL",0.038
"6867",526,"198002.537.1100.20","NMFS",1980,4,11,102,NA,40.25,-69.45,10,5,5,10,0,"AL",0.038
"6868",526,"198002.538.1100.12","NMFS",1980,4,11,102,NA,40.316667,-69.25,17,4,13,17,0,"AL",0.038
"6869",526,"198002.539.1100.9","NMFS",1980,4,11,102,NA,40.433333,-68.916667,0,0,0,0,0,"AL",0.038
"6870",526,"198002.540.1100.11","NMFS",1980,4,11,102,NA,40.783333,-68.916667,8,3,5,8,0,"AL",0.038
"6871",526,"198002.541.1100.10","NMFS",1980,4,11,102,NA,40.833333,-69.1,0,0,0,0,0,"AL",0.038
"6872",526,"198002.542.1090.14","NMFS",1980,4,11,102,NA,40.933333,-69.25,0,0,0,0,0,"AL",0.038
"6873",526,"198002.543.1090.13","NMFS",1980,4,11,102,NA,40.833333,-69.433333,0,0,0,0,0,"AL",0.038
"6874",526,"198002.544.1090.15","NMFS",1980,4,11,102,NA,40.766667,-69.583333,0,0,0,0,0,"AL",0.038
"6875",526,"198002.545.1090.17","NMFS",1980,4,11,102,NA,40.616667,-69.533333,0,0,0,0,0,"AL",0.038
"6876",521,"198002.552.1230.2","NMFS",1980,4,25,116,NA,41.016667,-68.966667,0,0,0,0,0,"AL",0.038
"6877",522,"198002.553.1230.5","NMFS",1980,4,25,116,NA,41.1,-68.683333,0,0,0,0,0,"AL",0.038
"6878",522,"198002.554.1230.4","NMFS",1980,4,25,116,NA,41.4,-68.5,0,0,0,0,0,"AL",0.038
"6879",522,"198002.555.1200.3","NMFS",1980,4,25,116,NA,41.266667,-68.45,0,0,0,0,0,"AL",0.038
"6880",522,"198002.556.1190.4","NMFS",1980,4,25,116,NA,41.133333,-68.35,0,0,0,0,0,"AL",0.038
"6881",525,"198002.557.1190.1","NMFS",1980,4,25,116,NA,40.883333,-68.3,0,0,0,0,0,"AL",0.038
"6882",525,"198002.558.1190.2","NMFS",1980,4,25,116,NA,40.816667,-68.366667,0,0,0,0,0,"AL",0.038
"6883",525,"198002.559.1130.1","NMFS",1980,4,25,116,NA,40.483333,-68.483333,1,0,1,1,0,"AL",0.038
"6884",525,"198002.560.1140.2","NMFS",1980,4,25,116,NA,40.316667,-68.35,0,0,0,0,0,"AL",0.038
"6885",525,"198002.561.1150.1","NMFS",1980,4,25,116,NA,40.383333,-68.166667,3,0,3,3,0,"AL",0.038
"6886",525,"198002.562.1150.3","NMFS",1980,4,26,117,NA,40.35,-67.766667,0,0,0,0,0,"AL",0.038
"6887",525,"198002.563.1140.1","NMFS",1980,4,26,117,NA,40.516667,-67.466667,1,1,0,0,1,"AL",0.038
"6888",525,"198002.564.1150.2","NMFS",1980,4,26,117,NA,40.5,-67.183333,6,4,2,6,0,"AL",0.038
"6889",525,"198002.565.1140.4","NMFS",1980,4,26,117,NA,40.633333,-67.133333,0,0,0,0,0,"AL",0.038
"6890",525,"198002.566.1140.3","NMFS",1980,4,26,117,NA,40.766667,-66.866667,0,0,0,0,0,"AL",0.038
"6891",562,"198002.567.1160.7","NMFS",1980,4,26,117,NA,40.95,-66.766667,0,0,0,0,0,"AL",0.038
"6892",562,"198002.568.1130.4","NMFS",1980,4,26,117,NA,40.9,-66.95,1,0,1,1,0,"AL",0.038
"6893",525,"198002.569.1130.6","NMFS",1980,4,26,117,NA,40.966667,-67.066667,0,0,0,0,0,"AL",0.038
"6894",525,"198002.570.1130.3","NMFS",1980,4,26,117,NA,40.833333,-67.05,0,0,0,0,0,"AL",0.038
"6895",525,"198002.571.1130.2","NMFS",1980,4,26,117,NA,40.716667,-67.1,1,0,1,1,0,"AL",0.038
"6896",525,"198002.572.1130.5","NMFS",1980,4,26,117,NA,40.7,-67.266667,0,0,0,0,0,"AL",0.038
"6897",525,"198002.573.1130.8","NMFS",1980,4,27,118,NA,40.716667,-67.333333,0,0,0,0,0,"AL",0.038
"6898",525,"198002.575.1130.7","NMFS",1980,4,27,118,NA,40.883333,-67.7,0,0,0,0,0,"AL",0.038
"6899",525,"198002.576.1190.9","NMFS",1980,4,27,118,NA,41.066667,-67.933333,0,0,0,0,0,"AL",0.038
"6900",525,"198002.577.1190.8","NMFS",1980,4,27,118,NA,41.183333,-68.033333,0,0,0,0,0,"AL",0.038
"6901",562,"198002.578.1190.5","NMFS",1980,4,27,118,NA,41.45,-67.566667,0,0,0,0,0,"AL",0.038
"6902",562,"198002.579.1190.3","NMFS",1980,4,27,118,NA,41.3,-67.483333,0,0,0,0,0,"AL",0.038
"6903",562,"198002.580.1190.7","NMFS",1980,4,27,118,NA,41.383333,-67.416667,0,0,0,0,0,"AL",0.038
"6904",562,"198002.581.1160.1","NMFS",1980,4,27,118,NA,41.216667,-66.9,0,0,0,0,0,"AL",0.038
"6905",562,"198002.582.1160.8","NMFS",1980,4,27,118,NA,41.116667,-66.716667,0,0,0,0,0,"AL",0.038
"6906",562,"198002.583.1170.5","NMFS",1980,4,28,119,NA,41.166667,-66.316667,0,0,0,0,0,"AL",0.038
"6907",562,"198002.584.1170.3","NMFS",1980,4,28,119,NA,41.166667,-66.366667,1,0,1,1,0,"AL",0.038
"6908",552,"198002.585.1160.6","NMFS",1980,4,28,119,NA,41.333333,-66.35,2,1,1,2,0,"AL",0.038
"6909",552,"198002.586.1160.10","NMFS",1980,4,28,119,NA,41.4,-66.366667,0,0,0,0,0,"AL",0.038
"6910",552,"198002.587.1160.3","NMFS",1980,4,28,119,NA,41.583333,-66.233333,0,0,0,0,0,"AL",0.038
"6911",552,"198002.588.1170.2","NMFS",1980,4,28,119,NA,41.566667,-66.016667,1,1,0,1,0,"AL",0.038
"6912",552,"198002.589.1170.4","NMFS",1980,4,28,119,NA,41.783333,-65.866667,0,0,0,0,0,"AL",0.038
"6913",552,"198002.590.1160.9","NMFS",1980,4,28,119,NA,41.8,-65.983333,0,0,0,0,0,"AL",0.038
"6914",551,"198002.591.1160.2","NMFS",1980,4,28,119,NA,41.883333,-65.966667,0,0,0,0,0,"AL",0.038
"6915",551,"198002.592.1170.1","NMFS",1980,4,28,119,NA,41.916667,-65.833333,0,0,0,0,0,"AL",0.038
"6916",551,"198002.593.1180.2","NMFS",1980,4,28,119,NA,41.95,-65.766667,1,1,0,1,0,"AL",0.038
"6917",551,"198002.594.1180.1","NMFS",1980,4,28,119,NA,42.033333,-65.9,0,0,0,0,0,"AL",0.038
"6918",551,"198002.595.1220.4","NMFS",1980,4,29,120,NA,42.083333,-66.05,5,2,3,5,0,"AL",0.038
"6919",552,"198002.596.1160.5","NMFS",1980,4,29,120,NA,41.8,-66.433333,0,0,0,0,0,"AL",0.038
"6920",551,"198002.597.1160.4","NMFS",1980,4,29,120,NA,41.883333,-66.516667,0,0,0,0,0,"AL",0.038
"6921",551,"198002.598.1220.1","NMFS",1980,4,29,120,NA,42.15,-66.466667,1,0,1,1,0,"AL",0.038
"6922",551,"198002.599.1210.4","NMFS",1980,4,29,120,NA,42.1,-66.766667,0,0,0,0,0,"AL",0.038
"6923",551,"198002.600.1210.2","NMFS",1980,4,29,120,NA,42.15,-66.95,0,0,0,0,0,"AL",0.038
"6924",464,"198002.601.1300.3","NMFS",1980,4,29,120,NA,42.383333,-66.916667,5,5,0,5,0,"AL",0.038
"6925",464,"198002.602.1290.8","NMFS",1980,4,30,121,NA,42.666667,-67.433333,1,0,1,1,0,"AL",0.038
"6926",464,"198002.603.1300.2","NMFS",1980,4,30,121,NA,42.433333,-67.316667,8,5,3,8,0,"AL",0.038
"6927",561,"198002.604.1300.1","NMFS",1980,4,30,121,NA,42.333333,-67.366667,19,18,1,19,0,"AL",0.038
"6928",561,"198002.605.1210.1","NMFS",1980,4,30,121,NA,42.116667,-67.316667,1,0,1,1,0,"AL",0.038
"6929",562,"198002.606.1190.6","NMFS",1980,4,30,121,NA,41.766667,-67.116667,1,0,1,1,0,"AL",0.038
"6930",522,"198002.607.1200.5","NMFS",1980,4,30,121,NA,41.816667,-67.716667,0,0,0,0,0,"AL",0.038
"6931",522,"198002.608.1200.1","NMFS",1980,4,30,121,NA,41.883333,-67.783333,0,0,0,0,0,"AL",0.038
"6932",522,"198002.609.1200.4","NMFS",1980,4,30,121,NA,41.85,-67.8,2,1,1,2,0,"AL",0.038
"6933",522,"198002.610.1200.2","NMFS",1980,5,1,122,NA,41.5,-67.933333,0,0,0,0,0,"AL",0.038
"6934",522,"198002.611.1200.6","NMFS",1980,5,1,122,NA,41.466667,-68.166667,0,0,0,0,0,"AL",0.038
"6935",522,"198002.612.1210.3","NMFS",1980,5,1,122,NA,41.8,-68.216667,0,0,0,0,0,"AL",0.038
"6936",522,"198002.613.1220.2","NMFS",1980,5,1,122,NA,41.85,-68.183333,0,0,0,0,0,"AL",0.038
"6937",522,"198002.614.1220.3","NMFS",1980,5,1,122,NA,41.766667,-68.4,0,0,0,0,0,"AL",0.038
"6938",522,"198002.615.1240.1","NMFS",1980,5,1,122,NA,41.933333,-68.483333,0,0,0,0,0,"AL",0.038
"6939",522,"198002.616.1240.3","NMFS",1980,5,1,122,NA,42.033333,-68.6,0,0,0,0,0,"AL",0.038
"6940",522,"198002.617.1240.4","NMFS",1980,5,1,122,NA,42.083333,-68.716667,0,0,0,0,0,"AL",0.038
"6941",521,"198002.618.1240.2","NMFS",1980,5,1,122,NA,41.883333,-69.75,0,0,0,0,0,"AL",0.038
"6942",521,"198002.619.1240.5","NMFS",1980,5,2,123,NA,41.733333,-69.083333,0,0,0,0,0,"AL",0.038
"6943",526,"198007.229.1100.5","NMFS",1980,10,12,286,NA,40.516667,-69.983333,0,0,0,0,0,"DE",0.038
"6944",526,"198007.232.1120.3","NMFS",1980,10,12,286,NA,39.933333,-69.55,6,4,2,5,1,"DE",0.038
"6945",526,"198007.233.1110.2","NMFS",1980,10,12,286,NA,39.966667,-69.333333,3,2,1,2,1,"DE",0.038
"6946",526,"198007.234.1100.1","NMFS",1980,10,13,287,NA,40.1,-69.533333,1,0,1,1,0,"DE",0.038
"6947",526,"198007.235.1100.4","NMFS",1980,10,13,287,NA,40.066667,-69.35,0,0,0,0,0,"DE",0.038
"6948",526,"198007.236.1120.2","NMFS",1980,10,13,287,NA,40.116667,-69.033333,0,0,0,0,0,"DE",0.038
"6949",525,"198007.237.1120.1","NMFS",1980,10,13,287,NA,40.116667,-68.816667,1,0,1,1,0,"DE",0.038
"6950",525,"198007.238.1110.3","NMFS",1980,10,13,287,NA,40.166667,-68.8,1,0,1,1,0,"DE",0.038
"6951",525,"198007.239.1150.1","NMFS",1980,10,13,287,NA,40.183333,-68.533333,3,1,2,2,1,"DE",0.038
"6952",525,"198007.240.1130.5","NMFS",1980,10,13,287,NA,40.466667,-68.566667,1,0,1,1,0,"DE",0.038
"6953",525,"198007.241.1140.2","NMFS",1980,10,13,287,NA,40.35,-68.316667,2,0,2,2,0,"DE",0.038
"6954",525,"198007.242.1140.5","NMFS",1980,10,13,287,NA,40.483333,-67.65,2,1,1,2,0,"DE",0.038
"6955",525,"198007.243.1140.4","NMFS",1980,10,13,287,NA,40.45,-67.516667,2,1,1,2,0,"DE",0.038
"6956",525,"198007.244.1140.1","NMFS",1980,10,13,287,NA,40.533333,-67.483333,0,0,0,0,0,"DE",0.038
"6957",525,"198007.245.1150.2","NMFS",1980,10,14,288,NA,40.466667,-67.366667,0,0,0,0,0,"DE",0.038
"6958",525,"198007.246.1140.3","NMFS",1980,10,14,288,NA,40.65,-67.083333,3,0,3,2,1,"DE",0.038
"6959",525,"198007.247.1130.7","NMFS",1980,10,14,288,NA,40.783333,-67.066667,0,0,0,0,0,"DE",0.038
"6960",562,"198007.248.1130.8","NMFS",1980,10,14,288,NA,40.866667,-66.883333,0,0,0,0,0,"DE",0.038
"6961",525,"198007.249.1130.9","NMFS",1980,10,14,288,NA,40.833333,-67.15,0,0,0,0,0,"DE",0.038
"6962",525,"198007.250.1130.3","NMFS",1980,10,14,288,NA,40.933333,-67.566667,7,5,2,6,1,"DE",0.038
"6963",525,"198007.251.1130.6","NMFS",1980,10,14,288,NA,40.966667,-67.683333,1,0,1,1,0,"DE",0.038
"6964",525,"198007.252.1130.2","NMFS",1980,10,14,288,NA,40.733333,-67.75,0,0,0,0,0,"DE",0.038
"6965",525,"198007.253.1130.1","NMFS",1980,10,14,288,NA,40.883333,-67.9,0,0,0,0,0,"DE",0.038
"6966",525,"198007.254.1190.5","NMFS",1980,10,14,288,NA,40.766667,-68.233333,0,0,0,0,0,"DE",0.038
"6967",525,"198007.255.1190.2","NMFS",1980,10,15,289,NA,40.85,-68.316667,0,0,0,0,0,"DE",0.038
"6968",526,"198007.256.1130.4","NMFS",1980,10,15,289,NA,40.983333,-68.883333,0,0,0,0,0,"DE",0.038
"6969",526,"198007.257.1100.6","NMFS",1980,10,15,289,NA,40.983333,-69.133333,0,0,0,0,0,"DE",0.038
"6970",526,"198007.258.1100.7","NMFS",1980,10,15,289,NA,40.833333,-69.05,1,0,1,1,0,"DE",0.038
"6971",526,"198007.259.1100.3","NMFS",1980,10,15,289,NA,40.666667,-68.866667,0,0,0,0,0,"DE",0.038
"6972",526,"198007.260.1100.8","NMFS",1980,10,15,289,NA,40.533333,-69,0,0,0,0,0,"DE",0.038
"6973",526,"198007.261.1090.3","NMFS",1980,10,15,289,NA,40.633333,-69.3,0,0,0,0,0,"DE",0.038
"6974",526,"198007.262.1090.2","NMFS",1980,10,15,289,NA,40.85,-69.333333,0,0,0,0,0,"DE",0.038
"6975",526,"198007.263.1090.4","NMFS",1980,10,15,289,NA,40.783333,-69.416667,0,0,0,0,0,"DE",0.038
"6976",526,"198007.264.1090.1","NMFS",1980,10,15,289,NA,40.716667,-69.733333,0,0,0,0,0,"DE",0.038
"6977",526,"198007.265.3550.3","NMFS",1980,10,15,289,NA,40.983333,-69.566667,0,0,0,0,0,"DE",0.038
"6978",526,"198007.266.3550.2","NMFS",1980,10,16,290,NA,41.1,-69.566667,0,0,0,0,0,"DE",0.038
"6979",521,"198007.267.1250.2","NMFS",1980,10,16,290,NA,41.05,-69.35,6,3,3,6,0,"DE",0.038
"6980",521,"198007.268.1250.3","NMFS",1980,10,16,290,NA,41.116667,-69.216667,3,2,1,3,0,"DE",0.038
"6981",521,"198007.269.1250.4","NMFS",1980,10,16,290,NA,41.283333,-69.383333,1,1,0,1,0,"DE",0.038
"6982",521,"198007.270.3550.4","NMFS",1980,10,16,290,NA,41.35,-69.533333,0,0,0,0,0,"DE",0.038
"6983",521,"198007.271.3550.1","NMFS",1980,10,16,290,NA,41.266667,-69.683333,4,2,2,2,2,"DE",0.038
"6984",521,"198007.272.1230.5","NMFS",1980,10,21,295,NA,41.516667,-69.316667,0,0,0,0,0,"DE",0.038
"6985",521,"198007.273.1230.2","NMFS",1980,10,21,295,NA,41.1,-68.95,0,0,0,0,0,"DE",0.038
"6986",521,"198007.274.1230.3","NMFS",1980,10,21,295,NA,41.233333,-68.85,0,0,0,0,0,"DE",0.038
"6987",522,"198007.275.1230.1","NMFS",1980,10,21,295,NA,41.283333,-68.566667,2,0,2,2,0,"DE",0.038
"6988",522,"198007.276.1230.4","NMFS",1980,10,21,295,NA,41.466667,-68.5,0,0,0,0,0,"DE",0.038
"6989",522,"198007.277.1210.1","NMFS",1980,10,21,295,NA,41.683333,-68.333333,0,0,0,0,0,"DE",0.038
"6990",522,"198007.278.1200.5","NMFS",1980,10,21,295,NA,41.6,-68.25,1,0,1,1,0,"DE",0.038
"6991",522,"198007.279.1200.3","NMFS",1980,10,21,295,NA,41.583333,-68.1,0,0,0,0,0,"DE",0.038
"6992",522,"198007.280.1200.4","NMFS",1980,10,21,295,NA,41.566667,-67.966667,0,0,0,0,0,"DE",0.038
"6993",522,"198007.281.1190.7","NMFS",1980,10,21,295,NA,41.5,-67.833333,0,0,0,0,0,"DE",0.038
"6994",522,"198007.282.1190.8","NMFS",1980,10,21,295,NA,41.416667,-67.7,0,0,0,0,0,"DE",0.038
"6995",562,"198007.283.1190.9","NMFS",1980,10,21,295,NA,41.35,-67.633333,0,0,0,0,0,"DE",0.038
"6996",562,"198007.284.1190.1","NMFS",1980,10,21,295,NA,41.183333,-67.516667,0,0,0,0,0,"DE",0.038
"6997",562,"198007.285.1160.6","NMFS",1980,10,21,295,NA,41.133333,-67.1,0,0,0,0,0,"DE",0.038
"6998",562,"198007.286.1160.12","NMFS",1980,10,22,296,NA,41.05,-66.9,2,2,0,2,0,"DE",0.038
"6999",562,"198007.287.1160.16","NMFS",1980,10,22,296,NA,40.983333,-66.9,0,0,0,0,0,"DE",0.038
"7000",562,"198007.288.1160.4","NMFS",1980,10,22,296,NA,40.966667,-66.833333,0,0,0,0,0,"DE",0.038
"7001",562,"198007.289.1160.3","NMFS",1980,10,22,296,NA,41.1,-66.833333,1,1,0,1,0,"DE",0.038
"7002",562,"198007.290.1160.5","NMFS",1980,10,22,296,NA,41.133333,-66.8,2,0,2,2,0,"DE",0.038
"7003",562,"198007.291.1160.19","NMFS",1980,10,22,296,NA,41.333333,-67.016667,0,0,0,0,0,"DE",0.038
"7004",562,"198007.292.1190.6","NMFS",1980,10,22,296,NA,41.433333,-67.133333,1,1,0,1,0,"DE",0.038
"7005",562,"198007.293.1190.3","NMFS",1980,10,22,296,NA,41.65,-67.216667,7,1,6,7,0,"DE",0.038
"7006",562,"198007.294.1160.13","NMFS",1980,10,22,296,NA,41.6,-66.95,3,2,1,3,0,"DE",0.038
"7007",562,"198007.295.1160.14","NMFS",1980,10,22,296,NA,41.516667,-66.933333,15,6,9,15,0,"DE",0.038
"7008",562,"198007.296.1160.1","NMFS",1980,10,22,296,NA,41.466667,-66.75,9,8,1,9,0,"DE",0.038
"7009",552,"198007.297.1160.8","NMFS",1980,10,22,296,NA,41.566667,-66.55,4,1,3,4,0,"DE",0.038
"7010",522,"198007.298.1220.8","NMFS",1980,10,28,302,NA,41.85,-68.133333,0,0,0,0,0,"DE",0.038
"7011",522,"198007.299.1210.6","NMFS",1980,10,28,302,NA,41.833333,-68.066667,1,0,1,1,0,"DE",0.038
"7012",522,"198007.300.1290.1","NMFS",1980,10,28,302,NA,41.966667,-68.066667,0,0,0,0,0,"DE",0.038
"7013",522,"198007.301.1220.2","NMFS",1980,10,28,302,NA,42,-67.85,0,0,0,0,0,"DE",0.038
"7014",522,"198007.302.1220.1","NMFS",1980,10,28,302,NA,42.083333,-67.833333,0,0,0,0,0,"DE",0.038
"7015",522,"198007.303.1220.5","NMFS",1980,10,28,302,NA,42.116667,-67.666667,0,0,0,0,0,"DE",0.038
"7016",561,"198007.304.1210.5","NMFS",1980,10,28,302,NA,42.033333,-67.6,1,0,1,1,0,"DE",0.038
"7017",522,"198007.305.1200.2","NMFS",1980,10,28,302,NA,41.966667,-67.716667,3,1,2,3,0,"DE",0.038
"7018",561,"198007.306.1200.6","NMFS",1980,10,28,302,NA,42.016667,-67.4,2,0,2,2,0,"DE",0.038
"7019",561,"198007.307.1200.1","NMFS",1980,10,28,302,NA,41.933333,-67.266667,0,0,0,0,0,"DE",0.038
"7020",561,"198007.308.1190.4","NMFS",1980,10,28,302,NA,41.883333,-67.016667,1,1,0,1,0,"DE",0.038
"7021",551,"198007.309.1160.17","NMFS",1980,10,28,302,NA,42.016667,-66.783333,1,0,1,1,0,"DE",0.038
"7022",551,"198007.310.1210.7","NMFS",1980,10,28,302,NA,42.083333,-66.966667,0,0,0,0,0,"DE",0.038
"7023",551,"198007.311.1210.3","NMFS",1980,10,29,303,NA,42.133333,-67.05,0,0,0,0,0,"DE",0.038
"7024",551,"198007.312.1220.4","NMFS",1980,10,29,303,NA,42.166667,-67.066667,0,0,0,0,0,"DE",0.038
"7025",561,"198007.313.1210.2","NMFS",1980,10,29,303,NA,42.133333,-67.183333,2,1,1,2,0,"DE",0.038
"7026",561,"198007.314.1220.7","NMFS",1980,10,29,303,NA,42.15,-67.283333,5,2,3,5,0,"DE",0.038
"7027",561,"198007.315.1210.4","NMFS",1980,10,29,303,NA,42.116667,-67.333333,1,1,0,1,0,"DE",0.038
"7028",561,"198007.316.1290.2","NMFS",1980,10,29,303,NA,42.25,-67.5,0,0,0,0,0,"DE",0.038
"7029",464,"198007.317.1300.1","NMFS",1980,10,29,303,NA,42.483333,-67.233333,0,0,0,0,0,"DE",0.038
"7030",464,"198007.318.1300.3","NMFS",1980,10,29,303,NA,42.5,-66.983333,1,1,0,1,0,"DE",0.038
"7031",551,"198007.319.1300.2","NMFS",1980,10,29,303,NA,42.316667,-66.766667,0,0,0,0,0,"DE",0.038
"7032",551,"198007.320.1290.6","NMFS",1980,10,29,303,NA,42.233333,-66.433333,0,0,0,0,0,"DE",0.038
"7033",551,"198007.322.1160.20","NMFS",1980,10,29,303,NA,41.983333,-66.516667,1,0,1,1,0,"DE",0.038
"7034",552,"198007.323.1160.10","NMFS",1980,10,30,304,NA,41.683333,-66.466667,1,0,1,1,0,"DE",0.038
"7035",552,"198007.324.1160.15","NMFS",1980,10,30,304,NA,41.6,-66.35,0,0,0,0,0,"DE",0.038
"7036",552,"198007.325.1160.18","NMFS",1980,10,30,304,NA,41.5,-66.4,0,0,0,0,0,"DE",0.038
"7037",552,"198007.326.1160.7","NMFS",1980,10,30,304,NA,41.466667,-66.283333,0,0,0,0,0,"DE",0.038
"7038",552,"198007.327.1170.5","NMFS",1980,10,30,304,NA,41.35,-66.25,12,8,4,12,0,"DE",0.038
"7039",552,"198007.328.1160.2","NMFS",1980,10,30,304,NA,41.35,-66.283333,3,2,1,3,0,"DE",0.038
"7040",552,"198007.329.1160.11","NMFS",1980,10,30,304,NA,41.25,-66.35,3,1,2,3,0,"DE",0.038
"7041",562,"198007.330.1170.7","NMFS",1980,10,30,304,NA,41.133333,-66.366667,4,3,1,3,1,"DE",0.038
"7042",562,"198007.331.1180.2","NMFS",1980,10,30,304,NA,41.016667,-66.433333,0,0,0,0,0,"DE",0.038
"7043",552,"198007.332.1180.1","NMFS",1980,10,30,304,NA,41.283333,-66.166667,6,6,0,6,0,"DE",0.038
"7044",552,"198007.333.1180.3","NMFS",1980,10,30,304,NA,41.366667,-66.033333,3,3,0,3,0,"DE",0.038
"7045",552,"198007.334.1170.1","NMFS",1980,10,30,304,NA,41.483333,-66,4,4,0,4,0,"DE",0.038
"7046",552,"198007.335.1160.9","NMFS",1980,10,30,304,NA,41.6,-66,8,8,0,8,0,"DE",0.038
"7047",552,"198007.336.1170.2","NMFS",1980,10,31,305,NA,41.7,-65.8,4,4,0,4,0,"DE",0.038
"7048",552,"198007.337.1170.4","NMFS",1980,10,31,305,NA,41.733333,-65.766667,1,1,0,1,0,"DE",0.038
"7049",552,"198007.338.1170.3","NMFS",1980,10,31,305,NA,41.8,-65.733333,2,2,0,2,0,"DE",0.038
"7050",551,"198007.339.1170.6","NMFS",1980,10,31,305,NA,41.866667,-65.766667,0,0,0,0,0,"DE",0.038
"7051",551,"198007.340.1170.8","NMFS",1980,10,31,305,NA,41.983333,-65.95,0,0,0,0,0,"DE",0.038
"7052",551,"198007.341.1220.3","NMFS",1980,10,31,305,NA,42.116667,-66.1,0,0,0,0,0,"DE",0.038
"7053",551,"198007.342.1220.6","NMFS",1980,10,31,305,NA,42.133333,-66.3,3,1,2,3,0,"DE",0.038
"7054",551,"198007.343.1290.3","NMFS",1980,10,31,305,NA,42.233333,-66.25,0,0,0,0,0,"DE",0.038
"7055",464,"198007.344.1290.7","NMFS",1980,10,31,305,NA,42.466667,-66,2,0,2,2,0,"DE",0.038
"7056",464,"198007.345.1320.2","NMFS",1980,10,31,305,NA,42.466667,-65.716667,0,0,0,0,0,"DE",0.038
"7057",464,"198007.349.1320.1","NMFS",1980,10,31,305,NA,42.65,-65.633333,0,0,0,0,0,"DE",0.038
"7058",464,"198007.352.1310.6","NMFS",1980,11,1,306,NA,42.733333,-65.716667,0,0,0,0,0,"DE",0.038
"7059",464,"198007.354.1320.3","NMFS",1980,11,1,306,NA,42.716667,-66.3,4,2,2,4,0,"DE",0.038
"7060",464,"198007.356.1310.5","NMFS",1980,11,1,306,NA,42.733333,-66.833333,0,0,0,0,0,"DE",0.038
"7061",464,"198007.357.1310.2","NMFS",1980,11,1,306,NA,42.933333,-66.6,1,1,0,1,0,"DE",0.038
"7062",465,"198007.359.1360.7","NMFS",1980,11,2,307,NA,43.116667,-67.4,0,0,0,0,0,"DE",0.038
"7063",465,"198007.360.1360.4","NMFS",1980,11,2,307,NA,43.316667,-66.933333,2,2,0,2,0,"DE",0.038
"7064",465,"198007.361.1340.4","NMFS",1980,11,2,307,NA,43.3,-66.816667,0,0,0,0,0,"DE",0.038
"7065",465,"198007.364.1330.3","NMFS",1980,11,2,307,NA,43.85,-66.4,1,0,1,1,0,"DE",0.038
"7066",465,"198007.365.1330.2","NMFS",1980,11,2,307,NA,43.916667,-66.516667,5,2,3,5,0,"DE",0.038
"7067",466,"198007.366.1330.1","NMFS",1980,11,2,307,NA,44.233333,-66.583333,0,0,0,0,0,"DE",0.038
"7068",466,"198007.367.1350.3","NMFS",1980,11,2,307,NA,44.183333,-66.733333,1,1,0,1,0,"DE",0.038
"7069",466,"198007.368.1350.4","NMFS",1980,11,3,308,NA,44.15,-66.833333,1,1,0,1,0,"DE",0.038
"7070",511,"198007.369.1350.2","NMFS",1980,11,3,308,NA,44.233333,-67.016667,1,0,1,1,0,"DE",0.038
"7071",511,"198007.370.1350.1","NMFS",1980,11,3,308,NA,44.3,-67.05,0,0,0,0,0,"DE",0.038
"7072",511,"198007.371.1340.1","NMFS",1980,11,3,308,NA,44.05,-67.366667,0,0,0,0,0,"DE",0.038
"7073",511,"198007.372.1340.5","NMFS",1980,11,3,308,NA,44,-67.416667,0,0,0,0,0,"DE",0.038
"7074",511,"198007.373.1340.6","NMFS",1980,11,3,308,NA,43.85,-67.4,1,1,0,1,0,"DE",0.038
"7075",511,"198007.374.1340.3","NMFS",1980,11,3,308,NA,43.85,-66.983333,0,0,0,0,0,"DE",0.038
"7076",465,"198007.375.1340.2","NMFS",1980,11,3,308,NA,43.716667,-67.066667,0,0,0,0,0,"DE",0.038
"7077",465,"198007.376.1360.6","NMFS",1980,11,3,308,NA,43.666667,-67.583333,1,0,1,1,0,"DE",0.038
"7078",512,"198007.377.1360.1","NMFS",1980,11,3,308,NA,43.6,-67.8,2,1,1,2,0,"DE",0.038
"7079",512,"198007.378.1380.3","NMFS",1980,11,3,308,NA,43.633333,-68.266667,0,0,0,0,0,"DE",0.038
"7080",512,"198007.379.1390.1","NMFS",1980,11,4,309,NA,43.983333,-68.416667,2,2,0,2,0,"DE",0.038
"7081",512,"198007.380.1390.2","NMFS",1980,11,4,309,NA,43.983333,-68.433333,1,1,0,1,0,"DE",0.038
"7082",512,"198007.381.1390.4","NMFS",1980,11,4,309,NA,43.933333,-68.45,0,0,0,0,0,"DE",0.038
"7083",512,"198007.382.1380.5","NMFS",1980,11,4,309,NA,43.65,-68.816667,1,1,0,1,0,"DE",0.038
"7084",512,"198007.384.1390.3","NMFS",1980,11,4,309,NA,43.75,-69.083333,6,2,4,6,0,"DE",0.038
"7085",513,"198007.385.1400.3","NMFS",1980,11,4,309,NA,43.716667,-69.416667,1,1,0,1,0,"DE",0.038
"7086",513,"198007.386.1380.4","NMFS",1980,11,4,309,NA,43.616667,-69.533333,0,0,0,0,0,"DE",0.038
"7087",513,"198007.387.1380.2","NMFS",1980,11,4,309,NA,43.283333,-69.3,0,0,0,0,0,"DE",0.038
"7088",513,"198007.388.1380.1","NMFS",1980,11,4,309,NA,43.3,-69.05,0,0,0,0,0,"DE",0.038
"7089",515,"198007.389.1370.2","NMFS",1980,11,5,310,NA,43.083333,-69.133333,0,0,0,0,0,"DE",0.038
"7090",513,"198007.390.1370.3","NMFS",1980,11,5,310,NA,43,-69.333333,0,0,0,0,0,"DE",0.038
"7091",515,"198007.392.1370.1","NMFS",1980,11,5,310,NA,42.633333,-69.1,0,0,0,0,0,"DE",0.038
"7092",515,"198007.393.1280.7","NMFS",1980,11,5,310,NA,42.45,-69.266667,0,0,0,0,0,"DE",0.038
"7093",521,"198007.394.1280.4","NMFS",1980,11,5,310,NA,42.3,-68.983333,0,0,0,0,0,"DE",0.038
"7094",515,"198007.395.1280.2","NMFS",1980,11,5,310,NA,42.416667,-68.816667,0,0,0,0,0,"DE",0.038
"7095",515,"198007.396.1280.6","NMFS",1980,11,5,310,NA,42.5,-68.583333,0,0,0,0,0,"DE",0.038
"7096",515,"198007.398.1370.4","NMFS",1980,11,5,310,NA,42.883333,-68.55,0,0,0,0,0,"DE",0.038
"7097",515,"198007.399.1370.5","NMFS",1980,11,5,310,NA,42.95,-68.566667,0,0,0,0,0,"DE",0.038
"7098",515,"198007.400.1360.8","NMFS",1980,11,5,310,NA,43.05,-68.25,0,0,0,0,0,"DE",0.038
"7099",515,"198007.401.1360.5","NMFS",1980,11,6,311,NA,43.133333,-67.966667,0,0,0,0,0,"DE",0.038
"7100",515,"198007.402.1360.3","NMFS",1980,11,6,311,NA,43.083333,-67.766667,0,0,0,0,0,"DE",0.038
"7101",515,"198007.403.1360.2","NMFS",1980,11,6,311,NA,42.833333,-68.1,0,0,0,0,0,"DE",0.038
"7102",515,"198007.404.1290.4","NMFS",1980,11,6,311,NA,42.633333,-68.233333,0,0,0,0,0,"DE",0.038
"7103",515,"198007.405.1290.5","NMFS",1980,11,6,311,NA,42.416667,-68.25,0,0,0,0,0,"DE",0.038
"7104",522,"198007.406.1240.1","NMFS",1980,11,6,311,NA,42.166667,-68.316667,0,0,0,0,0,"DE",0.038
"7105",522,"198007.407.1240.5","NMFS",1980,11,6,311,NA,42.066667,-68.55,0,0,0,0,0,"DE",0.038
"7106",522,"198007.409.1240.6","NMFS",1980,11,6,311,NA,41.7,-68.733333,0,0,0,0,0,"DE",0.038
"7107",521,"198007.410.1240.4","NMFS",1980,11,6,311,NA,41.7,-68.983333,0,0,0,0,0,"DE",0.038
"7108",521,"198007.411.1240.2","NMFS",1980,11,7,312,NA,41.8,-69.016667,0,0,0,0,0,"DE",0.038
"7109",521,"198007.412.1240.3","NMFS",1980,11,7,312,NA,41.866667,-69.366667,0,0,0,0,0,"DE",0.038
"7110",514,"198007.413.3580.1","NMFS",1980,11,12,317,NA,41.75,-70.35,0,0,0,0,0,"DE",0.038
"7111",514,"198007.414.3590.1","NMFS",1980,11,13,318,NA,41.8,-70.366667,11,5,6,8,3,"DE",0.038
"7112",514,"198007.415.3600.1","NMFS",1980,11,13,318,NA,41.933333,-70.283333,5,0,5,5,0,"DE",0.038
"7113",514,"198007.416.3610.1","NMFS",1980,11,13,318,NA,42.016667,-70.316667,5,2,3,5,0,"DE",0.038
"7114",514,"198007.417.3600.2","NMFS",1980,11,13,318,NA,41.966667,-70.533333,32,9,23,26,6,"DE",0.038
"7115",514,"198007.419.3650.1","NMFS",1980,11,13,318,NA,42.316667,-70.716667,52,24,28,52,0,"DE",0.038
"7116",514,"198007.420.1260.1","NMFS",1980,11,13,318,NA,42.333333,-70.566667,15,12,3,15,0,"DE",0.038
"7117",514,"198007.421.1260.2","NMFS",1980,11,13,318,NA,42.283333,-70.266667,1,0,1,1,0,"DE",0.038
"7118",514,"198007.422.1260.3","NMFS",1980,11,13,318,NA,42.366667,-70.383333,0,0,0,0,0,"DE",0.038
"7119",514,"198007.423.3660.2","NMFS",1980,11,13,318,NA,42.45,-70.65,1,0,1,1,0,"DE",0.038
"7120",514,"198007.424.1260.4","NMFS",1980,11,13,318,NA,42.516667,-70.55,1,1,0,1,0,"DE",0.038
"7121",514,"198007.425.3660.3","NMFS",1980,11,14,319,NA,42.633333,-70.5,6,4,2,6,0,"DE",0.038
"7122",514,"198007.426.3660.1","NMFS",1980,11,14,319,NA,42.716667,-70.55,1,0,1,1,0,"DE",0.038
"7123",513,"198007.427.1400.2","NMFS",1980,11,14,319,NA,43.033333,-70.466667,6,1,5,6,0,"DE",0.038
"7124",513,"198007.428.1400.1","NMFS",1980,11,14,319,NA,43.2,-70.35,3,2,1,3,0,"DE",0.038
"7125",513,"198007.429.1270.4","NMFS",1980,11,14,319,NA,43.083333,-70.116667,0,0,0,0,0,"DE",0.038
"7126",513,"198007.430.1270.1","NMFS",1980,11,14,319,NA,42.916667,-70.183333,1,1,0,1,0,"DE",0.038
"7127",513,"198007.431.1270.2","NMFS",1980,11,14,319,NA,42.883333,-70.066667,0,0,0,0,0,"DE",0.038
"7128",514,"198007.432.1270.3","NMFS",1980,11,14,319,NA,42.733333,-70.133333,1,1,0,1,0,"DE",0.038
"7129",514,"198007.433.1280.3","NMFS",1980,11,14,319,NA,42.4,-69.866667,0,0,0,0,0,"DE",0.038
"7130",521,"198007.434.1280.1","NMFS",1980,11,14,319,NA,42.3,-69.566667,0,0,0,0,0,"DE",0.038
"7131",521,"198007.435.1280.5","NMFS",1980,11,14,319,NA,42.25,-69.866667,0,0,0,0,0,"DE",0.038
"7132",514,"198007.436.3610.2","NMFS",1980,11,15,320,NA,42.083333,-70,3,3,0,3,0,"DE",0.038
"7133",521,"198007.437.1260.5","NMFS",1980,11,15,320,NA,42.05,-69.866667,1,1,0,1,0,"DE",0.038
"7134",521,"198007.438.1250.1","NMFS",1980,11,15,320,NA,41.9,-69.85,1,1,0,1,0,"DE",0.038
"7135",521,"198007.439.3560.1","NMFS",1980,11,15,320,NA,41.7,-69.9,0,0,0,0,0,"DE",0.038
"7136",526,"198102.243.1090.1","NMFS",1981,4,16,106,NA,40.633333,-69.933333,0,0,0,0,0,"DE",0.038
"7137",526,"198102.245.1100.7","NMFS",1981,4,16,106,NA,40.383333,-69.733333,0,0,0,0,0,"DE",0.038
"7138",526,"198102.247.1120.2","NMFS",1981,4,16,106,NA,39.916667,-69.7,24,10,14,11,13,"DE",0.038
"7139",526,"198102.264.1090.2","NMFS",1981,4,21,111,NA,40.85,-69.666667,1,0,1,1,0,"DE",0.038
"7140",526,"198102.265.3550.3","NMFS",1981,4,21,111,NA,40.983333,-69.533333,0,0,0,0,0,"DE",0.038
"7141",526,"198102.266.3550.2","NMFS",1981,4,21,111,NA,41.116667,-69.666667,0,0,0,0,0,"DE",0.038
"7142",521,"198102.267.3550.1","NMFS",1981,4,21,111,NA,41.05,-69.483333,0,0,0,0,0,"DE",0.038
"7143",521,"198102.268.1250.1","NMFS",1981,4,21,111,NA,41.05,-69.3,0,0,0,0,0,"DE",0.038
"7144",522,"198102.269.1230.4","NMFS",1981,4,22,112,NA,41.183333,-68.833333,0,0,0,0,0,"DE",0.038
"7145",522,"198102.270.1230.1","NMFS",1981,4,22,112,NA,41.283333,-68.75,0,0,0,0,0,"DE",0.038
"7146",522,"198102.271.1230.3","NMFS",1981,4,22,112,NA,41.083333,-68.75,3,2,1,3,0,"DE",0.038
"7147",522,"198102.272.1230.2","NMFS",1981,4,22,112,NA,41,-68.783333,0,0,0,0,0,"DE",0.038
"7148",525,"198102.273.1190.6","NMFS",1981,4,22,112,NA,40.916667,-68.45,0,0,0,0,0,"DE",0.038
"7149",525,"198102.274.1130.5","NMFS",1981,4,22,112,NA,40.766667,-68.683333,1,1,0,1,0,"DE",0.038
"7150",526,"198102.275.1100.2","NMFS",1981,4,22,112,NA,40.883333,-68.883333,3,2,1,3,0,"DE",0.038
"7151",526,"198102.276.1100.5","NMFS",1981,4,22,112,NA,40.816667,-69.183333,0,0,0,0,0,"DE",0.038
"7152",526,"198102.277.1100.3","NMFS",1981,4,22,112,NA,40.65,-69.1,0,0,0,0,0,"DE",0.038
"7153",526,"198102.278.1100.4","NMFS",1981,4,23,113,NA,40.55,-69.35,0,0,0,0,0,"DE",0.038
"7154",526,"198102.279.1110.2","NMFS",1981,4,23,113,NA,40.066667,-69.25,2,0,2,2,0,"DE",0.038
"7155",526,"198102.280.1110.1","NMFS",1981,4,23,113,NA,40.166667,-68.916667,0,0,0,0,0,"DE",0.038
"7156",526,"198102.281.1100.8","NMFS",1981,4,23,113,NA,40.25,-68.85,0,0,0,0,0,"DE",0.038
"7157",526,"198102.282.1100.6","NMFS",1981,4,23,113,NA,40.366667,-68.966667,0,0,0,0,0,"DE",0.038
"7158",525,"198102.283.1130.4","NMFS",1981,4,23,113,NA,40.466667,-68.816667,0,0,0,0,0,"DE",0.038
"7159",525,"198102.284.1130.2","NMFS",1981,4,23,113,NA,40.6,-68.733333,0,0,0,0,0,"DE",0.038
"7160",525,"198102.285.1130.7","NMFS",1981,4,23,113,NA,40.466667,-68.366667,1,1,0,1,0,"DE",0.038
"7161",525,"198102.286.1150.1","NMFS",1981,4,23,113,NA,40.25,-68.333333,23,8,15,20,3,"DE",0.038
"7162",525,"198102.287.1150.2","NMFS",1981,4,23,113,NA,40.316667,-68.05,4,0,4,4,0,"DE",0.038
"7163",525,"198102.288.1140.2","NMFS",1981,4,24,114,NA,40.4,-67.983333,0,0,0,0,0,"DE",0.038
"7164",525,"198102.289.1130.3","NMFS",1981,4,24,114,NA,40.516667,-67.85,0,0,0,0,0,"DE",0.038
"7165",525,"198102.290.1140.3","NMFS",1981,4,24,114,NA,40.466667,-67.75,1,0,1,1,0,"DE",0.038
"7166",525,"198102.291.1130.1","NMFS",1981,4,24,114,NA,40.85,-67.466667,0,0,0,0,0,"DE",0.038
"7167",525,"198102.292.1130.9","NMFS",1981,4,24,114,NA,40.65,-67.3,1,0,1,1,0,"DE",0.038
"7168",525,"198102.293.1140.4","NMFS",1981,4,24,114,NA,40.5,-67.616667,0,0,0,0,0,"DE",0.038
"7169",525,"198102.294.1140.1","NMFS",1981,4,24,114,NA,40.616667,-67.166667,0,0,0,0,0,"DE",0.038
"7170",562,"198102.295.1130.8","NMFS",1981,4,24,114,NA,40.85,-66.983333,0,0,0,0,0,"DE",0.038
"7171",562,"198102.296.1170.2","NMFS",1981,4,24,114,NA,40.833333,-66.7,0,0,0,0,0,"DE",0.038
"7172",562,"198102.297.1170.4","NMFS",1981,4,25,115,NA,40.9,-66.6,0,0,0,0,0,"DE",0.038
"7173",562,"198102.298.1160.1","NMFS",1981,4,25,115,NA,40.966667,-66.65,0,0,0,0,0,"DE",0.038
"7174",562,"198102.299.1170.3","NMFS",1981,4,25,115,NA,40.983333,-66.5,0,0,0,0,0,"DE",0.038
"7175",562,"198102.300.1160.3","NMFS",1981,4,25,115,NA,41.133333,-66.766667,0,0,0,0,0,"DE",0.038
"7176",562,"198102.301.1160.4","NMFS",1981,4,25,115,NA,41.216667,-66.916667,0,0,0,0,0,"DE",0.038
"7177",562,"198102.302.1160.8","NMFS",1981,4,25,115,NA,41.05,-66.95,0,0,0,0,0,"DE",0.038
"7178",525,"198102.303.1130.6","NMFS",1981,4,25,115,NA,41,-67.35,0,0,0,0,0,"DE",0.038
"7179",562,"198102.304.1160.5","NMFS",1981,4,25,115,NA,41.166667,-67.25,0,0,0,0,0,"DE",0.038
"7180",525,"198102.305.1190.5","NMFS",1981,4,25,115,NA,41.116667,-67.583333,0,0,0,0,0,"DE",0.038
"7181",525,"198102.306.1190.9","NMFS",1981,4,25,115,NA,41.15,-68.033333,0,0,0,0,0,"DE",0.038
"7182",522,"198102.307.1190.4","NMFS",1981,4,25,115,NA,41.466667,-67.7,0,0,0,0,0,"DE",0.038
"7183",562,"198102.308.1190.8","NMFS",1981,4,26,116,NA,41.433333,-67.333333,0,0,0,0,0,"DE",0.038
"7184",562,"198102.309.1190.3","NMFS",1981,4,26,116,NA,41.516667,-67.15,0,0,0,0,0,"DE",0.038
"7185",562,"198102.310.1160.9","NMFS",1981,4,26,116,NA,41.483333,-67,0,0,0,0,0,"DE",0.038
"7186",562,"198102.311.1160.10","NMFS",1981,4,26,116,NA,41.4,-67.016667,0,0,0,0,0,"DE",0.038
"7187",552,"198102.312.1160.7","NMFS",1981,4,26,116,NA,41.25,-66.333333,0,0,0,0,0,"DE",0.038
"7188",552,"198102.314.1160.6","NMFS",1981,4,26,116,NA,41.75,-65.966667,0,0,0,0,0,"DE",0.038
"7189",552,"198102.315.1170.1","NMFS",1981,4,26,116,NA,41.8,-65.833333,0,0,0,0,0,"DE",0.038
"7190",464,"198102.316.1290.2","NMFS",1981,4,26,116,NA,42.233333,-65.7,11,8,3,11,0,"DE",0.038
"7191",464,"198102.323.1310.1","NMFS",1981,4,27,117,NA,42.716667,-65.716667,0,0,0,0,0,"DE",0.038
"7192",464,"198102.324.1320.3","NMFS",1981,4,27,117,NA,42.683333,-65.716667,0,0,0,0,0,"DE",0.038
"7193",464,"198102.326.1320.4","NMFS",1981,4,27,117,NA,42.483333,-65.633333,0,0,0,0,0,"DE",0.038
"7194",464,"198102.327.1290.8","NMFS",1981,4,27,117,NA,42.416667,-66.066667,1,1,0,1,0,"DE",0.038
"7195",464,"198102.328.1290.7","NMFS",1981,4,28,118,NA,42.466667,-66.033333,11,8,3,11,0,"DE",0.038
"7196",464,"198102.329.1320.1","NMFS",1981,4,28,118,NA,42.666667,-66.016667,0,0,0,0,0,"DE",0.038
"7197",464,"198102.330.1320.2","NMFS",1981,4,28,118,NA,42.766667,-66.266667,0,0,0,0,0,"DE",0.038
"7198",464,"198102.332.1360.5","NMFS",1981,4,28,118,NA,42.816667,-66.666667,0,0,0,0,0,"DE",0.038
"7199",521,"198102.335.1250.3","NMFS",1981,5,6,126,NA,41.283333,-69.366667,0,0,0,0,0,"DE",0.038
"7200",521,"198102.336.1250.2","NMFS",1981,5,6,126,NA,41.416667,-69.416667,1,0,1,1,0,"DE",0.038
"7201",521,"198102.338.1250.4","NMFS",1981,5,6,126,NA,41.75,-69.833333,0,0,0,0,0,"DE",0.038
"7202",521,"198102.339.1280.5","NMFS",1981,5,6,126,NA,41.9,-69.45,0,0,0,0,0,"DE",0.038
"7203",521,"198102.340.1240.2","NMFS",1981,5,7,127,NA,41.716667,-69.266667,0,0,0,0,0,"DE",0.038
"7204",521,"198102.341.1280.2","NMFS",1981,5,7,127,NA,41.883333,-69.283333,0,0,0,0,0,"DE",0.038
"7205",521,"198102.342.1240.1","NMFS",1981,5,7,127,NA,42.033333,-68.966667,0,0,0,0,0,"DE",0.038
"7206",522,"198102.343.1240.3","NMFS",1981,5,7,127,NA,42.133333,-68.533333,0,0,0,0,0,"DE",0.038
"7207",522,"198102.344.1240.6","NMFS",1981,5,7,127,NA,41.933333,-68.666667,0,0,0,0,0,"DE",0.038
"7208",521,"198102.345.1240.4","NMFS",1981,5,7,127,NA,41.75,-68.883333,0,0,0,0,0,"DE",0.038
"7209",522,"198102.346.1240.5","NMFS",1981,5,7,127,NA,41.45,-68.833333,1,1,0,1,0,"DE",0.038
"7210",522,"198102.347.1200.6","NMFS",1981,5,7,127,NA,41.6,-68.283333,0,0,0,0,0,"DE",0.038
"7211",522,"198102.348.1200.4","NMFS",1981,5,7,127,NA,41.616667,-68.233333,2,1,1,2,0,"DE",0.038
"7212",522,"198102.349.1220.2","NMFS",1981,5,8,128,NA,41.75,-68.35,0,0,0,0,0,"DE",0.038
"7213",522,"198102.350.1210.1","NMFS",1981,5,8,128,NA,41.733333,-68.316667,0,0,0,0,0,"DE",0.038
"7214",522,"198102.351.1210.4","NMFS",1981,5,8,128,NA,41.783333,-68.2,0,0,0,0,0,"DE",0.038
"7215",522,"198102.352.1200.2","NMFS",1981,5,8,128,NA,41.8,-67.966667,0,0,0,0,0,"DE",0.038
"7216",561,"198102.353.1200.3","NMFS",1981,5,8,128,NA,41.9,-67.633333,0,0,0,0,0,"DE",0.038
"7217",562,"198102.354.1190.7","NMFS",1981,5,8,128,NA,41.683333,-67.433333,0,0,0,0,0,"DE",0.038
"7218",562,"198102.355.1190.2","NMFS",1981,5,8,128,NA,41.8,-67.366667,1,1,0,1,0,"DE",0.038
"7219",561,"198102.356.1200.1","NMFS",1981,5,8,128,NA,41.916667,-67.416667,0,0,0,0,0,"DE",0.038
"7220",561,"198102.357.1200.5","NMFS",1981,5,8,128,NA,41.983333,-67.333333,0,0,0,0,0,"DE",0.038
"7221",561,"198102.359.1190.1","NMFS",1981,5,8,128,NA,41.933333,-67.05,2,2,0,1,1,"DE",0.038
"7222",552,"198102.360.1160.2","NMFS",1981,5,8,128,NA,41.833333,-66.75,0,0,0,0,0,"DE",0.038
"7223",551,"198102.362.1290.1","NMFS",1981,5,9,129,NA,42.216667,-66.616667,0,0,0,0,0,"DE",0.038
"7224",551,"198102.363.1210.3","NMFS",1981,5,9,129,NA,42.133333,-66.766667,0,0,0,0,0,"DE",0.038
"7225",551,"198102.364.1210.2","NMFS",1981,5,9,129,NA,42.1,-67,0,0,0,0,0,"DE",0.038
"7226",561,"198102.365.1220.3","NMFS",1981,5,9,129,NA,42.166667,-67.183333,2,2,0,2,0,"DE",0.038
"7227",464,"198102.367.1300.1","NMFS",1981,5,9,129,NA,42.5,-66.9,0,0,0,0,0,"DE",0.038
"7228",464,"198102.368.1290.4","NMFS",1981,5,9,129,NA,42.65,-67,0,0,0,0,0,"DE",0.038
"7229",464,"198102.369.1300.2","NMFS",1981,5,9,129,NA,42.416667,-67.316667,14,13,1,14,0,"DE",0.038
"7230",561,"198102.370.1220.1","NMFS",1981,5,9,129,NA,42.166667,-67.616667,1,1,0,1,0,"DE",0.038
"7231",522,"198102.371.1220.4","NMFS",1981,5,10,130,NA,42.016667,-67.966667,1,0,1,1,0,"DE",0.038
"7232",522,"198102.372.1290.6","NMFS",1981,5,10,130,NA,42.25,-68.05,1,1,0,1,0,"DE",0.038
"7233",515,"198102.373.1290.3","NMFS",1981,5,10,130,NA,42.483333,-68.283333,0,0,0,0,0,"DE",0.038
"7234",515,"198102.374.1290.5","NMFS",1981,5,10,130,NA,42.666667,-67.816667,0,0,0,0,0,"DE",0.038
"7235",515,"198102.375.1360.3","NMFS",1981,5,10,130,NA,42.766667,-67.8,0,0,0,0,0,"DE",0.038
"7236",515,"198102.376.1360.1","NMFS",1981,5,10,130,NA,42.783333,-68.316667,0,0,0,0,0,"DE",0.038
"7237",515,"198102.377.1280.4","NMFS",1981,5,10,130,NA,42.633333,-68.5,1,0,1,1,0,"DE",0.038
"7238",515,"198102.378.1370.3","NMFS",1981,5,10,130,NA,42.816667,-68.816667,1,1,0,1,0,"DE",0.038
"7239",515,"198102.380.1370.1","NMFS",1981,5,11,131,NA,43.133333,-69,0,0,0,0,0,"DE",0.038
"7240",515,"198102.381.1370.4","NMFS",1981,5,11,131,NA,43.116667,-68.7,0,0,0,0,0,"DE",0.038
"7241",515,"198102.383.1360.4","NMFS",1981,5,11,131,NA,43.25,-67.933333,0,0,0,0,0,"DE",0.038
"7242",512,"198102.384.1360.7","NMFS",1981,5,11,131,NA,43.416667,-67.7,2,2,0,2,0,"DE",0.038
"7243",465,"198102.385.1360.2","NMFS",1981,5,11,131,NA,43.166667,-67.35,1,1,0,1,0,"DE",0.038
"7244",465,"198102.386.1340.1","NMFS",1981,5,11,131,NA,43.083333,-66.916667,0,0,0,0,0,"DE",0.038
"7245",465,"198102.387.1340.3","NMFS",1981,5,11,131,NA,43.316667,-66.816667,0,0,0,0,0,"DE",0.038
"7246",465,"198102.389.1340.4","NMFS",1981,5,11,131,NA,43.766667,-66.75,0,0,0,0,0,"DE",0.038
"7247",511,"198102.391.1340.2","NMFS",1981,5,12,132,NA,44.066667,-67.25,0,0,0,0,0,"DE",0.038
"7248",511,"198102.392.1390.3","NMFS",1981,5,12,132,NA,44.316667,-67.683333,0,0,0,0,0,"DE",0.038
"7249",512,"198102.393.1390.2","NMFS",1981,5,12,132,NA,44.083333,-67.866667,1,0,1,1,0,"DE",0.038
"7250",512,"198102.394.1360.6","NMFS",1981,5,12,132,NA,43.9,-67.716667,0,0,0,0,0,"DE",0.038
"7251",511,"198102.396.1350.1","NMFS",1981,5,12,132,NA,44.316667,-67.183333,1,1,0,1,0,"DE",0.038
"7252",467,"198102.397.1350.2","NMFS",1981,5,12,132,NA,44.35,-67,2,0,2,2,0,"DE",0.038
"7253",466,"198102.399.1330.3","NMFS",1981,5,12,132,NA,44.116667,-66.55,0,0,0,0,0,"DE",0.038
"7254",465,"198102.402.1330.1","NMFS",1981,5,13,133,NA,43.766667,-66.5,0,0,0,0,0,"DE",0.038
"7255",465,"198102.403.1330.2","NMFS",1981,5,13,133,NA,43.516667,-66.416667,0,0,0,0,0,"DE",0.038
"7256",465,"198102.404.1340.5","NMFS",1981,5,13,133,NA,43.666667,-67.166667,0,0,0,0,0,"DE",0.038
"7257",512,"198102.406.1380.6","NMFS",1981,5,13,133,NA,43.85,-68.066667,0,0,0,0,0,"DE",0.038
"7258",512,"198102.407.1390.4","NMFS",1981,5,13,133,NA,43.933333,-68.35,0,0,0,0,0,"DE",0.038
"7259",514,"198102.409.3590.1","NMFS",1981,5,21,141,NA,41.833333,-70.433333,99,44,55,56,43,"DE",0.038
"7260",514,"198102.410.3600.2","NMFS",1981,5,21,141,NA,41.883333,-70.383333,30,13,17,23,7,"DE",0.038
"7261",514,"198102.411.3580.1","NMFS",1981,5,21,141,NA,41.833333,-70.166667,6,1,5,5,1,"DE",0.038
"7262",514,"198102.412.3600.1","NMFS",1981,5,21,141,NA,41.883333,-70.216667,1,0,1,1,0,"DE",0.038
"7263",514,"198102.413.3610.2","NMFS",1981,5,21,141,NA,42.033333,-70.45,15,6,9,14,1,"DE",0.038
"7264",514,"198102.414.3660.1","NMFS",1981,5,21,141,NA,42.183333,-70.5,3,1,2,3,0,"DE",0.038
"7265",514,"198102.415.3630.1","NMFS",1981,5,21,141,NA,42.25,-70.683333,13,4,9,11,2,"DE",0.038
"7266",514,"198102.416.3650.1","NMFS",1981,5,21,141,NA,42.366667,-70.7,2,0,2,2,0,"DE",0.038
"7267",514,"198102.417.3640.1","NMFS",1981,5,21,141,NA,42.383333,-70.783333,2,1,1,2,0,"DE",0.038
"7268",514,"198102.418.1260.6","NMFS",1981,5,21,141,NA,42.566667,-70.5,0,0,0,0,0,"DE",0.038
"7269",514,"198102.419.1260.2","NMFS",1981,5,21,141,NA,42.616667,-70.116667,0,0,0,0,0,"DE",0.038
"7270",514,"198102.420.1270.1","NMFS",1981,5,22,142,NA,42.583333,-69.916667,0,0,0,0,0,"DE",0.038
"7271",514,"198102.421.1260.4","NMFS",1981,5,22,142,NA,42.45,-70.183333,0,0,0,0,0,"DE",0.038
"7272",514,"198102.422.1260.3","NMFS",1981,5,22,142,NA,42.5,-70.216667,0,0,0,0,0,"DE",0.038
"7273",514,"198102.423.1260.5","NMFS",1981,5,22,142,NA,42.266667,-70.233333,1,1,0,1,0,"DE",0.038
"7274",514,"198102.424.3610.1","NMFS",1981,5,22,142,NA,42.1,-70.183333,1,1,0,1,0,"DE",0.038
"7275",521,"198102.425.1270.3","NMFS",1981,5,22,142,NA,42.2,-69.933333,0,0,0,0,0,"DE",0.038
"7276",521,"198102.426.1260.1","NMFS",1981,5,22,142,NA,42.05,-69.95,1,1,0,1,0,"DE",0.038
"7277",521,"198102.427.1280.3","NMFS",1981,5,22,142,NA,42.3,-69.433333,1,1,0,1,0,"DE",0.038
"7278",515,"198102.428.1280.1","NMFS",1981,5,22,142,NA,42.35,-69.316667,0,0,0,0,0,"DE",0.038
"7279",515,"198102.429.1280.7","NMFS",1981,5,23,143,NA,42.516667,-69.466667,1,1,0,1,0,"DE",0.038
"7280",515,"198102.430.1370.5","NMFS",1981,5,23,143,NA,42.566667,-68.816667,0,0,0,0,0,"DE",0.038
"7281",515,"198102.431.1280.6","NMFS",1981,5,23,143,NA,42.683333,-69.55,1,1,0,1,0,"DE",0.038
"7282",513,"198102.432.1370.2","NMFS",1981,5,23,143,NA,42.85,-69.566667,0,0,0,0,0,"DE",0.038
"7283",513,"198102.433.1270.2","NMFS",1981,5,23,143,NA,43.166667,-70.1,0,0,0,0,0,"DE",0.038
"7284",513,"198102.434.1270.4","NMFS",1981,5,23,143,NA,43.316667,-70.05,2,2,0,2,0,"DE",0.038
"7285",513,"198102.435.1380.1","NMFS",1981,5,23,143,NA,43.383333,-69.966667,0,0,0,0,0,"DE",0.038
"7286",513,"198102.436.1380.2","NMFS",1981,5,24,144,NA,43.45,-69.9,0,0,0,0,0,"DE",0.038
"7287",513,"198102.437.1400.3","NMFS",1981,5,24,144,NA,43.616667,-69.7,1,1,0,1,0,"DE",0.038
"7288",513,"198102.438.1380.3","NMFS",1981,5,24,144,NA,43.5,-69.5,0,0,0,0,0,"DE",0.038
"7289",513,"198102.439.1400.2","NMFS",1981,5,24,144,NA,43.75,-69.466667,0,0,0,0,0,"DE",0.038
"7290",512,"198102.440.1400.1","NMFS",1981,5,24,144,NA,43.75,-69.083333,1,0,1,1,0,"DE",0.038
"7291",513,"198102.441.1380.5","NMFS",1981,5,24,144,NA,43.55,-69.116667,0,0,0,0,0,"DE",0.038
"7292",512,"198102.442.1380.4","NMFS",1981,5,25,145,NA,43.566667,-68.833333,1,1,0,1,0,"DE",0.038
"7293",512,"198102.443.1390.1","NMFS",1981,5,25,145,NA,43.8,-68.633333,2,1,1,2,0,"DE",0.038
"7294",526,"198106.253.1090.3","NMFS",1981,10,13,286,NA,40.883333,-69.816667,1,1,0,1,0,"DE",0.038
"7295",526,"198106.255.1100.2","NMFS",1981,10,13,286,NA,40.466667,-69.783333,2,2,0,1,1,"DE",0.038
"7296",526,"198106.256.1100.7","NMFS",1981,10,13,286,NA,40.383333,-69.783333,3,1,2,2,1,"DE",0.038
"7297",526,"198106.257.1100.8","NMFS",1981,10,13,286,NA,40.25,-69.733333,4,2,2,1,3,"DE",0.038
"7298",526,"198106.259.1100.3","NMFS",1981,10,13,286,NA,40.466667,-69.416667,10,4,6,8,2,"DE",0.038
"7299",526,"198106.260.1100.4","NMFS",1981,10,14,287,NA,40.45,-69.116667,0,0,0,0,0,"DE",0.038
"7300",526,"198106.263.1120.1","NMFS",1981,10,14,287,NA,39.933333,-69.333333,0,0,0,0,0,"DE",0.038
"7301",526,"198106.264.1110.1","NMFS",1981,10,14,287,NA,40.05,-69.2,10,4,6,8,2,"DE",0.038
"7302",526,"198106.265.1110.2","NMFS",1981,10,14,287,NA,40.116667,-68.95,2,1,1,2,0,"DE",0.038
"7303",525,"198106.266.1140.2","NMFS",1981,10,14,287,NA,40.266667,-68.65,4,3,1,2,2,"DE",0.038
"7304",525,"198106.267.1140.3","NMFS",1981,10,14,287,NA,40.266667,-68.5,1,0,1,1,0,"DE",0.038
"7305",525,"198106.268.1150.1","NMFS",1981,10,15,288,NA,40.25,-68.3,0,0,0,0,0,"DE",0.038
"7306",525,"198106.270.1130.4","NMFS",1981,10,16,289,NA,40.55,-68.366667,2,1,1,2,0,"DE",0.038
"7307",526,"198106.272.1100.5","NMFS",1981,10,15,288,NA,40.7,-68.933333,1,1,0,1,0,"DE",0.038
"7308",526,"198106.273.1100.6","NMFS",1981,10,15,288,NA,40.633333,-69.016667,0,0,0,0,0,"DE",0.038
"7309",526,"198106.274.1100.1","NMFS",1981,10,15,288,NA,40.733333,-68.983333,1,1,0,1,0,"DE",0.038
"7310",526,"198106.276.1090.5","NMFS",1981,10,15,288,NA,40.833333,-69.433333,0,0,0,0,0,"DE",0.038
"7311",521,"198106.277.1250.1","NMFS",1981,10,15,288,NA,41,-69.2,2,2,0,2,0,"DE",0.038
"7312",526,"198106.280.3550.1","NMFS",1981,10,15,288,20,41.116667,-69.516667,0,0,0,0,0,"DE",0.038
"7313",521,"198106.281.3550.3","NMFS",1981,10,16,289,30,41.233333,-69.633333,2,1,1,1,1,"DE",0.038
"7314",521,"198106.282.3550.2","NMFS",1981,10,16,289,30,41.35,-69.533333,1,0,1,1,0,"DE",0.038
"7315",521,"198106.285.1250.2","NMFS",1981,10,20,293,NA,41.983333,-69.9,1,1,0,0,1,"DE",0.038
"7316",521,"198106.286.1240.5","NMFS",1981,10,20,293,NA,41.666667,-69.533333,0,0,0,0,0,"DE",0.038
"7317",521,"198106.288.1240.4","NMFS",1981,10,20,293,NA,41.383333,-69.216667,0,0,0,0,0,"DE",0.038
"7318",522,"198106.289.1230.2","NMFS",1981,10,20,293,NA,41.15,-68.75,1,0,1,1,0,"DE",0.038
"7319",522,"198106.290.1230.1","NMFS",1981,10,21,294,NA,41.1,-68.783333,2,1,1,2,0,"DE",0.038
"7320",525,"198106.291.1190.3","NMFS",1981,10,21,294,NA,40.883333,-68.65,0,0,0,0,0,"DE",0.038
"7321",525,"198106.292.1190.8","NMFS",1981,10,21,294,NA,40.816667,-68.566667,1,0,1,1,0,"DE",0.038
"7322",525,"198106.293.1190.4","NMFS",1981,10,21,294,NA,40.9,-68.333333,0,0,0,0,0,"DE",0.038
"7323",525,"198106.294.1130.9","NMFS",1981,10,21,294,NA,40.766667,-68.133333,1,1,0,1,0,"DE",0.038
"7324",525,"198106.295.1190.7","NMFS",1981,10,21,294,NA,41.15,-68.2,1,1,0,1,0,"DE",0.038
"7325",522,"198106.296.1200.6","NMFS",1981,10,21,294,NA,41.3,-68.266667,0,0,0,0,0,"DE",0.038
"7326",522,"198106.297.1200.4","NMFS",1981,10,21,294,NA,41.233333,-68.433333,0,0,0,0,0,"DE",0.038
"7327",522,"198106.298.1230.4","NMFS",1981,10,21,294,NA,41.4,-68.45,3,2,1,3,0,"DE",0.038
"7328",522,"198106.299.1230.3","NMFS",1981,10,21,294,NA,41.5,-68.416667,2,2,0,2,0,"DE",0.038
"7329",522,"198106.300.1240.1","NMFS",1981,10,21,294,NA,41.7,-68.666667,0,0,0,0,0,"DE",0.038
"7330",522,"198106.301.1200.7","NMFS",1981,10,22,295,NA,41.533333,-68.3,1,0,1,1,0,"DE",0.038
"7331",522,"198106.302.1290.1","NMFS",1981,10,22,295,NA,41.833333,-68.466667,0,0,0,0,0,"DE",0.038
"7332",522,"198106.303.1210.1","NMFS",1981,10,22,295,NA,41.833333,-68.1,0,0,0,0,0,"DE",0.038
"7333",522,"198106.304.1200.1","NMFS",1981,10,22,295,NA,41.666667,-68.033333,2,2,0,2,0,"DE",0.038
"7334",522,"198106.305.1200.2","NMFS",1981,10,21,294,NA,41.566667,-67.883333,1,1,0,1,0,"DE",0.038
"7335",522,"198106.306.1200.5","NMFS",1981,10,22,295,NA,41.716667,-67.716667,0,0,0,0,0,"DE",0.038
"7336",522,"198106.307.1210.4","NMFS",1981,10,22,295,NA,41.916667,-67.916667,0,0,0,0,0,"DE",0.038
"7337",522,"198106.308.1220.4","NMFS",1981,10,22,295,NA,42.033333,-67.766667,0,0,0,0,0,"DE",0.038
"7338",561,"198106.309.1220.2","NMFS",1981,10,23,296,NA,42.1,-67.533333,0,0,0,0,0,"DE",0.038
"7339",561,"198106.310.1200.3","NMFS",1981,10,23,296,NA,42.033333,-67.4,1,1,0,0,1,"DE",0.038
"7340",561,"198106.311.1200.8","NMFS",1981,10,23,296,NA,41.95,-67.466667,1,1,0,1,0,"DE",0.038
"7341",561,"198106.312.1200.9","NMFS",1981,10,23,296,NA,42.066667,-67.266667,1,1,0,1,0,"DE",0.038
"7342",551,"198106.313.1210.2","NMFS",1981,10,23,296,NA,42.133333,-67.1,0,0,0,0,0,"DE",0.038
"7343",551,"198106.314.1220.3","NMFS",1981,10,23,296,NA,42.183333,-67,0,0,0,0,0,"DE",0.038
"7344",551,"198106.315.1220.1","NMFS",1981,10,23,296,NA,42.166667,-66.666667,0,0,0,0,0,"DE",0.038
"7345",551,"198106.316.1210.3","NMFS",1981,10,23,296,NA,42.116667,-66.733333,0,0,0,0,0,"DE",0.038
"7346",551,"198106.317.1160.3","NMFS",1981,10,23,296,NA,42.05,-66.766667,0,0,0,0,0,"DE",0.038
"7347",551,"198106.318.1160.6","NMFS",1981,10,23,296,NA,41.95,-66.766667,3,2,1,2,1,"DE",0.038
"7348",562,"198106.319.1160.4","NMFS",1981,10,24,297,NA,41.683333,-66.833333,3,1,2,3,0,"DE",0.038
"7349",562,"198106.320.1160.10","NMFS",1981,10,24,297,NA,41.583333,-66.683333,3,2,1,3,0,"DE",0.038
"7350",551,"198106.321.1160.1","NMFS",1981,10,24,297,NA,41.983333,-66.4,0,0,0,0,0,"DE",0.038
"7351",551,"198106.322.1160.9","NMFS",1981,10,24,297,NA,41.9,-66.1,0,0,0,0,0,"DE",0.038
"7352",551,"198106.323.1170.1","NMFS",1981,10,24,297,NA,41.966667,-65.866667,0,0,0,0,0,"DE",0.038
"7353",551,"198106.324.1180.1","NMFS",1981,10,24,297,NA,41.95,-65.733333,0,0,0,0,0,"DE",0.038
"7354",552,"198106.325.1170.4","NMFS",1981,10,24,297,NA,41.8,-65.783333,0,0,0,0,0,"DE",0.038
"7355",552,"198106.326.1180.2","NMFS",1981,10,24,297,NA,41.65,-65.816667,0,0,0,0,0,"DE",0.038
"7356",552,"198106.327.1170.3","NMFS",1981,10,24,297,NA,41.566667,-66,1,1,0,1,0,"DE",0.038
"7357",562,"198106.330.1160.2","NMFS",1981,10,25,298,NA,41.166667,-66.516667,1,1,0,1,0,"DE",0.038
"7358",562,"198106.331.1160.7","NMFS",1981,10,25,298,NA,41.083333,-66.483333,2,2,0,2,0,"DE",0.038
"7359",562,"198106.332.1170.2","NMFS",1981,10,25,298,NA,41.1,-66.45,3,3,0,3,0,"DE",0.038
"7360",562,"198106.333.1180.3","NMFS",1981,10,25,298,NA,40.983333,-66.416667,0,0,0,0,0,"DE",0.038
"7361",562,"198106.334.1160.5","NMFS",1981,10,25,298,NA,41.033333,-66.866667,0,0,0,0,0,"DE",0.038
"7362",562,"198106.335.1160.8","NMFS",1981,10,25,298,NA,40.966667,-66.916667,1,0,1,1,0,"DE",0.038
"7363",525,"198106.336.1130.1","NMFS",1981,10,25,298,NA,40.95,-67.4,2,2,0,2,0,"DE",0.038
"7364",525,"198106.337.1130.5","NMFS",1981,10,25,298,NA,40.9,-67.333333,1,0,1,1,0,"DE",0.038
"7365",525,"198106.338.1130.8","NMFS",1981,10,25,298,NA,40.766667,-67.333333,2,0,2,2,0,"DE",0.038
"7366",525,"198106.339.1130.3","NMFS",1981,10,25,298,NA,40.65,-67.266667,0,0,0,0,0,"DE",0.038
"7367",525,"198106.340.1140.4","NMFS",1981,10,26,299,NA,40.533333,-67.366667,1,1,0,1,0,"DE",0.038
"7368",525,"198106.341.1130.7","NMFS",1981,10,26,299,NA,40.616667,-67.516667,0,0,0,0,0,"DE",0.038
"7369",525,"198106.342.1130.6","NMFS",1981,10,26,299,NA,40.516667,-67.833333,1,0,1,0,1,"DE",0.038
"7370",525,"198106.343.1150.2","NMFS",1981,10,26,299,NA,40.316667,-67.966667,0,0,0,0,0,"DE",0.038
"7371",525,"198106.344.1140.1","NMFS",1981,10,26,299,NA,40.366667,-68.033333,1,0,1,1,0,"DE",0.038
"7372",525,"198106.347.1130.2","NMFS",1981,10,26,299,NA,40.933333,-67.833333,0,0,0,0,0,"DE",0.038
"7373",562,"198106.348.1190.5","NMFS",1981,10,26,299,NA,41.183333,-67.55,0,0,0,0,0,"DE",0.038
"7374",562,"198106.349.1190.9","NMFS",1981,10,26,299,NA,41.266667,-67.616667,0,0,0,0,0,"DE",0.038
"7375",562,"198106.350.1190.2","NMFS",1981,10,26,299,NA,41.216667,-67.266667,1,1,0,1,0,"DE",0.038
"7376",562,"198106.351.1190.1","NMFS",1981,10,26,299,NA,41.633333,-67.283333,3,3,0,3,0,"DE",0.038
"7377",562,"198106.352.1190.6","NMFS",1981,10,27,300,NA,41.666667,-67.183333,0,0,0,0,0,"DE",0.038
"7378",561,"198106.356.1220.5","NMFS",1981,10,27,300,NA,42.166667,-67.183333,0,0,0,0,0,"DE",0.038
"7379",551,"198106.357.1290.3","NMFS",1981,10,27,300,NA,42.266667,-67.033333,0,0,0,0,0,"DE",0.038
"7380",464,"198106.358.1300.3","NMFS",1981,10,27,300,NA,42.366667,-66.816667,0,0,0,0,0,"DE",0.038
"7381",551,"198106.359.1300.2","NMFS",1981,10,27,300,NA,42.316667,-66.65,0,0,0,0,0,"DE",0.038
"7382",464,"198106.361.1310.5","NMFS",1981,10,27,300,NA,42.2,-65.583333,0,0,0,0,0,"DE",0.038
"7383",464,"198106.362.1320.2","NMFS",1981,10,28,301,NA,42.4,-65.6,1,0,1,1,0,"DE",0.038
"7384",464,"198106.363.1320.1","NMFS",1981,10,28,301,NA,42.566667,-65.75,0,0,0,0,0,"DE",0.038
"7385",464,"198106.364.1320.3","NMFS",1981,10,28,301,NA,42.65,-65.8,0,0,0,0,0,"DE",0.038
"7386",464,"198106.365.1320.4","NMFS",1981,10,28,301,NA,42.65,-65.65,0,0,0,0,0,"DE",0.038
"7387",464,"198106.370.1320.5","NMFS",1981,10,28,301,NA,42.716667,-66.266667,13,7,6,13,0,"DE",0.038
"7388",522,"198106.372.1290.5","NMFS",1981,10,29,302,NA,42.25,-67.983333,0,0,0,0,0,"DE",0.038
"7389",514,"198106.377.1280.2","NMFS",1981,11,2,306,NA,42.416667,-69.883333,0,0,0,0,0,"DE",0.038
"7390",515,"198106.380.1370.3","NMFS",1981,11,3,307,NA,42.933333,-69.05,0,0,0,0,0,"DE",0.038
"7391",512,"198106.382.1380.4","NMFS",1981,11,3,307,NA,43.35,-68.6,0,0,0,0,0,"DE",0.038
"7392",512,"198106.383.1360.2","NMFS",1981,11,3,307,NA,43.5,-68.083333,1,0,1,1,0,"DE",0.038
"7393",512,"198106.384.1360.4","NMFS",1981,11,3,307,NA,43.666667,-67.8,0,0,0,0,0,"DE",0.038
"7394",512,"198106.385.1360.5","NMFS",1981,11,4,308,NA,43.666667,-67.733333,0,0,0,0,0,"DE",0.038
"7395",511,"198106.387.1340.1","NMFS",1981,11,3,307,NA,43.966667,-67.216667,1,1,0,1,0,"DE",0.038
"7396",511,"198106.389.1390.1","NMFS",1981,11,4,308,NA,44.316667,-67.516667,2,1,1,2,0,"DE",0.038
"7397",511,"198106.390.1350.2","NMFS",1981,11,4,308,NA,44.35,-67.2,0,0,0,0,0,"DE",0.038
"7398",511,"198106.391.1350.4","NMFS",1981,11,4,308,NA,44.216667,-67.15,0,0,0,0,0,"DE",0.038
"7399",466,"198106.393.1350.1","NMFS",1981,11,4,308,NA,44.383333,-66.65,0,0,0,0,0,"DE",0.038
"7400",467,"198106.394.1350.3","NMFS",1981,11,4,308,NA,44.566667,-66.516667,0,0,0,0,0,"DE",0.038
"7401",466,"198106.395.1330.4","NMFS",1981,11,5,309,NA,44.166667,-66.516667,0,0,0,0,0,"DE",0.038
"7402",465,"198106.396.1340.4","NMFS",1981,11,5,309,NA,43.966667,-66.833333,0,0,0,0,0,"DE",0.038
"7403",465,"198106.397.1330.2","NMFS",1981,11,5,309,NA,43.9,-66.5,6,2,4,6,0,"DE",0.038
"7404",465,"198106.398.1330.1","NMFS",1981,11,5,309,NA,43.716667,-66.533333,1,0,1,1,0,"DE",0.038
"7405",465,"198106.399.1340.3","NMFS",1981,11,5,309,NA,43.616667,-66.583333,1,0,1,1,0,"DE",0.038
"7406",465,"198106.400.1340.6","NMFS",1981,11,5,309,NA,43.533333,-66.566667,0,0,0,0,0,"DE",0.038
"7407",465,"198106.401.1330.3","NMFS",1981,11,5,309,NA,43.466667,-66.45,2,1,1,2,0,"DE",0.038
"7408",465,"198106.402.1340.5","NMFS",1981,11,5,309,NA,43.466667,-66.633333,0,0,0,0,0,"DE",0.038
"7409",465,"198106.404.1360.6","NMFS",1981,11,5,309,NA,43.466667,-67.25,1,1,0,1,0,"DE",0.038
"7410",465,"198106.406.1340.2","NMFS",1981,11,5,309,NA,43.1,-67.066667,1,1,0,1,0,"DE",0.038
"7411",464,"198106.408.1310.7","NMFS",1981,11,6,310,NA,42.916667,-66.6,3,3,0,3,0,"DE",0.038
"7412",464,"198106.410.1310.3","NMFS",1981,11,6,310,NA,42.733333,-66.966667,0,0,0,0,0,"DE",0.038
"7413",464,"198106.411.1300.1","NMFS",1981,11,6,310,NA,42.516667,-67.05,0,0,0,0,0,"DE",0.038
"7414",515,"198106.413.1290.2","NMFS",1981,11,6,310,NA,42.616667,-67.7,0,0,0,0,0,"DE",0.038
"7415",515,"198106.414.1360.3","NMFS",1981,11,6,310,NA,42.916667,-67.683333,0,0,0,0,0,"DE",0.038
"7416",515,"198106.415.1360.7","NMFS",1981,11,6,310,NA,43.033333,-67.866667,0,0,0,0,0,"DE",0.038
"7417",515,"198106.416.1360.1","NMFS",1981,11,6,310,NA,43.15,-68.083333,0,0,0,0,0,"DE",0.038
"7418",515,"198106.418.1370.1","NMFS",1981,11,7,311,NA,42.866667,-68.65,0,0,0,0,0,"DE",0.038
"7419",515,"198106.419.1360.8","NMFS",1981,11,7,311,NA,42.833333,-68.15,0,0,0,0,0,"DE",0.038
"7420",515,"198106.420.1290.8","NMFS",1981,11,7,311,NA,42.7,-67.933333,0,0,0,0,0,"DE",0.038
"7421",515,"198106.421.1290.7","NMFS",1981,11,7,311,NA,42.516667,-68.116667,0,0,0,0,0,"DE",0.038
"7422",514,"198106.501.3610.2","NMFS",1981,11,3,307,30,42.066667,-70.283333,5,1,4,5,0,"AL",0.038
"7423",514,"198106.502.3610.1","NMFS",1981,11,3,307,30,42.1,-70.116667,3,3,0,3,0,"AL",0.038
"7424",514,"198106.503.1260.4","NMFS",1981,11,3,307,NA,42.216667,-70.2,0,0,0,0,0,"AL",0.038
"7425",514,"198106.504.3650.1","NMFS",1981,11,3,307,30,42.166667,-70.566667,6,3,3,6,0,"AL",0.038
"7426",514,"198106.505.3660.2","NMFS",1981,11,3,307,30,42.233333,-70.533333,4,3,1,4,0,"AL",0.038
"7427",514,"198106.506.1260.1","NMFS",1981,11,3,307,NA,42.316667,-70.266667,0,0,0,0,0,"AL",0.038
"7428",514,"198106.507.1260.5","NMFS",1981,11,3,307,NA,42.35,-70.233333,1,1,0,1,0,"AL",0.038
"7429",514,"198106.508.1260.2","NMFS",1981,11,3,307,NA,42.433333,-70.433333,0,0,0,0,0,"AL",0.038
"7430",514,"198106.509.1260.3","NMFS",1981,11,3,307,NA,42.616667,-70.35,0,0,0,0,0,"AL",0.038
"7431",514,"198106.510.3660.3","NMFS",1981,11,3,307,30,42.65,-70.516667,3,0,3,3,0,"AL",0.038
"7432",514,"198106.511.3660.1","NMFS",1981,11,4,308,28,42.666667,-70.466667,0,0,0,0,0,"AL",0.038
"7433",514,"198106.512.3640.1","NMFS",1981,11,4,308,30,42.75,-70.7,13,6,7,13,0,"AL",0.038
"7434",513,"198106.516.1270.4","NMFS",1981,11,4,308,NA,43.333333,-70.1,1,1,0,1,0,"AL",0.038
"7435",513,"198106.517.1400.1","NMFS",1981,11,4,308,NA,43.5,-70,0,0,0,0,0,"AL",0.038
"7436",513,"198106.518.1400.2","NMFS",1981,11,4,308,NA,43.533333,-69.7,0,0,0,0,0,"AL",0.038
"7437",513,"198106.519.1380.5","NMFS",1981,11,4,308,NA,43.483333,-69.566667,0,0,0,0,0,"AL",0.038
"7438",512,"198106.522.1390.2","NMFS",1981,11,4,308,NA,43.8,-69.066667,7,3,4,7,0,"AL",0.038
"7439",512,"198106.524.1390.5","NMFS",1981,11,5,309,NA,43.85,-68.533333,1,1,0,1,0,"AL",0.038
"7440",512,"198106.525.1390.3","NMFS",1981,11,5,309,NA,43.933333,-68.55,0,0,0,0,0,"AL",0.038
"7441",512,"198106.526.1390.4","NMFS",1981,11,5,309,NA,43.883333,-68.366667,0,0,0,0,0,"AL",0.038
"7442",512,"198106.527.1380.2","NMFS",1981,11,5,309,NA,43.716667,-68.316667,0,0,0,0,0,"AL",0.038
"7443",513,"198106.530.1380.3","NMFS",1981,11,5,309,NA,43.333333,-69.35,0,0,0,0,0,"AL",0.038
"7444",513,"198106.531.1380.1","NMFS",1981,11,5,309,NA,43.316667,-69.316667,0,0,0,0,0,"AL",0.038
"7445",513,"198106.532.1370.4","NMFS",1981,11,5,309,NA,43.183333,-69.266667,0,0,0,0,0,"AL",0.038
"7446",513,"198106.533.1370.2","NMFS",1981,11,5,309,NA,43.1,-69.45,0,0,0,0,0,"AL",0.038
"7447",513,"198106.534.1370.5","NMFS",1981,11,5,309,NA,42.983333,-69.4,0,0,0,0,0,"AL",0.038
"7448",513,"198106.535.1280.7","NMFS",1981,11,6,310,NA,43,-69.8,0,0,0,0,0,"AL",0.038
"7449",514,"198106.536.1270.2","NMFS",1981,11,6,310,NA,42.783333,-70.1,0,0,0,0,0,"AL",0.038
"7450",514,"198106.538.1270.3","NMFS",1981,11,6,310,NA,42.416667,-69.966667,0,0,0,0,0,"AL",0.038
"7451",514,"198106.539.1260.6","NMFS",1981,11,6,310,NA,42.383333,-70.066667,0,0,0,0,0,"AL",0.038
"7452",521,"198106.540.1270.1","NMFS",1981,11,6,310,NA,42.083333,-69.733333,0,0,0,0,0,"AL",0.038
"7453",521,"198106.541.1280.3","NMFS",1981,11,6,310,NA,42.083333,-69.716667,0,0,0,0,0,"AL",0.038
"7454",521,"198106.542.1280.4","NMFS",1981,11,6,310,NA,42.233333,-69.65,0,0,0,0,0,"AL",0.038
"7455",521,"198106.543.1280.5","NMFS",1981,11,6,310,NA,42.316667,-69.483333,0,0,0,0,0,"AL",0.038
"7456",515,"198106.544.1280.6","NMFS",1981,11,6,310,NA,42.4,-69.3,0,0,0,0,0,"AL",0.038
"7457",521,"198106.545.1280.1","NMFS",1981,11,6,310,NA,42.15,-69.3,0,0,0,0,0,"AL",0.038
"7458",521,"198106.546.1240.3","NMFS",1981,11,7,311,NA,42.1,-69.166667,0,0,0,0,0,"AL",0.038
"7459",522,"198106.548.1240.6","NMFS",1981,11,7,311,NA,42.25,-68.483333,0,0,0,0,0,"AL",0.038
"7460",522,"198106.549.1240.2","NMFS",1981,11,7,311,NA,42.333333,-68.516667,0,0,0,0,0,"AL",0.038
"7461",515,"198106.550.1290.6","NMFS",1981,11,7,311,NA,42.416667,-68.366667,0,0,0,0,0,"AL",0.038
"7462",515,"198106.551.1290.4","NMFS",1981,11,7,311,NA,42.466667,-68.3,0,0,0,0,0,"AL",0.038
"7463",526,"198202.258.1090.4","NMFS",1982,4,15,105,30,40.85,-69.816667,0,0,0,0,0,"DE",0.038
"7464",526,"198202.259.3550.2","NMFS",1982,4,15,105,30,40.966667,-69.8,0,0,0,0,0,"DE",0.038
"7465",526,"198202.260.3550.1","NMFS",1982,4,15,105,30,40.983333,-69.433333,1,1,0,0,1,"DE",0.038
"7466",526,"198202.261.3550.3","NMFS",1982,4,15,105,30,40.9,-69.4,0,0,0,0,0,"DE",0.038
"7467",526,"198202.262.1090.2","NMFS",1982,4,15,105,30,40.683333,-69.466667,0,0,0,0,0,"DE",0.038
"7468",526,"198202.263.1100.3","NMFS",1982,4,15,105,30,40.533333,-69.75,0,0,0,0,0,"DE",0.038
"7469",526,"198202.264.1100.7","NMFS",1982,4,15,105,30,40.383333,-69.85,11,4,7,10,1,"DE",0.038
"7470",526,"198202.269.1110.2","NMFS",1982,4,16,106,30,39.966667,-69.716667,1,1,0,1,0,"DE",0.038
"7471",526,"198202.270.1110.3","NMFS",1982,4,16,106,30,40,-69.266667,1,0,1,1,0,"DE",0.038
"7472",526,"198202.271.1100.8","NMFS",1982,4,16,106,30,40.216667,-69.183333,1,0,1,1,0,"DE",0.038
"7473",526,"198202.272.1120.1","NMFS",1982,4,16,106,30,40.116667,-69.016667,10,5,5,10,0,"DE",0.038
"7474",526,"198202.273.1120.3","NMFS",1982,4,16,106,30,40.066667,-68.916667,0,0,0,0,0,"DE",0.038
"7475",525,"198202.274.1150.3","NMFS",1982,4,16,106,30,40.1,-68.8,0,0,0,0,0,"DE",0.038
"7476",525,"198202.275.1140.1","NMFS",1982,4,16,106,30,40.233333,-68.6,0,0,0,0,0,"DE",0.038
"7477",526,"198202.276.1100.4","NMFS",1982,4,16,106,30,40.266667,-68.95,0,0,0,0,0,"DE",0.038
"7478",526,"198202.277.1100.2","NMFS",1982,4,16,106,30,40.4,-69.1,0,0,0,0,0,"DE",0.038
"7479",526,"198202.278.1100.6","NMFS",1982,4,16,106,30,40.5,-69.083333,0,0,0,0,0,"DE",0.038
"7480",526,"198202.279.1100.1","NMFS",1982,4,17,107,30,40.75,-68.933333,0,0,0,0,0,"DE",0.038
"7481",525,"198202.280.1130.7","NMFS",1982,4,17,107,30,40.6,-68.833333,0,0,0,0,0,"DE",0.038
"7482",525,"198202.281.1130.5","NMFS",1982,4,17,107,30,40.483333,-68.6,0,0,0,0,0,"DE",0.038
"7483",525,"198202.282.1150.1","NMFS",1982,4,17,107,30,40.316667,-68.05,0,0,0,0,0,"DE",0.038
"7484",525,"198202.283.1130.6","NMFS",1982,4,17,107,30,40.516667,-67.883333,0,0,0,0,0,"DE",0.038
"7485",525,"198202.284.1140.4","NMFS",1982,4,17,107,30,40.433333,-67.866667,1,1,0,1,0,"DE",0.038
"7486",525,"198202.285.1140.3","NMFS",1982,4,17,107,30,40.4,-67.816667,0,0,0,0,0,"DE",0.038
"7487",525,"198202.286.1140.2","NMFS",1982,4,17,107,30,40.466667,-67.6,0,0,0,0,0,"DE",0.038
"7488",525,"198202.287.1150.2","NMFS",1982,4,17,107,30,40.483333,-67.433333,0,0,0,0,0,"DE",0.038
"7489",525,"198202.288.1130.2","NMFS",1982,4,17,107,30,40.6,-67.383333,0,0,0,0,0,"DE",0.038
"7490",525,"198202.289.1130.4","NMFS",1982,4,17,107,30,40.85,-67.283333,0,0,0,0,0,"DE",0.038
"7491",525,"198202.290.1130.1","NMFS",1982,4,17,107,30,41.016667,-67.216667,0,0,0,0,0,"DE",0.038
"7492",525,"198202.291.1130.3","NMFS",1982,4,18,108,30,41.016667,-67.383333,0,0,0,0,0,"DE",0.038
"7493",525,"198202.292.1130.9","NMFS",1982,4,18,108,30,40.883333,-67.733333,1,0,1,1,0,"DE",0.038
"7494",525,"198202.293.1130.8","NMFS",1982,4,18,108,30,40.733333,-68.266667,1,0,1,1,0,"DE",0.038
"7495",525,"198202.294.1190.8","NMFS",1982,4,18,108,30,40.75,-68.533333,0,0,0,0,0,"DE",0.038
"7496",525,"198202.295.1190.6","NMFS",1982,4,18,108,30,40.883333,-68.533333,0,0,0,0,0,"DE",0.038
"7497",525,"198202.296.1190.4","NMFS",1982,4,18,108,30,41.133333,-68.25,0,0,0,0,0,"DE",0.038
"7498",522,"198202.297.1200.4","NMFS",1982,4,18,108,30,41.3,-68.316667,0,0,0,0,0,"DE",0.038
"7499",525,"198202.298.1190.3","NMFS",1982,4,18,108,30,41.183333,-68.05,0,0,0,0,0,"DE",0.038
"7500",525,"198202.299.1190.7","NMFS",1982,4,18,108,30,41.15,-67.933333,1,0,1,1,0,"DE",0.038
"7501",525,"198202.300.1190.2","NMFS",1982,4,18,108,30,41.3,-67.75,0,0,0,0,0,"DE",0.038
"7502",522,"198202.301.1200.1","NMFS",1982,4,19,109,30,41.666667,-67.666667,0,0,0,0,0,"DE",0.038
"7503",562,"198202.302.1190.1","NMFS",1982,4,19,109,30,41.616667,-67.3,1,1,0,1,0,"DE",0.038
"7504",562,"198202.303.1190.5","NMFS",1982,4,19,109,30,41.8,-67.1,1,0,1,1,0,"DE",0.038
"7505",562,"198202.304.1190.9","NMFS",1982,4,19,109,30,41.816667,-67.016667,1,0,1,1,0,"DE",0.038
"7506",562,"198202.305.1160.4","NMFS",1982,4,19,109,30,41.55,-66.783333,0,0,0,0,0,"DE",0.038
"7507",562,"198202.306.1160.10","NMFS",1982,4,19,109,30,41.333333,-66.966667,0,0,0,0,0,"DE",0.038
"7508",562,"198202.307.1160.8","NMFS",1982,4,19,109,30,41.3,-66.85,0,0,0,0,0,"DE",0.038
"7509",562,"198202.309.1160.3","NMFS",1982,4,19,109,30,40.85,-66.783333,0,0,0,0,0,"DE",0.038
"7510",562,"198202.310.1180.2","NMFS",1982,4,19,109,30,40.766667,-66.733333,1,1,0,1,0,"DE",0.038
"7511",562,"198202.311.1170.2","NMFS",1982,4,19,109,30,40.933333,-66.566667,0,0,0,0,0,"DE",0.038
"7512",552,"198202.313.1170.4","NMFS",1982,4,20,110,30,41.316667,-66.233333,1,1,0,1,0,"DE",0.038
"7513",552,"198202.314.1180.1","NMFS",1982,4,20,110,30,41.5,-65.933333,0,0,0,0,0,"DE",0.038
"7514",552,"198202.315.1160.1","NMFS",1982,4,20,110,30,41.566667,-66.183333,0,0,0,0,0,"DE",0.038
"7515",552,"198202.316.1160.5","NMFS",1982,4,20,110,30,41.783333,-66.033333,0,0,0,0,0,"DE",0.038
"7516",552,"198202.317.1170.3","NMFS",1982,4,20,110,30,41.8,-65.833333,0,0,0,0,0,"DE",0.038
"7517",551,"198202.318.1180.3","NMFS",1982,4,20,110,30,41.9,-65.75,0,0,0,0,0,"DE",0.038
"7518",551,"198202.319.1170.1","NMFS",1982,4,20,110,30,42.033333,-65.983333,0,0,0,0,0,"DE",0.038
"7519",551,"198202.320.1160.9","NMFS",1982,4,20,110,30,41.883333,-66.05,0,0,0,0,0,"DE",0.038
"7520",551,"198202.321.1160.2","NMFS",1982,4,20,110,30,41.916667,-66.216667,0,0,0,0,0,"DE",0.038
"7521",552,"198202.322.1160.6","NMFS",1982,4,20,110,30,41.833333,-66.55,0,0,0,0,0,"DE",0.038
"7522",551,"198202.323.1160.7","NMFS",1982,4,20,110,30,41.983333,-66.45,0,0,0,0,0,"DE",0.038
"7523",551,"198202.324.1210.3","NMFS",1982,4,21,111,30,42.083333,-66.5,0,0,0,0,0,"DE",0.038
"7524",551,"198202.325.1220.3","NMFS",1982,4,21,111,30,42.166667,-66.633333,1,1,0,1,0,"DE",0.038
"7525",551,"198202.326.1290.2","NMFS",1982,4,21,111,30,42.233333,-66.866667,1,0,1,1,0,"DE",0.038
"7526",551,"198202.327.1290.7","NMFS",1982,4,21,111,30,42.266667,-66.716667,1,0,1,1,0,"DE",0.038
"7527",464,"198202.328.1300.3","NMFS",1982,4,21,111,30,42.383333,-66.833333,0,0,0,0,0,"DE",0.038
"7528",464,"198202.329.1300.1","NMFS",1982,4,21,111,30,42.416667,-66.583333,0,0,0,0,0,"DE",0.038
"7529",464,"198202.330.1290.8","NMFS",1982,4,21,111,30,42.566667,-66.666667,0,0,0,0,0,"DE",0.038
"7530",464,"198202.331.1310.7","NMFS",1982,4,21,111,30,42.65,-66.55,1,1,0,1,0,"DE",0.038
"7531",464,"198202.332.1310.4","NMFS",1982,4,21,111,30,42.65,-66.366667,9,5,4,9,0,"DE",0.038
"7532",464,"198202.333.1320.1","NMFS",1982,4,21,111,30,42.616667,-66.116667,0,0,0,0,0,"DE",0.038
"7533",464,"198202.334.1290.6","NMFS",1982,4,21,111,30,42.466667,-66.166667,0,0,0,0,0,"DE",0.038
"7534",464,"198202.335.1310.3","NMFS",1982,4,21,111,30,42.433333,-65.833333,0,0,0,0,0,"DE",0.038
"7535",464,"198202.336.1310.2","NMFS",1982,4,22,112,30,42.35,-65.65,1,1,0,1,0,"DE",0.038
"7536",464,"198202.337.1320.4","NMFS",1982,4,22,112,30,42.483333,-65.716667,0,0,0,0,0,"DE",0.038
"7537",464,"198202.338.1320.3","NMFS",1982,4,22,112,30,42.683333,-65.533333,0,0,0,0,0,"DE",0.038
"7538",464,"198202.342.1310.1","NMFS",1982,4,22,112,30,42.733333,-66.4,0,0,0,0,0,"DE",0.038
"7539",521,"198202.343.1250.6","NMFS",1982,4,27,117,30,41.7,-69.9,0,0,0,0,0,"DE",0.038
"7540",521,"198202.345.1250.4","NMFS",1982,4,27,117,20,41.9,-69.866667,0,0,0,0,0,"DE",0.038
"7541",521,"198202.346.1240.4","NMFS",1982,4,27,117,30,42,-69.783333,2,2,0,2,0,"DE",0.038
"7542",521,"198202.347.1270.4","NMFS",1982,4,27,117,30,42.116667,-69.8,1,1,0,1,0,"DE",0.038
"7543",521,"198202.348.1280.4","NMFS",1982,4,27,117,30,42.233333,-69.616667,0,0,0,0,0,"DE",0.038
"7544",515,"198202.349.1280.1","NMFS",1982,4,27,117,30,42.35,-69.65,0,0,0,0,0,"DE",0.038
"7545",521,"198202.350.1280.3","NMFS",1982,4,27,117,30,42.283333,-69.516667,0,0,0,0,0,"DE",0.038
"7546",515,"198202.351.1280.6","NMFS",1982,4,27,117,30,42.4,-69.283333,0,0,0,0,0,"DE",0.038
"7547",515,"198202.352.1370.4","NMFS",1982,4,28,118,30,42.916667,-69.166667,0,0,0,0,0,"DE",0.038
"7548",515,"198202.353.1370.2","NMFS",1982,4,28,118,30,42.716667,-68.966667,0,0,0,0,0,"DE",0.038
"7549",515,"198202.354.1370.3","NMFS",1982,4,28,118,30,42.65,-68.75,1,0,1,1,0,"DE",0.038
"7550",515,"198202.355.1280.5","NMFS",1982,4,28,118,30,42.633333,-68.516667,0,0,0,0,0,"DE",0.038
"7551",515,"198202.356.1370.5","NMFS",1982,4,28,118,30,42.783333,-68.5,0,0,0,0,0,"DE",0.038
"7552",515,"198202.357.1290.1","NMFS",1982,4,29,119,30,42.583333,-67.983333,0,0,0,0,0,"DE",0.038
"7553",515,"198202.358.1290.4","NMFS",1982,4,30,120,30,42.566667,-68.166667,0,0,0,0,0,"DE",0.038
"7554",522,"198202.359.1240.5","NMFS",1982,4,30,120,30,42.316667,-68.683333,0,0,0,0,0,"DE",0.038
"7555",515,"198202.360.1280.7","NMFS",1982,4,30,120,30,42.4,-68.833333,0,0,0,0,0,"DE",0.038
"7556",522,"198202.361.1240.1","NMFS",1982,4,30,120,30,42.3,-68.75,0,0,0,0,0,"DE",0.038
"7557",521,"198202.362.1240.2","NMFS",1982,4,30,120,30,42.166667,-69.116667,0,0,0,0,0,"DE",0.038
"7558",521,"198202.363.1240.3","NMFS",1982,4,30,120,30,41.783333,-69.083333,0,0,0,0,0,"DE",0.038
"7559",521,"198202.364.1240.6","NMFS",1982,4,30,120,30,41.75,-69.216667,0,0,0,0,0,"DE",0.038
"7560",521,"198202.365.1230.1","NMFS",1982,4,30,120,30,41.45,-69.283333,0,0,0,0,0,"DE",0.038
"7561",521,"198202.366.1250.2","NMFS",1982,4,30,120,30,41.383333,-69.35,0,0,0,0,0,"DE",0.038
"7562",521,"198202.367.1250.1","NMFS",1982,4,30,120,30,41.433333,-69.483333,0,0,0,0,0,"DE",0.038
"7563",521,"198202.368.3550.4","NMFS",1982,4,30,120,30,41.35,-69.583333,0,0,0,0,0,"DE",0.038
"7564",521,"198202.369.1250.3","NMFS",1982,5,1,121,30,41.233333,-69.35,0,0,0,0,0,"DE",0.038
"7565",521,"198202.370.1230.2","NMFS",1982,5,1,121,30,41.233333,-68.933333,0,0,0,0,0,"DE",0.038
"7566",522,"198202.371.1230.4","NMFS",1982,5,1,121,30,41.15,-68.616667,0,0,0,0,0,"DE",0.038
"7567",522,"198202.372.1230.3","NMFS",1982,5,1,121,30,41.383333,-68.566667,0,0,0,0,0,"DE",0.038
"7568",522,"198202.373.1230.5","NMFS",1982,5,1,121,30,41.416667,-68.483333,0,0,0,0,0,"DE",0.038
"7569",522,"198202.374.1200.3","NMFS",1982,5,1,121,30,41.633333,-68.35,0,0,0,0,0,"DE",0.038
"7570",522,"198202.375.1210.4","NMFS",1982,5,1,121,30,41.733333,-68.2,0,0,0,0,0,"DE",0.038
"7571",522,"198202.376.1200.2","NMFS",1982,5,1,121,30,41.766667,-68.1,0,0,0,0,0,"DE",0.038
"7572",522,"198202.377.1210.2","NMFS",1982,5,1,121,30,41.8,-68.1,1,0,1,1,0,"DE",0.038
"7573",522,"198202.378.1220.4","NMFS",1982,5,1,121,30,41.816667,-68.216667,0,0,0,0,0,"DE",0.038
"7574",522,"198202.379.1290.3","NMFS",1982,5,1,121,30,42,-68.166667,0,0,0,0,0,"DE",0.038
"7575",522,"198202.380.1220.1","NMFS",1982,5,2,122,30,42.133333,-67.75,2,1,1,2,0,"DE",0.038
"7576",561,"198202.381.1200.5","NMFS",1982,5,2,122,30,41.966667,-67.566667,0,0,0,0,0,"DE",0.038
"7577",561,"198202.382.1200.6","NMFS",1982,5,2,122,30,41.983333,-67.233333,1,0,1,1,0,"DE",0.038
"7578",551,"198202.383.1210.1","NMFS",1982,5,2,122,30,42.083333,-67.066667,0,0,0,0,0,"DE",0.038
"7579",561,"198202.384.1220.2","NMFS",1982,5,2,122,30,42.166667,-67.35,0,0,0,0,0,"DE",0.038
"7580",464,"198202.385.1300.2","NMFS",1982,5,2,122,30,42.466667,-67.133333,0,0,0,0,0,"DE",0.038
"7581",464,"198202.386.1290.5","NMFS",1982,5,2,122,30,42.666667,-67.4,0,0,0,0,0,"DE",0.038
"7582",464,"198202.387.1360.8","NMFS",1982,5,2,122,30,42.833333,-67.383333,1,0,1,1,0,"DE",0.038
"7583",465,"198202.388.1360.3","NMFS",1982,5,2,122,30,43.233333,-67.566667,0,0,0,0,0,"DE",0.038
"7584",465,"198202.389.1360.2","NMFS",1982,5,3,123,30,43.266667,-67.433333,0,0,0,0,0,"DE",0.038
"7585",465,"198202.390.1360.6","NMFS",1982,5,3,123,30,43.3,-67,0,0,0,0,0,"DE",0.038
"7586",465,"198202.391.1340.2","NMFS",1982,5,3,123,30,43.033333,-66.916667,0,0,0,0,0,"DE",0.038
"7587",464,"198202.392.1360.5","NMFS",1982,5,3,123,30,42.9,-66.833333,0,0,0,0,0,"DE",0.038
"7588",465,"198202.393.1310.6","NMFS",1982,5,3,123,22,43,-66.5,1,0,1,1,0,"DE",0.038
"7589",465,"198202.395.1330.3","NMFS",1982,5,3,123,30,43.466667,-66.533333,0,0,0,0,0,"DE",0.038
"7590",465,"198202.396.1340.5","NMFS",1982,5,3,123,30,43.7,-66.866667,0,0,0,0,0,"DE",0.038
"7591",511,"198202.397.1340.6","NMFS",1982,5,4,124,30,43.883333,-67.066667,0,0,0,0,0,"DE",0.038
"7592",511,"198202.398.1340.3","NMFS",1982,5,4,124,30,44,-66.983333,0,0,0,0,0,"DE",0.038
"7593",465,"198202.399.1340.4","NMFS",1982,5,4,124,30,43.883333,-66.833333,0,0,0,0,0,"DE",0.038
"7594",465,"198202.400.1330.2","NMFS",1982,5,4,124,20,43.75,-66.55,0,0,0,0,0,"DE",0.038
"7595",466,"198202.401.1330.4","NMFS",1982,5,4,124,30,44.05,-66.416667,1,1,0,1,0,"DE",0.038
"7596",466,"198202.402.1330.1","NMFS",1982,5,4,124,30,44.183333,-66.55,0,0,0,0,0,"DE",0.038
"7597",466,"198202.403.1350.4","NMFS",1982,5,4,124,30,44.333333,-66.533333,0,0,0,0,0,"DE",0.038
"7598",466,"198202.404.1350.2","NMFS",1982,5,4,124,30,44.466667,-66.233333,0,0,0,0,0,"DE",0.038
"7599",511,"198202.405.1350.3","NMFS",1982,5,4,124,30,44.35,-67.083333,0,0,0,0,0,"DE",0.038
"7600",511,"198202.406.1350.1","NMFS",1982,5,4,124,30,44.3,-67.15,1,1,0,1,0,"DE",0.038
"7601",511,"198202.407.1360.1","NMFS",1982,5,4,124,30,44.233333,-67.383333,0,0,0,0,0,"DE",0.038
"7602",511,"198202.408.1390.2","NMFS",1982,5,5,125,30,44.4,-67.5,7,5,2,7,0,"DE",0.038
"7603",512,"198202.409.1390.4","NMFS",1982,5,5,125,30,44.2,-67.95,4,3,1,3,1,"DE",0.038
"7604",512,"198202.410.1390.1","NMFS",1982,5,5,125,30,43.983333,-68.433333,3,0,3,3,0,"DE",0.038
"7605",512,"198202.411.1380.3","NMFS",1982,5,5,125,30,43.833333,-68.483333,0,0,0,0,0,"DE",0.038
"7606",512,"198202.412.1380.1","NMFS",1982,5,5,125,30,43.666667,-68.316667,0,0,0,0,0,"DE",0.038
"7607",512,"198202.413.1360.4","NMFS",1982,5,5,125,30,43.533333,-67.983333,1,1,0,1,0,"DE",0.038
"7608",512,"198202.414.1360.7","NMFS",1982,5,5,125,30,43.416667,-68.1,0,0,0,0,0,"DE",0.038
"7609",515,"198202.415.1380.5","NMFS",1982,5,5,125,30,43.316667,-68.633333,0,0,0,0,0,"DE",0.038
"7610",512,"198202.416.1380.4","NMFS",1982,5,5,125,30,43.433333,-68.833333,1,1,0,1,0,"DE",0.038
"7611",513,"198202.418.1380.2","NMFS",1982,5,6,126,30,43.583333,-69.4,0,0,0,0,0,"DE",0.038
"7612",513,"198202.419.1400.1","NMFS",1982,5,6,126,20,43.516667,-69.633333,0,0,0,0,0,"DE",0.038
"7613",513,"198202.420.1370.1","NMFS",1982,5,6,126,30,43.2,-69.85,0,0,0,0,0,"DE",0.038
"7614",513,"198202.421.1270.2","NMFS",1982,5,6,126,30,43.05,-70,1,1,0,1,0,"DE",0.038
"7615",513,"198202.422.1280.2","NMFS",1982,5,6,126,30,42.866667,-69.783333,0,0,0,0,0,"DE",0.038
"7616",514,"198202.423.1260.4","NMFS",1982,5,6,126,30,42.7,-70.183333,0,0,0,0,0,"DE",0.038
"7617",513,"198202.424.1270.3","NMFS",1982,5,6,126,30,42.966667,-70.233333,0,0,0,0,0,"DE",0.038
"7618",513,"198202.425.1270.1","NMFS",1982,5,6,126,30,43.083333,-70.333333,1,1,0,1,0,"DE",0.038
"7619",513,"198202.426.1400.2","NMFS",1982,5,6,126,30,43,-70.466667,4,1,3,4,0,"DE",0.038
"7620",513,"198202.427.3640.1","NMFS",1982,5,7,127,30,42.85,-70.766667,4,1,3,4,0,"DE",0.038
"7621",514,"198202.428.1400.3","NMFS",1982,5,7,127,30,42.816667,-70.6,0,0,0,0,0,"DE",0.038
"7622",514,"198202.429.1260.7","NMFS",1982,5,7,127,30,42.716667,-70.5,1,1,0,1,0,"DE",0.038
"7623",514,"198202.430.1260.1","NMFS",1982,5,7,127,23,42.466667,-70.283333,0,0,0,0,0,"DE",0.038
"7624",514,"198202.432.1260.2","NMFS",1982,5,7,127,30,42.416667,-70.283333,0,0,0,0,0,"DE",0.038
"7625",514,"198202.433.1260.3","NMFS",1982,5,7,127,30,42.35,-70.25,1,1,0,1,0,"DE",0.038
"7626",514,"198202.434.1260.5","NMFS",1982,5,7,127,30,42.333333,-70.316667,0,0,0,0,0,"DE",0.038
"7627",514,"198202.435.3640.2","NMFS",1982,5,7,127,20,42.383333,-70.816667,1,0,1,1,0,"DE",0.038
"7628",514,"198202.436.3650.1","NMFS",1982,5,7,127,20,42.316667,-70.733333,6,4,2,6,0,"DE",0.038
"7629",514,"198202.437.1260.8","NMFS",1982,5,7,127,30,42.216667,-70.483333,1,1,0,1,0,"DE",0.038
"7630",514,"198202.438.3610.1","NMFS",1982,5,7,127,30,42.15,-70.5,0,0,0,0,0,"DE",0.038
"7631",514,"198202.439.3590.1","NMFS",1982,5,7,127,30,42.1,-70.566667,6,2,4,6,0,"DE",0.038
"7632",514,"198202.440.3600.2","NMFS",1982,5,8,128,30,41.966667,-70.483333,3,1,2,3,0,"DE",0.038
"7633",514,"198202.441.3610.2","NMFS",1982,5,8,128,30,42.016667,-70.25,1,0,1,1,0,"DE",0.038
"7634",514,"198202.442.3600.1","NMFS",1982,5,8,128,30,41.983333,-70.283333,2,1,1,2,0,"DE",0.038
"7635",514,"198202.443.3580.1","NMFS",1982,5,8,128,30,41.833333,-70.216667,2,2,0,2,0,"DE",0.038
"7636",526,"198206.248.1120.2","NMFS",1982,10,12,285,30,39.933333,-69.9,0,0,0,0,0,"AL",0.038
"7637",526,"198206.249.1110.1","NMFS",1982,10,13,286,30,40.05,-69.766667,2,1,1,2,0,"AL",0.038
"7638",526,"198206.250.1100.6","NMFS",1982,10,13,286,30,40.15,-69.7,0,0,0,0,0,"AL",0.038
"7639",526,"198206.251.1100.3","NMFS",1982,10,13,286,30,40.183333,-69.366667,1,1,0,1,0,"AL",0.038
"7640",526,"198206.252.1120.1","NMFS",1982,10,13,286,30,40.133333,-69.066667,4,2,2,3,1,"AL",0.038
"7641",526,"198206.253.1100.4","NMFS",1982,10,13,286,25,40.266667,-69.216667,5,3,2,5,0,"AL",0.038
"7642",526,"198206.254.1100.2","NMFS",1982,10,13,286,30,40.366667,-69.366667,8,4,4,7,1,"AL",0.038
"7643",526,"198206.255.1100.5","NMFS",1982,10,13,286,30,40.433333,-69.15,0,0,0,0,0,"AL",0.038
"7644",526,"198206.256.1100.8","NMFS",1982,10,13,286,30,40.466667,-68.983333,1,0,1,1,0,"AL",0.038
"7645",526,"198206.257.1090.2","NMFS",1982,10,13,286,30,40.7,-69.45,0,0,0,0,0,"AL",0.038
"7646",526,"198206.258.1090.3","NMFS",1982,10,13,286,30,40.766667,-69.716667,0,0,0,0,0,"AL",0.038
"7647",526,"198206.259.3550.3","NMFS",1982,10,14,287,30,40.933333,-69.583333,0,0,0,0,0,"AL",0.038
"7648",526,"198206.261.1100.7","NMFS",1982,10,14,287,30,40.816667,-69.05,1,0,1,1,0,"AL",0.038
"7649",521,"198206.262.1230.2","NMFS",1982,10,14,287,30,41.1,-68.95,0,0,0,0,0,"AL",0.038
"7650",521,"198206.263.1240.4","NMFS",1982,10,14,287,30,41.333333,-68.9,0,0,0,0,0,"AL",0.038
"7651",521,"198206.264.1240.5","NMFS",1982,10,14,287,30,41.366667,-69.1,0,0,0,0,0,"AL",0.038
"7652",521,"198206.265.1240.2","NMFS",1982,10,19,292,30,41.7,-69.166667,0,0,0,0,0,"AL",0.038
"7653",522,"198206.266.1230.4","NMFS",1982,10,19,292,30,41.433333,-68.65,0,0,0,0,0,"AL",0.038
"7654",522,"198206.267.1230.3","NMFS",1982,10,19,292,30,41.333333,-68.533333,3,1,2,3,0,"AL",0.038
"7655",522,"198206.268.1200.2","NMFS",1982,10,19,292,30,41.3,-68.45,7,6,1,7,0,"AL",0.038
"7656",522,"198206.269.1230.1","NMFS",1982,10,19,292,30,41.25,-68.55,0,0,0,0,0,"AL",0.038
"7657",522,"198206.270.1190.6","NMFS",1982,10,19,292,30,41.05,-68.366667,0,0,0,0,0,"AL",0.038
"7658",525,"198206.271.1190.9","NMFS",1982,10,19,292,30,40.95,-68.533333,6,5,1,6,0,"AL",0.038
"7659",525,"198206.272.1190.8","NMFS",1982,10,19,292,30,40.816667,-68.433333,5,3,2,5,0,"AL",0.038
"7660",525,"198206.273.1190.3","NMFS",1982,10,19,292,30,40.75,-68.566667,1,0,1,1,0,"AL",0.038
"7661",525,"198206.274.1130.6","NMFS",1982,10,19,292,30,40.55,-68.666667,1,1,0,1,0,"AL",0.038
"7662",525,"198206.275.1130.3","NMFS",1982,10,20,293,30,40.433333,-68.466667,0,0,0,0,0,"AL",0.038
"7663",525,"198206.276.1140.3","NMFS",1982,10,20,293,30,40.25,-68.4,0,0,0,0,0,"AL",0.038
"7664",525,"198206.277.1150.3","NMFS",1982,10,20,293,30,40.183333,-68.3,0,0,0,0,0,"AL",0.038
"7665",525,"198206.278.1130.1","NMFS",1982,10,20,293,30,40.533333,-68.316667,2,0,2,1,1,"AL",0.038
"7666",525,"198206.279.1140.2","NMFS",1982,10,20,293,30,40.433333,-68.016667,0,0,0,0,0,"AL",0.038
"7667",525,"198206.280.1140.1","NMFS",1982,10,20,293,30,40.45,-67.883333,0,0,0,0,0,"AL",0.038
"7668",525,"198206.281.1150.1","NMFS",1982,10,20,293,30,40.483333,-67.666667,2,1,1,2,0,"AL",0.038
"7669",525,"198206.282.1130.7","NMFS",1982,10,20,293,30,40.566667,-67.833333,0,0,0,0,0,"AL",0.038
"7670",525,"198206.283.1130.2","NMFS",1982,10,20,293,30,40.766667,-68.083333,0,0,0,0,0,"AL",0.038
"7671",525,"198206.284.1130.8","NMFS",1982,10,21,294,30,40.816667,-68.033333,0,0,0,0,0,"AL",0.038
"7672",525,"198206.285.1190.4","NMFS",1982,10,21,294,30,40.966667,-68.133333,1,1,0,1,0,"AL",0.038
"7673",525,"198206.286.1190.5","NMFS",1982,10,21,294,30,41.05,-67.85,0,0,0,0,0,"AL",0.038
"7674",525,"198206.287.1130.4","NMFS",1982,10,21,294,30,40.9,-67.733333,2,1,1,2,0,"AL",0.038
"7675",525,"198206.288.1130.5","NMFS",1982,10,21,294,30,41,-67.45,2,1,1,2,0,"AL",0.038
"7676",562,"198206.289.1150.2","NMFS",1982,10,21,294,30,40.683333,-66.833333,0,0,0,0,0,"AL",0.038
"7677",562,"198206.290.1160.2","NMFS",1982,10,21,294,30,40.983333,-66.766667,0,0,0,0,0,"AL",0.038
"7678",562,"198206.291.1160.6","NMFS",1982,10,21,294,30,41.066667,-66.933333,0,0,0,0,0,"AL",0.038
"7679",562,"198206.292.1190.2","NMFS",1982,10,22,295,30,41.35,-67.433333,0,0,0,0,0,"AL",0.038
"7680",522,"198206.293.1190.7","NMFS",1982,10,22,295,30,41.45,-67.75,0,0,0,0,0,"AL",0.038
"7681",522,"198206.294.1200.5","NMFS",1982,10,22,295,30,41.533333,-67.966667,1,1,0,1,0,"AL",0.038
"7682",522,"198206.295.1200.4","NMFS",1982,10,22,295,30,41.7,-67.883333,2,1,1,2,0,"AL",0.038
"7683",522,"198206.296.1200.1","NMFS",1982,10,22,295,30,41.7,-68.15,1,1,0,1,0,"AL",0.038
"7684",522,"198206.297.1230.5","NMFS",1982,10,22,295,30,41.633333,-68.433333,0,0,0,0,0,"AL",0.038
"7685",522,"198206.298.1210.4","NMFS",1982,10,22,295,30,41.75,-68.166667,2,1,1,2,0,"AL",0.038
"7686",522,"198206.299.1210.3","NMFS",1982,10,22,295,30,41.95,-67.866667,0,0,0,0,0,"AL",0.038
"7687",522,"198206.300.1220.1","NMFS",1982,10,22,295,30,41.983333,-67.95,0,0,0,0,0,"AL",0.038
"7688",522,"198206.301.1290.1","NMFS",1982,10,22,295,30,42.116667,-67.983333,0,0,0,0,0,"AL",0.038
"7689",561,"198206.302.1220.2","NMFS",1982,10,22,295,30,42.083333,-67.65,0,0,0,0,0,"AL",0.038
"7690",561,"198206.303.1200.3","NMFS",1982,10,23,296,30,41.983333,-67.6,7,3,4,6,1,"AL",0.038
"7691",561,"198206.304.1200.6","NMFS",1982,10,23,296,30,42.016667,-67.316667,1,1,0,1,0,"AL",0.038
"7692",551,"198206.305.1220.4","NMFS",1982,10,23,296,30,42.2,-67.1,0,0,0,0,0,"AL",0.038
"7693",551,"198206.306.1210.1","NMFS",1982,10,23,296,30,42.133333,-67.05,0,0,0,0,0,"AL",0.038
"7694",551,"198206.307.1290.2","NMFS",1982,10,23,296,30,42.283333,-66.783333,0,0,0,0,0,"AL",0.038
"7695",464,"198206.308.1300.1","NMFS",1982,10,23,296,30,42.383333,-66.666667,0,0,0,0,0,"AL",0.038
"7696",464,"198206.309.1300.3","NMFS",1982,10,23,296,30,42.366667,-66.6,0,0,0,0,0,"AL",0.038
"7697",551,"198206.310.1160.7","NMFS",1982,10,23,296,30,41.9,-66.85,6,2,4,6,0,"AL",0.038
"7698",562,"198206.311.1190.1","NMFS",1982,10,23,296,30,41.716667,-67.1,7,5,2,7,0,"AL",0.038
"7699",562,"198206.312.1160.9","NMFS",1982,10,23,296,30,41.566667,-66.966667,2,1,1,2,0,"AL",0.038
"7700",562,"198206.313.1160.8","NMFS",1982,10,23,296,30,41.716667,-66.783333,3,2,1,3,0,"AL",0.038
"7701",552,"198206.314.1160.5","NMFS",1982,10,24,297,30,41.733333,-66.433333,2,1,1,2,0,"AL",0.038
"7702",552,"198206.315.1160.4","NMFS",1982,10,24,297,30,41.633333,-66.283333,0,0,0,0,0,"AL",0.038
"7703",552,"198206.316.1160.1","NMFS",1982,10,24,297,30,41.45,-66.233333,1,1,0,1,0,"AL",0.038
"7704",552,"198206.317.1170.3","NMFS",1982,10,24,297,30,41.333333,-66.25,0,0,0,0,0,"AL",0.038
"7705",552,"198206.319.1180.2","NMFS",1982,10,24,297,30,41.366667,-66.066667,0,0,0,0,0,"AL",0.038
"7706",552,"198206.320.1160.3","NMFS",1982,10,24,297,30,41.7,-65.983333,0,0,0,0,0,"AL",0.038
"7707",551,"198206.321.1170.2","NMFS",1982,10,24,297,30,41.883333,-65.866667,0,0,0,0,0,"AL",0.038
"7708",551,"198206.322.1170.1","NMFS",1982,10,24,297,30,41.983333,-65.9,0,0,0,0,0,"AL",0.038
"7709",551,"198206.323.1160.10","NMFS",1982,10,24,297,30,41.95,-65.95,0,0,0,0,0,"AL",0.038
"7710",551,"198206.324.1220.3","NMFS",1982,10,25,298,30,42.1,-66.033333,0,0,0,0,0,"AL",0.038
"7711",551,"198206.325.1210.2","NMFS",1982,10,25,298,30,42.1,-66.15,0,0,0,0,0,"AL",0.038
"7712",464,"198206.326.1290.5","NMFS",1982,10,25,298,30,42.383333,-65.85,1,0,1,1,0,"AL",0.038
"7713",464,"198206.331.1320.1","NMFS",1982,10,25,298,30,42.566667,-65.566667,0,0,0,0,0,"AL",0.038
"7714",464,"198206.332.1320.5","NMFS",1982,10,25,298,30,42.583333,-65.7,0,0,0,0,0,"AL",0.038
"7715",464,"198206.333.1310.1","NMFS",1982,10,25,298,30,42.7,-65.783333,0,0,0,0,0,"AL",0.038
"7716",464,"198206.334.1310.4","NMFS",1982,10,25,298,30,42.566667,-66.033333,0,0,0,0,0,"AL",0.038
"7717",464,"198206.335.1320.2","NMFS",1982,10,25,298,30,42.616667,-66.016667,0,0,0,0,0,"AL",0.038
"7718",465,"198206.336.1330.3","NMFS",1982,10,26,299,30,43.366667,-66.533333,0,0,0,0,0,"AL",0.038
"7719",465,"198206.337.1330.1","NMFS",1982,10,26,299,30,43.7,-66.516667,0,0,0,0,0,"AL",0.038
"7720",465,"198206.339.1340.3","NMFS",1982,10,26,299,30,43.816667,-67.066667,0,0,0,0,0,"AL",0.038
"7721",465,"198206.340.1340.6","NMFS",1982,10,26,299,30,43.666667,-66.9,0,0,0,0,0,"AL",0.038
"7722",465,"198206.341.1360.2","NMFS",1982,10,26,299,30,43.433333,-66.933333,0,0,0,0,0,"AL",0.038
"7723",465,"198206.342.1340.1","NMFS",1982,10,27,300,30,43.416667,-66.9,0,0,0,0,0,"AL",0.038
"7724",465,"198206.343.1340.2","NMFS",1982,10,27,300,30,43.1,-66.9,0,0,0,0,0,"AL",0.038
"7725",464,"198206.344.1340.5","NMFS",1982,10,27,300,30,42.983333,-67.033333,0,0,0,0,0,"AL",0.038
"7726",464,"198206.345.1360.8","NMFS",1982,10,27,300,30,42.866667,-66.816667,0,0,0,0,0,"AL",0.038
"7727",464,"198206.346.1360.6","NMFS",1982,10,27,300,30,42.833333,-66.733333,1,0,1,1,0,"AL",0.038
"7728",464,"198206.347.1310.2","NMFS",1982,10,27,300,20,42.916667,-66.516667,0,0,0,0,0,"AL",0.038
"7729",464,"198206.348.1320.4","NMFS",1982,10,27,300,30,42.766667,-66.3,1,1,0,1,0,"AL",0.038
"7730",464,"198206.349.1310.7","NMFS",1982,10,27,300,30,42.733333,-66.416667,2,2,0,2,0,"AL",0.038
"7731",464,"198206.350.1290.6","NMFS",1982,10,27,300,30,42.7,-67.183333,0,0,0,0,0,"AL",0.038
"7732",464,"198206.351.1290.7","NMFS",1982,10,27,300,30,42.633333,-67.4,0,0,0,0,0,"AL",0.038
"7733",464,"198206.352.1300.2","NMFS",1982,10,28,301,30,42.416667,-67.5,0,0,0,0,0,"AL",0.038
"7734",522,"198206.353.1290.8","NMFS",1982,10,28,301,30,42.316667,-68.066667,0,0,0,0,0,"AL",0.038
"7735",522,"198206.354.1290.3","NMFS",1982,10,28,301,30,42.266667,-68.3,0,0,0,0,0,"AL",0.038
"7736",522,"198206.355.1240.3","NMFS",1982,10,28,301,30,42.05,-68.816667,0,0,0,0,0,"AL",0.038
"7737",521,"198206.356.1240.1","NMFS",1982,10,28,301,30,42.066667,-68.95,0,0,0,0,0,"AL",0.038
"7738",521,"198206.357.1240.6","NMFS",1982,10,28,301,30,41.85,-69.1,0,0,0,0,0,"AL",0.038
"7739",521,"198206.358.1250.4","NMFS",1982,10,28,301,30,41.45,-69.416667,3,2,1,3,0,"AL",0.038
"7740",521,"198206.359.1250.1","NMFS",1982,10,28,301,30,41.383333,-69.45,5,4,1,4,1,"AL",0.038
"7741",521,"198206.360.1250.3","NMFS",1982,10,28,301,30,41,-69.25,1,1,0,1,0,"AL",0.038
"7742",521,"198206.361.1250.2","NMFS",1982,10,28,301,27,41.133333,-69.216667,1,0,1,1,0,"AL",0.038
"7743",521,"198206.362.3550.1","NMFS",1982,10,28,301,30,41.333333,-69.516667,4,1,3,4,0,"AL",0.038
"7744",521,"198206.363.1280.4","NMFS",1982,11,2,306,30,42.266667,-69.533333,0,0,0,0,0,"AL",0.038
"7745",521,"198206.364.1240.7","NMFS",1982,11,2,306,30,42.133333,-69.15,0,0,0,0,0,"AL",0.038
"7746",521,"198206.365.1240.8","NMFS",1982,11,2,306,30,42.2,-69.066667,0,0,0,0,0,"AL",0.038
"7747",515,"198206.366.1280.5","NMFS",1982,11,2,306,30,42.433333,-68.9,0,0,0,0,0,"AL",0.038
"7748",515,"198206.367.1280.2","NMFS",1982,11,2,306,30,42.4,-68.616667,0,0,0,0,0,"AL",0.038
"7749",515,"198206.369.1290.4","NMFS",1982,11,3,307,30,42.733333,-67.75,0,0,0,0,0,"AL",0.038
"7750",464,"198206.370.1360.4","NMFS",1982,11,3,307,30,42.783333,-67.633333,0,0,0,0,0,"AL",0.038
"7751",515,"198206.371.1360.5","NMFS",1982,11,3,307,30,43.033333,-68.166667,0,0,0,0,0,"AL",0.038
"7752",515,"198206.372.1360.3","NMFS",1982,11,3,307,30,43.166667,-67.783333,0,0,0,0,0,"AL",0.038
"7753",465,"198206.373.1360.1","NMFS",1982,11,3,307,30,43.166667,-67.6,0,0,0,0,0,"AL",0.038
"7754",512,"198206.374.1360.7","NMFS",1982,11,3,307,30,43.55,-67.716667,0,0,0,0,0,"AL",0.038
"7755",465,"198206.375.1360.9","NMFS",1982,11,3,307,30,43.716667,-67.433333,0,0,0,0,0,"AL",0.038
"7756",511,"198206.376.1340.4","NMFS",1982,11,3,307,30,44.066667,-67.183333,0,0,0,0,0,"AL",0.038
"7757",511,"198206.377.1350.1","NMFS",1982,11,4,308,30,44.2,-67.116667,0,0,0,0,0,"AL",0.038
"7758",466,"198206.378.1330.4","NMFS",1982,11,4,308,30,44.166667,-66.7,0,0,0,0,0,"AL",0.038
"7759",466,"198206.379.1350.3","NMFS",1982,11,4,308,30,44.4,-66.516667,0,0,0,0,0,"AL",0.038
"7760",466,"198206.380.1350.2","NMFS",1982,11,4,308,30,44.666667,-66.2,0,0,0,0,0,"AL",0.038
"7761",467,"198206.381.1350.4","NMFS",1982,11,4,308,30,44.783333,-66.466667,0,0,0,0,0,"AL",0.038
"7762",511,"198206.384.1390.1","NMFS",1982,11,4,308,30,44.266667,-67.816667,1,1,0,1,0,"AL",0.038
"7763",512,"198206.385.1390.3","NMFS",1982,11,5,309,30,44.233333,-67.966667,9,7,2,8,1,"AL",0.038
"7764",512,"198206.386.1390.2","NMFS",1982,11,5,309,30,44.016667,-68.216667,1,0,1,1,0,"AL",0.038
"7765",512,"198206.387.1390.5","NMFS",1982,11,5,309,30,43.85,-68.433333,0,0,0,0,0,"AL",0.038
"7766",512,"198206.388.1380.5","NMFS",1982,11,5,309,30,43.783333,-68.2,0,0,0,0,0,"AL",0.038
"7767",512,"198206.389.1380.4","NMFS",1982,11,5,309,30,43.6,-68.366667,0,0,0,0,0,"AL",0.038
"7768",512,"198206.390.1380.2","NMFS",1982,11,5,309,30,43.55,-68.883333,0,0,0,0,0,"AL",0.038
"7769",512,"198206.391.1390.4","NMFS",1982,11,5,309,25,43.7,-69.033333,2,2,0,2,0,"AL",0.038
"7770",513,"198206.392.1400.3","NMFS",1982,11,6,310,30,43.666667,-69.55,0,0,0,0,0,"AL",0.038
"7771",513,"198206.393.1380.1","NMFS",1982,11,6,310,30,43.5,-69.75,0,0,0,0,0,"AL",0.038
"7772",513,"198206.394.1400.2","NMFS",1982,11,6,310,28,43.55,-69.933333,0,0,0,0,0,"AL",0.038
"7773",513,"198206.395.1270.2","NMFS",1982,11,6,310,30,43.216667,-70.183333,1,0,1,1,0,"AL",0.038
"7774",513,"198206.396.1270.1","NMFS",1982,11,6,310,30,43.066667,-70.133333,0,0,0,0,0,"AL",0.038
"7775",513,"198206.397.1270.3","NMFS",1982,11,6,310,30,43.066667,-70.283333,0,0,0,0,0,"AL",0.038
"7776",513,"198206.398.1400.1","NMFS",1982,11,6,310,30,42.883333,-70.6,2,2,0,2,0,"AL",0.038
"7777",514,"198206.399.3640.1","NMFS",1982,11,6,310,30,42.733333,-70.716667,8,3,5,7,1,"AL",0.038
"7778",514,"198206.401.1260.3","NMFS",1982,11,7,311,30,42.416667,-70.35,0,0,0,0,0,"AL",0.038
"7779",514,"198206.402.1260.1","NMFS",1982,11,7,311,30,42.583333,-70.116667,0,0,0,0,0,"AL",0.038
"7780",514,"198206.403.1270.4","NMFS",1982,11,7,311,30,42.65,-70.066667,0,0,0,0,0,"AL",0.038
"7781",514,"198206.404.1280.3","NMFS",1982,11,7,311,30,42.716667,-69.9,0,0,0,0,0,"AL",0.038
"7782",514,"198206.405.1280.1","NMFS",1982,11,7,311,30,42.816667,-69.816667,0,0,0,0,0,"AL",0.038
"7783",513,"198206.406.1380.3","NMFS",1982,11,7,311,30,43.25,-69.483333,0,0,0,0,0,"AL",0.038
"7784",513,"198206.407.1370.4","NMFS",1982,11,7,311,30,43.25,-69.283333,0,0,0,0,0,"AL",0.038
"7785",515,"198206.408.1370.5","NMFS",1982,11,7,311,30,43.15,-68.816667,0,0,0,0,0,"AL",0.038
"7786",515,"198206.409.1370.3","NMFS",1982,11,7,311,30,43.1,-68.95,0,0,0,0,0,"AL",0.038
"7787",515,"198206.410.1370.2","NMFS",1982,11,7,311,30,42.816667,-68.766667,0,0,0,0,0,"AL",0.038
"7788",515,"198206.411.1370.1","NMFS",1982,11,8,312,30,42.7,-68.933333,0,0,0,0,0,"AL",0.038
"7789",515,"198206.412.1280.7","NMFS",1982,11,8,312,30,42.633333,-69.35,0,0,0,0,0,"AL",0.038
"7790",515,"198206.413.1280.6","NMFS",1982,11,8,312,30,42.65,-69.55,0,0,0,0,0,"AL",0.038
"7791",514,"198206.414.1260.2","NMFS",1982,11,8,312,30,42.35,-70.166667,0,0,0,0,0,"AL",0.038
"7792",514,"198206.415.1260.4","NMFS",1982,11,8,312,30,42.283333,-70.283333,0,0,0,0,0,"AL",0.038
"7793",514,"198206.417.3650.1","NMFS",1982,11,8,312,30,42.2,-70.55,13,4,9,13,0,"AL",0.038
"7794",514,"198206.418.3610.2","NMFS",1982,11,9,313,30,42.05,-70.5,51,29,22,44,7,"AL",0.038
"7795",514,"198206.419.3600.2","NMFS",1982,11,9,313,30,41.883333,-70.416667,27,22,5,17,10,"AL",0.038
"7796",514,"198206.420.3580.1","NMFS",1982,11,9,313,30,41.85,-70.2,1,1,0,1,0,"AL",0.038
"7797",514,"198206.421.3590.1","NMFS",1982,11,9,313,30,41.933333,-70.133333,2,0,2,2,0,"AL",0.038
"7798",514,"198206.422.3600.1","NMFS",1982,11,9,313,30,41.966667,-70.166667,0,0,0,0,0,"AL",0.038
"7799",514,"198206.423.3610.1","NMFS",1982,11,9,313,30,42.016667,-70.3,0,0,0,0,0,"AL",0.038
"7800",521,"198206.424.1260.5","NMFS",1982,11,9,313,30,42.033333,-69.9,0,0,0,0,0,"AL",0.038
"7801",526,"198303.240.1100.7","NMFS",1983,4,4,94,30,40.233333,-69.85,0,0,0,0,0,"AL",0.038
"7802",526,"198303.241.1110.1","NMFS",1983,4,4,94,30,39.983333,-69.766667,0,0,0,0,0,"AL",0.038
"7803",526,"198303.242.1120.3","NMFS",1983,4,4,94,30,39.916667,-69.783333,1,0,1,1,0,"AL",0.038
"7804",526,"198303.243.1110.3","NMFS",1983,4,5,95,30,40.05,-69.233333,0,0,0,0,0,"AL",0.038
"7805",526,"198303.244.1100.5","NMFS",1983,4,5,95,30,40.316667,-69.35,6,3,3,6,0,"AL",0.038
"7806",526,"198303.245.1100.2","NMFS",1983,4,5,95,30,40.366667,-69.116667,1,0,1,1,0,"AL",0.038
"7807",525,"198303.246.1130.6","NMFS",1983,4,5,95,30,40.333333,-68.8,0,0,0,0,0,"AL",0.038
"7808",526,"198303.247.1120.2","NMFS",1983,4,5,95,30,40.083333,-68.866667,0,0,0,0,0,"AL",0.038
"7809",525,"198303.248.1150.2","NMFS",1983,4,5,95,30,40.1,-68.683333,0,0,0,0,0,"AL",0.038
"7810",525,"198303.249.1140.3","NMFS",1983,4,5,95,30,40.15,-68.683333,1,0,1,1,0,"AL",0.038
"7811",525,"198303.250.1130.2","NMFS",1983,4,5,95,30,40.4,-68.533333,0,0,0,0,0,"AL",0.038
"7812",525,"198303.251.1140.1","NMFS",1983,4,5,95,30,40.333333,-68.416667,0,0,0,0,0,"AL",0.038
"7813",525,"198303.252.1130.4","NMFS",1983,4,5,95,30,40.566667,-68.133333,0,0,0,0,0,"AL",0.038
"7814",525,"198303.253.1150.1","NMFS",1983,4,6,96,30,40.35,-67.766667,0,0,0,0,0,"AL",0.038
"7815",525,"198303.254.1140.4","NMFS",1983,4,6,96,30,40.516667,-67.5,0,0,0,0,0,"AL",0.038
"7816",525,"198303.255.1130.7","NMFS",1983,4,6,96,30,40.7,-67.75,0,0,0,0,0,"AL",0.038
"7817",525,"198303.256.1130.3","NMFS",1983,4,6,96,30,40.9,-67.8,0,0,0,0,0,"AL",0.038
"7818",525,"198303.257.1130.8","NMFS",1983,4,6,96,30,40.733333,-68.083333,0,0,0,0,0,"AL",0.038
"7819",525,"198303.258.1130.9","NMFS",1983,4,6,96,30,40.783333,-68.133333,0,0,0,0,0,"AL",0.038
"7820",525,"198303.259.1130.5","NMFS",1983,4,6,96,30,40.716667,-68.4,0,0,0,0,0,"AL",0.038
"7821",525,"198303.260.1190.2","NMFS",1983,4,6,96,30,40.883333,-68.583333,0,0,0,0,0,"AL",0.038
"7822",525,"198303.261.1190.9","NMFS",1983,4,6,96,30,40.8,-68.633333,1,1,0,1,0,"AL",0.038
"7823",525,"198303.262.1130.1","NMFS",1983,4,6,96,30,40.566667,-68.833333,0,0,0,0,0,"AL",0.038
"7824",526,"198303.263.1100.4","NMFS",1983,4,6,96,30,40.6,-68.9,0,0,0,0,0,"AL",0.038
"7825",526,"198303.264.1100.6","NMFS",1983,4,7,97,30,40.583333,-69.516667,0,0,0,0,0,"AL",0.038
"7826",526,"198303.265.1090.2","NMFS",1983,4,7,97,30,40.716667,-69.466667,0,0,0,0,0,"AL",0.038
"7827",526,"198303.266.1090.3","NMFS",1983,4,7,97,30,40.933333,-69.7,0,0,0,0,0,"AL",0.038
"7828",526,"198303.267.3550.3","NMFS",1983,4,7,97,30,40.95,-69.766667,0,0,0,0,0,"AL",0.038
"7829",526,"198303.268.3550.4","NMFS",1983,4,7,97,30,40.983333,-69.616667,0,0,0,0,0,"AL",0.038
"7830",526,"198303.269.3550.1","NMFS",1983,4,7,97,30,40.916667,-69.533333,0,0,0,0,0,"AL",0.038
"7831",526,"198303.270.1090.4","NMFS",1983,4,7,97,30,40.95,-69.283333,0,0,0,0,0,"AL",0.038
"7832",521,"198303.271.1250.4","NMFS",1983,4,7,97,30,41.083333,-69.266667,1,0,1,0,1,"AL",0.038
"7833",521,"198303.272.1250.3","NMFS",1983,4,7,97,30,41.166667,-69.283333,0,0,0,0,0,"AL",0.038
"7834",521,"198303.273.3550.2","NMFS",1983,4,7,97,30,41.333333,-69.566667,0,0,0,0,0,"AL",0.038
"7835",521,"198303.274.3560.1","NMFS",1983,4,7,97,30,41.683333,-69.866667,0,0,0,0,0,"AL",0.038
"7836",521,"198303.275.1250.2","NMFS",1983,4,7,97,30,41.766667,-69.85,1,1,0,1,0,"AL",0.038
"7837",521,"198303.276.1230.4","NMFS",1983,4,7,97,30,41.666667,-69.583333,0,0,0,0,0,"AL",0.038
"7838",521,"198303.277.1230.2","NMFS",1983,4,7,97,30,41.583333,-69.466667,1,1,0,1,0,"AL",0.038
"7839",521,"198303.278.1240.3","NMFS",1983,4,12,102,30,41.883333,-69.683333,0,0,0,0,0,"AL",0.038
"7840",521,"198303.281.1280.1","NMFS",1983,4,12,102,30,42,-69.383333,0,0,0,0,0,"AL",0.038
"7841",521,"198303.282.1240.6","NMFS",1983,4,12,102,30,41.783333,-69.133333,1,1,0,1,0,"AL",0.038
"7842",521,"198303.283.1240.1","NMFS",1983,4,12,102,30,41.65,-69.15,0,0,0,0,0,"AL",0.038
"7843",522,"198303.285.1200.2","NMFS",1983,4,12,102,30,41.55,-68.416667,0,0,0,0,0,"AL",0.038
"7844",522,"198303.286.1200.3","NMFS",1983,4,12,102,30,41.6,-68.25,0,0,0,0,0,"AL",0.038
"7845",522,"198303.287.1200.6","NMFS",1983,4,13,103,30,41.433333,-68.216667,0,0,0,0,0,"AL",0.038
"7846",522,"198303.288.1200.4","NMFS",1983,4,13,103,30,41.233333,-68.35,0,0,0,0,0,"AL",0.038
"7847",522,"198303.289.1230.5","NMFS",1983,4,13,103,30,41.25,-68.8,1,0,1,1,0,"AL",0.038
"7848",522,"198303.290.1230.1","NMFS",1983,4,13,103,30,41.033333,-68.716667,0,0,0,0,0,"AL",0.038
"7849",522,"198303.291.1230.3","NMFS",1983,4,13,103,30,41,-68.8,0,0,0,0,0,"AL",0.038
"7850",522,"198303.292.1190.7","NMFS",1983,4,13,103,30,41.033333,-68.45,0,0,0,0,0,"AL",0.038
"7851",522,"198303.293.1190.6","NMFS",1983,4,13,103,30,41.016667,-68.366667,0,0,0,0,0,"AL",0.038
"7852",525,"198303.294.1190.1","NMFS",1983,4,13,103,30,40.966667,-68.233333,0,0,0,0,0,"AL",0.038
"7853",525,"198303.295.1190.8","NMFS",1983,4,13,103,30,41.1,-67.833333,0,0,0,0,0,"AL",0.038
"7854",525,"198303.296.1190.4","NMFS",1983,4,13,103,30,41.15,-67.783333,0,0,0,0,0,"AL",0.038
"7855",522,"198303.297.1190.3","NMFS",1983,4,14,104,30,41.466667,-67.783333,0,0,0,0,0,"AL",0.038
"7856",522,"198303.298.1200.5","NMFS",1983,4,14,104,30,41.633333,-67.783333,0,0,0,0,0,"AL",0.038
"7857",562,"198303.299.1190.5","NMFS",1983,4,14,104,30,41.433333,-67.516667,0,0,0,0,0,"AL",0.038
"7858",562,"198303.300.1160.1","NMFS",1983,4,14,104,30,41.466667,-67.1,0,0,0,0,0,"AL",0.038
"7859",525,"198303.301.1160.3","NMFS",1983,4,14,104,30,41.133333,-67.216667,0,0,0,0,0,"AL",0.038
"7860",525,"198303.303.1140.2","NMFS",1983,4,14,104,30,40.683333,-66.966667,0,0,0,0,0,"AL",0.038
"7861",562,"198303.304.1150.3","NMFS",1983,4,14,104,30,40.733333,-66.783333,4,1,3,4,0,"AL",0.038
"7862",562,"198303.305.1180.1","NMFS",1983,4,14,104,22,40.883333,-66.55,0,0,0,0,0,"AL",0.038
"7863",562,"198303.306.1170.3","NMFS",1983,4,14,104,30,40.95,-66.566667,0,0,0,0,0,"AL",0.038
"7864",562,"198303.307.1160.5","NMFS",1983,4,15,105,30,41.2,-66.683333,0,0,0,0,0,"AL",0.038
"7865",562,"198303.308.1160.2","NMFS",1983,4,15,105,30,41.316667,-66.7,0,0,0,0,0,"AL",0.038
"7866",562,"198303.309.1160.8","NMFS",1983,4,15,105,30,41.433333,-66.65,0,0,0,0,0,"AL",0.038
"7867",552,"198303.310.1160.4","NMFS",1983,4,15,105,30,41.516667,-66.283333,0,0,0,0,0,"AL",0.038
"7868",552,"198303.312.1170.2","NMFS",1983,4,15,105,30,41.483333,-65.983333,2,2,0,2,0,"AL",0.038
"7869",552,"198303.313.1170.4","NMFS",1983,4,15,105,30,41.733333,-65.783333,2,2,0,2,0,"AL",0.038
"7870",552,"198303.314.1180.2","NMFS",1983,4,15,105,21,41.8,-65.733333,0,0,0,0,0,"AL",0.038
"7871",551,"198303.316.1170.1","NMFS",1983,4,15,105,30,41.85,-65.85,0,0,0,0,0,"AL",0.038
"7872",551,"198303.317.1160.6","NMFS",1983,4,16,106,30,42.016667,-66.116667,0,0,0,0,0,"AL",0.038
"7873",464,"198303.319.1310.3","NMFS",1983,4,16,106,30,42.266667,-65.516667,0,0,0,0,0,"AL",0.038
"7874",464,"198303.324.1320.4","NMFS",1983,4,16,106,30,42.516667,-65.633333,0,0,0,0,0,"AL",0.038
"7875",464,"198303.326.1320.1","NMFS",1983,4,16,106,30,42.833333,-65.933333,0,0,0,0,0,"AL",0.038
"7876",465,"198303.328.1310.7","NMFS",1983,4,16,106,20,43,-66.4,0,0,0,0,0,"AL",0.038
"7877",464,"198303.329.1360.1","NMFS",1983,4,17,107,30,42.916667,-66.716667,0,0,0,0,0,"AL",0.038
"7878",465,"198303.331.1330.2","NMFS",1983,4,17,107,30,43.35,-66.55,0,0,0,0,0,"AL",0.038
"7879",465,"198303.332.1330.4","NMFS",1983,4,17,107,30,43.45,-66.416667,0,0,0,0,0,"AL",0.038
"7880",465,"198303.334.1340.6","NMFS",1983,4,17,107,30,43.916667,-66.733333,0,0,0,0,0,"AL",0.038
"7881",466,"198303.335.1330.3","NMFS",1983,4,17,107,30,44.033333,-66.5,0,0,0,0,0,"AL",0.038
"7882",465,"198303.336.1340.1","NMFS",1983,4,17,107,30,44,-66.716667,0,0,0,0,0,"AL",0.038
"7883",511,"198303.337.1340.2","NMFS",1983,4,17,107,30,43.95,-67,0,0,0,0,0,"AL",0.038
"7884",465,"198303.338.1340.4","NMFS",1983,4,17,107,30,43.833333,-67.216667,0,0,0,0,0,"AL",0.038
"7885",465,"198303.339.1340.5","NMFS",1983,4,18,108,30,43.75,-67.266667,0,0,0,0,0,"AL",0.038
"7886",465,"198303.340.1360.7","NMFS",1983,4,18,108,30,43.516667,-67.466667,0,0,0,0,0,"AL",0.038
"7887",465,"198303.341.1360.2","NMFS",1983,4,18,108,30,43.4,-67.133333,0,0,0,0,0,"AL",0.038
"7888",464,"198303.343.1360.4","NMFS",1983,4,18,108,30,42.8,-67.233333,0,0,0,0,0,"AL",0.038
"7889",464,"198303.344.1310.6","NMFS",1983,4,18,108,30,42.683333,-66.8,0,0,0,0,0,"AL",0.038
"7890",464,"198303.346.1290.1","NMFS",1983,4,18,108,30,42.6,-66.8,0,0,0,0,0,"AL",0.038
"7891",464,"198303.347.1310.5","NMFS",1983,4,18,108,30,42.666667,-66.5,0,0,0,0,0,"AL",0.038
"7892",464,"198303.348.1290.5","NMFS",1983,4,19,109,30,42.416667,-66.4,0,0,0,0,0,"AL",0.038
"7893",464,"198303.349.1300.3","NMFS",1983,4,19,109,30,42.383333,-66.7,2,2,0,2,0,"AL",0.038
"7894",551,"198303.350.1300.1","NMFS",1983,4,19,109,30,42.316667,-66.9,0,0,0,0,0,"AL",0.038
"7895",551,"198303.351.1220.3","NMFS",1983,4,19,109,30,42.166667,-66.733333,1,0,1,1,0,"AL",0.038
"7896",551,"198303.352.1160.7","NMFS",1983,4,19,109,30,41.966667,-66.75,0,0,0,0,0,"AL",0.038
"7897",551,"198303.353.1160.10","NMFS",1983,4,19,109,30,41.916667,-66.766667,0,0,0,0,0,"AL",0.038
"7898",552,"198303.354.1160.9","NMFS",1983,4,19,109,30,41.833333,-66.783333,0,0,0,0,0,"AL",0.038
"7899",561,"198303.355.1210.1","NMFS",1983,4,19,109,30,42.083333,-67.2,0,0,0,0,0,"AL",0.038
"7900",561,"198303.356.1220.4","NMFS",1983,4,19,109,30,42.183333,-67.216667,0,0,0,0,0,"AL",0.038
"7901",561,"198303.357.1290.4","NMFS",1983,4,19,109,30,42.266667,-67.4,1,1,0,1,0,"AL",0.038
"7902",464,"198303.358.1300.2","NMFS",1983,4,19,109,30,42.533333,-67.3,0,0,0,0,0,"AL",0.038
"7903",464,"198303.359.1290.3","NMFS",1983,4,20,110,30,42.683333,-67.633333,0,0,0,0,0,"AL",0.038
"7904",515,"198303.360.1290.7","NMFS",1983,4,20,110,30,42.55,-67.916667,0,0,0,0,0,"AL",0.038
"7905",515,"198303.361.1290.8","NMFS",1983,4,20,110,30,42.483333,-68.133333,0,0,0,0,0,"AL",0.038
"7906",522,"198303.362.1290.6","NMFS",1983,4,20,110,30,42.166667,-68.1,0,0,0,0,0,"AL",0.038
"7907",522,"198303.363.1210.3","NMFS",1983,4,20,110,30,41.983333,-67.766667,2,1,1,2,0,"AL",0.038
"7908",561,"198303.364.1200.1","NMFS",1983,4,20,110,30,41.9,-67.483333,0,0,0,0,0,"AL",0.038
"7909",522,"198303.365.1210.2","NMFS",1983,4,20,110,30,41.833333,-68.133333,0,0,0,0,0,"AL",0.038
"7910",522,"198303.366.1220.1","NMFS",1983,4,20,110,30,41.866667,-68.116667,0,0,0,0,0,"AL",0.038
"7911",522,"198303.367.1210.4","NMFS",1983,4,20,110,30,41.766667,-68.25,0,0,0,0,0,"AL",0.038
"7912",522,"198303.368.1220.2","NMFS",1983,4,21,111,30,41.8,-68.266667,0,0,0,0,0,"AL",0.038
"7913",522,"198303.370.1240.4","NMFS",1983,4,21,111,30,42.316667,-68.55,0,0,0,0,0,"AL",0.038
"7914",515,"198303.371.1290.2","NMFS",1983,4,21,111,30,42.5,-68.516667,0,0,0,0,0,"AL",0.038
"7915",515,"198303.372.1280.7","NMFS",1983,4,21,111,30,42.5,-68.733333,0,0,0,0,0,"AL",0.038
"7916",515,"198303.373.1280.6","NMFS",1983,4,21,111,30,42.4,-68.733333,0,0,0,0,0,"AL",0.038
"7917",514,"198303.374.3590.1","NMFS",1983,4,25,115,30,41.8,-70.366667,1,1,0,1,0,"AL",0.038
"7918",514,"198303.375.3580.1","NMFS",1983,4,26,116,30,41.8,-70.25,2,1,1,2,0,"AL",0.038
"7919",514,"198303.376.3600.2","NMFS",1983,4,26,116,30,41.95,-70.433333,6,2,4,5,1,"AL",0.038
"7920",514,"198303.377.3610.1","NMFS",1983,4,26,116,30,42.05,-70.366667,24,6,18,24,0,"AL",0.038
"7921",514,"198303.378.3610.2","NMFS",1983,4,26,116,30,42.05,-70.483333,18,10,8,15,3,"AL",0.038
"7922",514,"198303.379.3600.1","NMFS",1983,4,26,116,30,42.066667,-70.566667,2,1,1,2,0,"AL",0.038
"7923",514,"198303.380.3650.1","NMFS",1983,4,26,116,30,42.183333,-70.55,2,0,2,2,0,"AL",0.038
"7924",514,"198303.381.3660.2","NMFS",1983,4,26,116,30,42.233333,-70.533333,4,1,3,4,0,"AL",0.038
"7925",514,"198303.382.1260.2","NMFS",1983,4,26,116,30,42.2,-70.4,3,1,2,3,0,"AL",0.038
"7926",514,"198303.383.1260.3","NMFS",1983,4,26,116,30,42.25,-70.366667,0,0,0,0,0,"AL",0.038
"7927",514,"198303.384.1260.4","NMFS",1983,4,26,116,30,42.366667,-70.316667,0,0,0,0,0,"AL",0.038
"7928",514,"198303.385.1260.5","NMFS",1983,4,26,116,30,42.533333,-70.166667,0,0,0,0,0,"AL",0.038
"7929",514,"198303.386.1270.3","NMFS",1983,4,26,116,30,42.683333,-70.05,0,0,0,0,0,"AL",0.038
"7930",514,"198303.387.1270.4","NMFS",1983,4,26,116,30,42.833333,-70,0,0,0,0,0,"AL",0.038
"7931",515,"198303.388.1280.4","NMFS",1983,4,27,117,30,42.416667,-69.566667,0,0,0,0,0,"AL",0.038
"7932",515,"198303.389.1280.5","NMFS",1983,4,27,117,30,42.383333,-69.333333,0,0,0,0,0,"AL",0.038
"7933",521,"198303.390.1240.5","NMFS",1983,4,27,117,30,42.15,-69.05,0,0,0,0,0,"AL",0.038
"7934",521,"198303.391.1240.2","NMFS",1983,4,27,117,30,42.216667,-69.066667,0,0,0,0,0,"AL",0.038
"7935",515,"198303.392.1280.3","NMFS",1983,4,27,117,30,42.416667,-69.016667,0,0,0,0,0,"AL",0.038
"7936",515,"198303.393.1280.2","NMFS",1983,4,27,117,30,42.683333,-68.6,0,0,0,0,0,"AL",0.038
"7937",515,"198303.394.1360.5","NMFS",1983,4,27,117,30,42.766667,-68.116667,0,0,0,0,0,"AL",0.038
"7938",515,"198303.395.1360.6","NMFS",1983,4,27,117,30,42.866667,-68.133333,0,0,0,0,0,"AL",0.038
"7939",515,"198303.396.1370.2","NMFS",1983,4,27,117,30,42.783333,-68.716667,0,0,0,0,0,"AL",0.038
"7940",515,"198303.397.1370.3","NMFS",1983,4,27,117,30,42.783333,-68.816667,0,0,0,0,0,"AL",0.038
"7941",515,"198303.398.1370.4","NMFS",1983,4,28,118,30,42.933333,-69.083333,0,0,0,0,0,"AL",0.038
"7942",513,"198303.399.1370.5","NMFS",1983,4,28,118,30,43.133333,-69.25,0,0,0,0,0,"AL",0.038
"7943",512,"198303.402.1360.3","NMFS",1983,4,28,118,30,43.416667,-67.983333,0,0,0,0,0,"AL",0.038
"7944",512,"198303.403.1360.8","NMFS",1983,4,28,118,30,43.883333,-67.716667,0,0,0,0,0,"AL",0.038
"7945",511,"198303.404.1340.3","NMFS",1983,4,28,118,30,44.05,-67.35,0,0,0,0,0,"AL",0.038
"7946",466,"198303.405.1350.2","NMFS",1983,4,29,119,30,44.366667,-66.65,0,0,0,0,0,"AL",0.038
"7947",467,"198303.407.1350.4","NMFS",1983,4,29,119,30,44.733333,-66.466667,0,0,0,0,0,"AL",0.038
"7948",467,"198303.408.1350.3","NMFS",1983,4,29,119,30,44.783333,-66.616667,0,0,0,0,0,"AL",0.038
"7949",511,"198303.409.1390.2","NMFS",1983,4,29,119,30,44.4,-67.466667,0,0,0,0,0,"AL",0.038
"7950",511,"198303.410.1390.3","NMFS",1983,4,29,119,30,44.266667,-67.7,1,0,1,1,0,"AL",0.038
"7951",511,"198303.411.1380.5","NMFS",1983,4,29,119,30,44.1,-67.65,1,1,0,1,0,"AL",0.038
"7952",512,"198303.412.1390.5","NMFS",1983,4,29,119,30,44.066667,-68.05,0,0,0,0,0,"AL",0.038
"7953",512,"198303.413.1390.1","NMFS",1983,4,29,119,30,44.016667,-68.316667,3,1,2,2,1,"AL",0.038
"7954",512,"198303.414.1390.4","NMFS",1983,4,29,119,30,43.9,-68.433333,0,0,0,0,0,"AL",0.038
"7955",512,"198303.415.1380.3","NMFS",1983,4,30,120,30,43.75,-68.416667,1,1,0,1,0,"AL",0.038
"7956",512,"198303.416.1380.4","NMFS",1983,4,30,120,30,43.683333,-68.583333,1,1,0,1,0,"AL",0.038
"7957",512,"198303.417.1380.2","NMFS",1983,4,30,120,30,43.6,-68.966667,0,0,0,0,0,"AL",0.038
"7958",513,"198303.418.1380.1","NMFS",1983,4,30,120,26,43.666667,-69.4,1,0,1,1,0,"AL",0.038
"7959",513,"198303.419.1400.3","NMFS",1983,4,30,120,30,43.566667,-69.683333,0,0,0,0,0,"AL",0.038
"7960",513,"198303.420.1270.2","NMFS",1983,4,30,120,30,43.333333,-70.016667,0,0,0,0,0,"AL",0.038
"7961",513,"198303.421.1370.1","NMFS",1983,4,30,120,30,43.15,-69.916667,0,0,0,0,0,"AL",0.038
"7962",513,"198303.422.1270.1","NMFS",1983,4,30,120,30,42.983333,-70.216667,0,0,0,0,0,"AL",0.038
"7963",514,"198303.423.1400.2","NMFS",1983,4,30,120,26,42.816667,-70.533333,0,0,0,0,0,"AL",0.038
"7964",514,"198303.424.1400.1","NMFS",1983,4,30,120,30,42.766667,-70.633333,0,0,0,0,0,"AL",0.038
"7965",514,"198303.425.3640.1","NMFS",1983,4,30,120,30,42.8,-70.683333,0,0,0,0,0,"AL",0.038
"7966",514,"198303.426.3630.1","NMFS",1983,5,1,121,23,42.733333,-70.716667,7,3,4,5,2,"AL",0.038
"7967",514,"198303.427.3660.1","NMFS",1983,5,1,121,30,42.7,-70.466667,4,4,0,3,1,"AL",0.038
"7968",514,"198303.428.1260.1","NMFS",1983,4,30,120,30,42.466667,-70.6,5,2,3,5,0,"AL",0.038
"7969",526,"198306.246.1110.2","NMFS",1983,10,8,281,30,40.016667,-69.966667,0,0,0,0,0,"AL",0.038
"7970",526,"198306.247.1120.3","NMFS",1983,10,8,281,30,39.933333,-69.8,6,3,3,6,0,"AL",0.038
"7971",526,"198306.259.1090.3","NMFS",1983,10,9,282,30,40.716667,-69.833333,2,2,0,2,0,"AL",0.038
"7972",526,"198306.260.1090.1","NMFS",1983,10,9,282,30,40.666667,-69.65,7,2,5,5,2,"AL",0.038
"7973",526,"198306.261.3550.3","NMFS",1983,10,10,283,30,40.95,-69.783333,0,0,0,0,0,"AL",0.038
"7974",526,"198306.262.3550.4","NMFS",1983,10,10,283,30,41.016667,-69.6,0,0,0,0,0,"AL",0.038
"7975",526,"198306.263.3550.1","NMFS",1983,10,10,283,30,40.916667,-69.5,0,0,0,0,0,"AL",0.038
"7976",526,"198306.264.1100.3","NMFS",1983,10,10,283,30,40.6,-68.95,1,0,1,1,0,"AL",0.038
"7977",526,"198306.265.1100.2","NMFS",1983,10,10,283,30,40.3,-69,6,1,5,4,2,"AL",0.038
"7978",526,"198306.266.1110.3","NMFS",1983,10,10,283,30,40.233333,-68.966667,0,0,0,0,0,"AL",0.038
"7979",526,"198306.267.1100.6","NMFS",1983,10,10,283,30,40.266667,-68.85,0,0,0,0,0,"AL",0.038
"7980",525,"198306.268.1120.2","NMFS",1983,10,10,283,30,40.133333,-68.833333,2,1,1,2,0,"AL",0.038
"7981",525,"198306.269.1140.3","NMFS",1983,10,10,283,30,40.266667,-68.433333,1,0,1,0,1,"AL",0.038
"7982",525,"198306.270.1130.9","NMFS",1983,10,10,283,30,40.366667,-68.533333,0,0,0,0,0,"AL",0.038
"7983",525,"198306.271.1130.2","NMFS",1983,10,11,284,30,40.6,-68.333333,0,0,0,0,0,"AL",0.038
"7984",525,"198306.272.1130.7","NMFS",1983,10,11,284,30,40.666667,-68.216667,0,0,0,0,0,"AL",0.038
"7985",525,"198306.273.1130.3","NMFS",1983,10,11,284,30,40.85,-68.133333,3,1,2,3,0,"AL",0.038
"7986",525,"198306.274.1140.4","NMFS",1983,10,11,284,30,40.366667,-67.983333,0,0,0,0,0,"AL",0.038
"7987",525,"198306.275.1140.5","NMFS",1983,10,11,284,30,40.4,-67.9,1,1,0,1,0,"AL",0.038
"7988",525,"198306.276.1140.2","NMFS",1983,10,11,284,30,40.433333,-67.783333,1,1,0,1,0,"AL",0.038
"7989",525,"198306.277.1150.1","NMFS",1983,10,11,284,30,40.416667,-67.633333,0,0,0,0,0,"AL",0.038
"7990",525,"198306.278.1140.1","NMFS",1983,10,11,284,30,40.55,-67.516667,3,2,1,3,0,"AL",0.038
"7991",525,"198306.279.1130.5","NMFS",1983,10,11,284,30,40.766667,-67.583333,0,0,0,0,0,"AL",0.038
"7992",525,"198306.280.1130.4","NMFS",1983,10,11,284,30,40.983333,-67.4,1,1,0,0,1,"AL",0.038
"7993",525,"198306.281.1130.1","NMFS",1983,10,12,285,30,41.05,-67.366667,2,0,2,1,1,"AL",0.038
"7994",525,"198306.282.1130.8","NMFS",1983,10,12,285,30,40.983333,-67.633333,3,2,1,3,0,"AL",0.038
"7995",525,"198306.283.1190.4","NMFS",1983,10,12,285,30,41.133333,-67.666667,0,0,0,0,0,"AL",0.038
"7996",525,"198306.284.1190.6","NMFS",1983,10,12,285,30,41.083333,-67.866667,0,0,0,0,0,"AL",0.038
"7997",525,"198306.285.1190.5","NMFS",1983,10,12,285,30,41.083333,-68.3,1,1,0,1,0,"AL",0.038
"7998",522,"198306.286.1190.8","NMFS",1983,10,12,285,30,41.066667,-68.416667,0,0,0,0,0,"AL",0.038
"7999",526,"198306.287.1130.6","NMFS",1983,10,12,285,30,40.983333,-68.9,1,1,0,1,0,"AL",0.038
"8000",521,"198306.288.1230.2","NMFS",1983,10,12,285,30,41.183333,-68.85,0,0,0,0,0,"AL",0.038
"8001",521,"198306.289.1230.1","NMFS",1983,10,12,285,30,41.2,-69.166667,0,0,0,0,0,"AL",0.038
"8002",521,"198306.290.1250.2","NMFS",1983,10,12,285,30,41.133333,-69.316667,0,0,0,0,0,"AL",0.038
"8003",521,"198306.291.1250.3","NMFS",1983,10,12,285,30,41.133333,-69.4,5,2,3,4,1,"AL",0.038
"8004",521,"198306.292.3550.2","NMFS",1983,10,13,286,30,41.366667,-69.566667,25,15,10,24,1,"AL",0.038
"8005",521,"198306.293.1250.4","NMFS",1983,10,13,286,27,41.533333,-69.666667,13,8,5,13,0,"AL",0.038
"8006",521,"198306.294.1250.1","NMFS",1983,10,13,286,21,41.633333,-69.75,4,1,3,1,3,"AL",0.038
"8007",521,"198306.296.1240.6","NMFS",1983,10,13,286,30,41.816667,-69.483333,0,0,0,0,0,"AL",0.038
"8008",522,"198306.309.1240.3","NMFS",1983,10,19,292,30,41.533333,-68.783333,0,0,0,0,0,"AL",0.038
"8009",522,"198306.310.1230.3","NMFS",1983,10,19,292,30,41.4,-68.366667,4,0,4,4,0,"AL",0.038
"8010",522,"198306.311.1230.5","NMFS",1983,10,19,292,30,41.3,-68.633333,0,0,0,0,0,"AL",0.038
"8011",522,"198306.312.1230.4","NMFS",1983,10,19,292,30,41.233333,-68.633333,1,0,1,1,0,"AL",0.038
"8012",522,"198306.313.1200.2","NMFS",1983,10,19,292,30,41.2,-68.4,1,0,1,1,0,"AL",0.038
"8013",525,"198306.315.1190.7","NMFS",1983,10,19,292,30,41.233333,-68.133333,0,0,0,0,0,"AL",0.038
"8014",525,"198306.317.1190.3","NMFS",1983,10,19,292,30,41.25,-67.716667,0,0,0,0,0,"AL",0.038
"8015",522,"198306.318.1190.9","NMFS",1983,10,19,292,30,41.4,-67.8,0,0,0,0,0,"AL",0.038
"8016",522,"198306.319.1190.2","NMFS",1983,10,19,292,30,41.45,-67.783333,0,0,0,0,0,"AL",0.038
"8017",562,"198306.326.1160.1","NMFS",1983,10,20,293,30,41.533333,-66.9,5,3,2,5,0,"AL",0.038
"8018",562,"198306.329.1190.1","NMFS",1983,10,20,293,30,41.216667,-67.366667,0,0,0,0,0,"AL",0.038
"8019",562,"198306.330.1160.5","NMFS",1983,10,20,293,30,41.183333,-67.2,0,0,0,0,0,"AL",0.038
"8020",562,"198306.333.1160.3","NMFS",1983,10,20,293,30,41.116667,-66.85,0,0,0,0,0,"AL",0.038
"8021",562,"198306.334.1160.10","NMFS",1983,10,20,293,30,40.983333,-66.966667,0,0,0,0,0,"AL",0.038
"8022",562,"198306.335.1150.2","NMFS",1983,10,21,294,30,40.733333,-66.816667,5,3,2,5,0,"AL",0.038
"8023",562,"198306.336.1160.8","NMFS",1983,10,21,294,30,40.966667,-66.616667,0,0,0,0,0,"AL",0.038
"8024",562,"198306.338.1180.3","NMFS",1983,10,21,294,30,41,-66.433333,0,0,0,0,0,"AL",0.038
"8025",552,"198306.339.1160.4","NMFS",1983,10,21,294,30,41.3,-66.4,0,0,0,0,0,"AL",0.038
"8026",552,"198306.340.1160.9","NMFS",1983,10,21,294,30,41.6,-66.383333,0,0,0,0,0,"AL",0.038
"8027",552,"198306.341.1160.7","NMFS",1983,10,22,295,30,41.733333,-66.583333,1,1,0,1,0,"AL",0.038
"8028",552,"198306.342.1160.6","NMFS",1983,10,22,295,30,41.75,-66.766667,1,1,0,1,0,"AL",0.038
"8029",522,"198306.347.1200.3","NMFS",1983,10,22,295,30,41.816667,-67.816667,5,1,4,5,0,"AL",0.038
"8030",522,"198306.349.1200.4","NMFS",1983,10,22,295,30,41.666667,-67.933333,0,0,0,0,0,"AL",0.038
"8031",522,"198306.352.1200.5","NMFS",1983,10,22,295,30,41.633333,-68.116667,1,1,0,1,0,"AL",0.038
"8032",522,"198306.353.1200.1","NMFS",1983,10,22,295,30,41.583333,-68.216667,1,1,0,0,1,"AL",0.038
"8033",522,"198306.354.1210.4","NMFS",1983,10,22,295,30,41.683333,-68.366667,1,1,0,1,0,"AL",0.038
"8034",522,"198306.355.1240.2","NMFS",1983,10,23,296,30,41.733333,-68.516667,0,0,0,0,0,"AL",0.038
"8035",522,"198306.359.1220.1","NMFS",1983,10,23,296,30,42.016667,-67.983333,0,0,0,0,0,"AL",0.038
"8036",522,"198306.360.1220.4","NMFS",1983,10,23,296,30,41.983333,-67.833333,0,0,0,0,0,"AL",0.038
"8037",522,"198306.361.1210.1","NMFS",1983,10,23,296,30,42.016667,-67.766667,0,0,0,0,0,"AL",0.038
"8038",522,"198306.362.1290.7","NMFS",1983,10,23,296,30,42.166667,-67.966667,0,0,0,0,0,"AL",0.038
"8039",522,"198306.363.1290.2","NMFS",1983,10,23,296,30,42.233333,-67.716667,0,0,0,0,0,"AL",0.038
"8040",561,"198306.365.1220.3","NMFS",1983,10,23,296,30,42.1,-67.616667,0,0,0,0,0,"AL",0.038
"8041",561,"198306.366.1220.2","NMFS",1983,10,23,296,30,42.183333,-67.45,0,0,0,0,0,"AL",0.038
"8042",561,"198306.368.1200.6","NMFS",1983,10,23,296,30,42.033333,-67.4,0,0,0,0,0,"AL",0.038
"8043",551,"198306.373.1210.3","NMFS",1983,10,24,297,30,42.083333,-66.583333,0,0,0,0,0,"AL",0.038
"8044",551,"198306.375.1210.2","NMFS",1983,10,24,297,30,42.1,-66.3,0,0,0,0,0,"AL",0.038
"8045",551,"198306.377.1180.1","NMFS",1983,10,24,297,30,42.033333,-65.9,0,0,0,0,0,"AL",0.038
"8046",551,"198306.378.1170.3","NMFS",1983,10,24,297,30,41.966667,-65.95,0,0,0,0,0,"AL",0.038
"8047",551,"198306.379.1170.2","NMFS",1983,10,24,297,30,41.85,-65.866667,0,0,0,0,0,"AL",0.038
"8048",552,"198306.380.1180.2","NMFS",1983,10,24,297,30,41.733333,-65.783333,0,0,0,0,0,"AL",0.038
"8049",552,"198306.381.1170.1","NMFS",1983,10,24,297,21,41.683333,-65.816667,0,0,0,0,0,"AL",0.038
"8050",514,"198306.384.1260.1","NMFS",1983,10,26,299,30,42.366667,-70.15,0,0,0,0,0,"AL",0.038
"8051",514,"198306.388.3660.1","NMFS",1983,10,26,299,24,42.416667,-70.683333,14,8,6,14,0,"AL",0.038
"8052",514,"198306.390.3660.2","NMFS",1983,10,26,299,27,42.3,-70.666667,141,72,69,140,1,"AL",0.038
"8053",514,"198306.392.1260.2","NMFS",1983,10,27,300,30,42.133333,-70.383333,1,0,1,1,0,"AL",0.038
"8054",514,"198306.393.3610.2","NMFS",1983,10,27,300,30,42.05,-70.466667,49,16,33,45,4,"AL",0.038
"8055",514,"198306.394.3610.1","NMFS",1983,10,27,300,30,42.066667,-70.383333,15,12,3,15,0,"AL",0.038
"8056",514,"198306.395.3600.2","NMFS",1983,10,27,300,30,41.933333,-70.35,20,8,12,19,1,"AL",0.038
"8057",514,"198306.396.3600.1","NMFS",1983,10,27,300,30,41.866667,-70.333333,24,11,13,22,2,"AL",0.038
"8058",514,"198306.397.3590.1","NMFS",1983,10,27,300,30,41.816667,-70.35,9,5,4,9,0,"AL",0.038
"8059",514,"198306.398.3580.1","NMFS",1983,10,27,300,30,41.75,-70.316667,1,1,0,1,0,"AL",0.038
"8060",521,"198306.399.1280.3","NMFS",1983,11,1,305,30,42.266667,-69.2,0,0,0,0,0,"AL",0.038
"8061",521,"198306.400.1240.5","NMFS",1983,11,1,305,30,42.116667,-68.933333,0,0,0,0,0,"AL",0.038
"8062",522,"198306.401.1240.4","NMFS",1983,11,1,305,30,42.183333,-68.383333,0,0,0,0,0,"AL",0.038
"8063",522,"198306.402.1240.1","NMFS",1983,11,1,305,30,42.25,-68.583333,0,0,0,0,0,"AL",0.038
"8064",515,"198306.403.1290.4","NMFS",1983,11,1,305,30,42.383333,-68.433333,0,0,0,0,0,"AL",0.038
"8065",515,"198306.404.1290.3","NMFS",1983,11,1,305,30,42.5,-68.416667,0,0,0,0,0,"AL",0.038
"8066",515,"198306.405.1290.1","NMFS",1983,11,1,305,30,42.666667,-68.433333,0,0,0,0,0,"AL",0.038
"8067",515,"198306.406.1290.6","NMFS",1983,11,1,305,30,42.683333,-68.316667,0,0,0,0,0,"AL",0.038
"8068",515,"198306.407.1360.2","NMFS",1983,11,2,306,30,42.866667,-68.283333,0,0,0,0,0,"AL",0.038
"8069",464,"198306.408.1290.8","NMFS",1983,11,2,306,30,42.55,-67.516667,0,0,0,0,0,"AL",0.038
"8070",464,"198306.409.1300.1","NMFS",1983,11,2,306,30,42.6,-67.116667,0,0,0,0,0,"AL",0.038
"8071",464,"198306.410.1300.3","NMFS",1983,11,2,306,30,42.566667,-67.05,0,0,0,0,0,"AL",0.038
"8072",464,"198306.411.1300.2","NMFS",1983,11,2,306,30,42.483333,-66.766667,1,0,1,1,0,"AL",0.038
"8073",464,"198306.412.1310.5","NMFS",1983,11,2,306,30,42.583333,-66.466667,0,0,0,0,0,"AL",0.038
"8074",464,"198306.414.1290.10","NMFS",1983,11,2,306,30,42.333333,-65.816667,0,0,0,0,0,"AL",0.038
"8075",464,"198306.415.1290.5","NMFS",1983,11,3,307,30,42.183333,-65.75,0,0,0,0,0,"AL",0.038
"8076",464,"198306.418.1320.5","NMFS",1983,11,3,307,30,42.516667,-65.6,0,0,0,0,0,"AL",0.038
"8077",464,"198306.420.1320.3","NMFS",1983,11,3,307,30,42.833333,-65.883333,0,0,0,0,0,"AL",0.038
"8078",464,"198306.421.1320.4","NMFS",1983,11,3,307,30,42.733333,-66.05,0,0,0,0,0,"AL",0.038
"8079",464,"198306.422.1320.2","NMFS",1983,11,3,307,30,42.616667,-66.05,0,0,0,0,0,"AL",0.038
"8080",464,"198306.423.1320.1","NMFS",1983,11,3,307,30,42.6,-66.15,0,0,0,0,0,"AL",0.038
"8081",464,"198306.425.1310.6","NMFS",1983,11,3,307,30,42.783333,-66.7,0,0,0,0,0,"AL",0.038
"8082",464,"198306.426.1360.1","NMFS",1983,11,4,308,30,42.8,-66.9,0,0,0,0,0,"AL",0.038
"8083",465,"198306.427.1360.3","NMFS",1983,11,4,308,30,43.066667,-67.416667,0,0,0,0,0,"AL",0.038
"8084",465,"198306.428.1360.4","NMFS",1983,11,4,308,30,43.233333,-67,0,0,0,0,0,"AL",0.038
"8085",465,"198306.429.1330.4","NMFS",1983,11,4,308,30,43.433333,-66.533333,1,0,1,1,0,"AL",0.038
"8086",465,"198306.430.1330.1","NMFS",1983,11,4,308,30,43.483333,-66.45,0,0,0,0,0,"AL",0.038
"8087",465,"198306.431.1330.3","NMFS",1983,11,4,308,30,43.583333,-66.45,0,0,0,0,0,"AL",0.038
"8088",465,"198306.432.1340.2","NMFS",1983,11,4,308,30,43.683333,-66.816667,1,1,0,1,0,"AL",0.038
"8089",465,"198306.433.1340.3","NMFS",1983,11,4,308,30,43.85,-66.766667,2,2,0,2,0,"AL",0.038
"8090",465,"198306.434.1330.2","NMFS",1983,11,4,308,30,43.983333,-66.483333,0,0,0,0,0,"AL",0.038
"8091",511,"198306.435.1340.1","NMFS",1983,11,5,309,30,44.05,-66.85,0,0,0,0,0,"AL",0.038
"8092",465,"198306.436.1340.5","NMFS",1983,11,5,309,30,43.833333,-67.05,0,0,0,0,0,"AL",0.038
"8093",511,"198306.437.1340.4","NMFS",1983,11,5,309,30,43.933333,-67.466667,0,0,0,0,0,"AL",0.038
"8094",512,"198306.438.1390.1","NMFS",1983,11,5,309,30,44.233333,-67.883333,5,4,1,5,0,"AL",0.038
"8095",512,"198306.439.1390.2","NMFS",1983,11,6,310,30,44.116667,-68,0,0,0,0,0,"AL",0.038
"8096",512,"198306.440.1380.4","NMFS",1983,11,6,310,30,43.533333,-68.45,0,0,0,0,0,"AL",0.038
"8097",512,"198306.441.1380.2","NMFS",1983,11,6,310,30,43.45,-68.533333,0,0,0,0,0,"AL",0.038
"8098",515,"198306.442.1370.1","NMFS",1983,11,7,311,30,43.083333,-68.733333,0,0,0,0,0,"AL",0.038
"8099",515,"198306.443.1370.4","NMFS",1983,11,7,311,30,43.05,-68.783333,0,0,0,0,0,"AL",0.038
"8100",513,"198306.444.1370.2","NMFS",1983,11,7,311,30,42.883333,-69.466667,0,0,0,0,0,"AL",0.038
"8101",513,"198306.445.1370.3","NMFS",1983,11,7,311,30,42.916667,-69.5,0,0,0,0,0,"AL",0.038
"8102",513,"198306.446.1370.5","NMFS",1983,11,7,311,30,43.083333,-69.416667,0,0,0,0,0,"AL",0.038
"8103",513,"198306.447.1380.3","NMFS",1983,11,7,311,30,43.383333,-69.216667,0,0,0,0,0,"AL",0.038
"8104",512,"198306.449.1390.4","NMFS",1983,11,7,311,30,43.75,-69.083333,5,3,2,5,0,"AL",0.038
"8105",513,"198306.450.1380.5","NMFS",1983,11,7,311,30,43.6,-69.266667,1,1,0,1,0,"AL",0.038
"8106",513,"198306.452.1380.1","NMFS",1983,11,7,311,30,43.533333,-69.483333,0,0,0,0,0,"AL",0.038
"8107",513,"198306.454.1400.2","NMFS",1983,11,8,312,30,43.433333,-70.016667,0,0,0,0,0,"AL",0.038
"8108",513,"198306.455.1270.1","NMFS",1983,11,8,312,30,43.133333,-69.95,0,0,0,0,0,"AL",0.038
"8109",513,"198306.456.1280.4","NMFS",1983,11,8,312,30,43.05,-69.95,0,0,0,0,0,"AL",0.038
"8110",513,"198306.457.1270.4","NMFS",1983,11,8,312,30,43.15,-70.216667,0,0,0,0,0,"AL",0.038
"8111",513,"198306.458.1270.3","NMFS",1983,11,8,312,30,43.116667,-70.266667,1,1,0,1,0,"AL",0.038
"8112",513,"198306.459.1400.1","NMFS",1983,11,8,312,30,43.1,-70.366667,4,0,4,4,0,"AL",0.038
"8113",513,"198306.460.1400.3","NMFS",1983,11,8,312,30,43.033333,-70.4,0,0,0,0,0,"AL",0.038
"8114",514,"198306.461.3650.1","NMFS",1983,11,8,312,30,42.75,-70.683333,24,12,12,19,5,"AL",0.038
"8115",514,"198306.462.1260.5","NMFS",1983,11,8,312,30,42.633333,-70.333333,2,1,1,2,0,"AL",0.038
"8116",514,"198306.464.1260.4","NMFS",1983,11,8,312,30,42.55,-70.333333,1,0,1,1,0,"AL",0.038
"8117",514,"198306.465.1260.3","NMFS",1983,11,8,312,30,42.616667,-70.233333,0,0,0,0,0,"AL",0.038
"8118",514,"198306.466.1270.2","NMFS",1983,11,9,313,30,42.766667,-70.05,0,0,0,0,0,"AL",0.038
"8119",514,"198306.467.1280.6","NMFS",1983,11,9,313,30,42.733333,-69.916667,1,1,0,1,0,"AL",0.038
"8120",514,"198306.470.1280.5","NMFS",1983,11,9,313,30,42.6,-69.733333,0,0,0,0,0,"AL",0.038
"8121",514,"198306.471.1280.7","NMFS",1983,11,9,313,30,42.55,-69.733333,0,0,0,0,0,"AL",0.038
"8122",515,"198306.472.1280.2","NMFS",1983,11,9,313,30,42.45,-69.483333,0,0,0,0,0,"AL",0.038
"8123",515,"198306.474.1280.1","NMFS",1983,11,9,313,30,42.55,-69,0,0,0,0,0,"AL",0.038
"8124",526,"198402.228.1090.2","NMFS",1984,3,25,85,30,40.7,-69.916667,0,0,0,0,0,"AL",0.038
"8125",526,"198402.229.1100.1","NMFS",1984,3,25,85,30,40.516667,-69.683333,0,0,0,0,0,"AL",0.038
"8126",526,"198402.230.1100.6","NMFS",1984,3,25,85,30,40.5,-69.566667,0,0,0,0,0,"AL",0.038
"8127",526,"198402.238.1110.2","NMFS",1984,3,26,86,30,40.05,-69.766667,0,0,0,0,0,"AL",0.038
"8128",526,"198402.240.1100.8","NMFS",1984,3,26,86,30,40.583333,-69.133333,0,0,0,0,0,"AL",0.038
"8129",526,"198402.241.1100.7","NMFS",1984,3,26,86,30,40.466667,-69,0,0,0,0,0,"AL",0.038
"8130",525,"198402.242.1130.5","NMFS",1984,3,26,86,30,40.5,-68.683333,0,0,0,0,0,"AL",0.038
"8131",525,"198402.243.1140.1","NMFS",1984,3,26,86,30,40.216667,-68.666667,0,0,0,0,0,"AL",0.038
"8132",525,"198402.244.1140.2","NMFS",1984,3,26,86,30,40.283333,-68.5,0,0,0,0,0,"AL",0.038
"8133",525,"198402.245.1150.3","NMFS",1984,3,26,86,30,40.2,-68.45,1,1,0,1,0,"AL",0.038
"8134",525,"198402.246.1150.2","NMFS",1984,3,26,86,30,40.283333,-68.016667,0,0,0,0,0,"AL",0.038
"8135",525,"198402.247.1140.3","NMFS",1984,3,27,87,30,40.366667,-68,0,0,0,0,0,"AL",0.038
"8136",525,"198402.248.1140.4","NMFS",1984,3,27,87,30,40.483333,-67.583333,0,0,0,0,0,"AL",0.038
"8137",525,"198402.249.1150.1","NMFS",1984,3,27,87,30,40.516667,-67.166667,0,0,0,0,0,"AL",0.038
"8138",562,"198402.250.1180.3","NMFS",1984,3,27,87,30,40.783333,-66.75,0,0,0,0,0,"AL",0.038
"8139",525,"198402.251.1130.2","NMFS",1984,3,27,87,30,40.683333,-67.133333,0,0,0,0,0,"AL",0.038
"8140",525,"198402.252.1130.7","NMFS",1984,3,27,87,30,40.75,-67.15,0,0,0,0,0,"AL",0.038
"8141",525,"198402.253.1130.6","NMFS",1984,3,27,87,30,40.733333,-67.2,0,0,0,0,0,"AL",0.038
"8142",525,"198402.254.1130.3","NMFS",1984,3,27,87,30,40.733333,-67.6,0,0,0,0,0,"AL",0.038
"8143",525,"198402.255.1130.1","NMFS",1984,3,27,87,30,41.016667,-67.583333,0,0,0,0,0,"AL",0.038
"8144",562,"198402.256.1190.9","NMFS",1984,3,27,87,30,41.183333,-67.55,0,0,0,0,0,"AL",0.038
"8145",562,"198402.257.1190.5","NMFS",1984,3,28,88,30,41.316667,-67.466667,0,0,0,0,0,"AL",0.038
"8146",525,"198402.258.1130.8","NMFS",1984,3,28,88,30,40.816667,-67.983333,0,0,0,0,0,"AL",0.038
"8147",525,"198402.259.1130.4","NMFS",1984,3,28,88,30,40.716667,-68.1,0,0,0,0,0,"AL",0.038
"8148",525,"198402.260.1190.6","NMFS",1984,3,28,88,30,41.033333,-68.216667,0,0,0,0,0,"AL",0.038
"8149",525,"198402.261.1190.2","NMFS",1984,3,28,88,30,40.983333,-68.35,0,0,0,0,0,"AL",0.038
"8150",522,"198402.262.1190.1","NMFS",1984,3,28,88,30,41.016667,-68.6,0,0,0,0,0,"AL",0.038
"8151",525,"198402.263.1130.9","NMFS",1984,3,28,88,30,40.95,-68.716667,0,0,0,0,0,"AL",0.038
"8152",522,"198402.264.1230.4","NMFS",1984,3,28,88,30,41.05,-68.8,0,0,0,0,0,"AL",0.038
"8153",521,"198402.265.1230.5","NMFS",1984,3,28,88,30,41.283333,-69.166667,0,0,0,0,0,"AL",0.038
"8154",521,"198402.266.1250.4","NMFS",1984,3,28,88,30,41.116667,-69.283333,1,0,1,0,1,"AL",0.038
"8155",521,"198402.267.3550.4","NMFS",1984,3,28,88,30,41.033333,-69.4,0,0,0,0,0,"AL",0.038
"8156",526,"198402.268.3550.1","NMFS",1984,3,28,88,30,40.95,-69.616667,0,0,0,0,0,"AL",0.038
"8157",521,"198402.269.3550.2","NMFS",1984,4,3,94,30,41.433333,-69.7,4,2,2,2,2,"AL",0.038
"8158",521,"198402.270.3550.3","NMFS",1984,4,3,94,30,41.366667,-69.566667,6,4,2,5,1,"AL",0.038
"8159",521,"198402.271.1250.2","NMFS",1984,4,3,94,26,41.516667,-69.566667,3,0,3,3,0,"AL",0.038
"8160",521,"198402.272.1240.3","NMFS",1984,4,3,94,30,41.75,-69.616667,0,0,0,0,0,"AL",0.038
"8161",521,"198402.273.1230.3","NMFS",1984,4,3,94,29,41.716667,-69.733333,0,0,0,0,0,"AL",0.038
"8162",521,"198402.274.1250.1","NMFS",1984,4,3,94,30,41.733333,-69.85,1,1,0,1,0,"AL",0.038
"8163",521,"198402.275.3560.1","NMFS",1984,4,3,94,30,41.95,-69.95,1,0,1,1,0,"AL",0.038
"8164",521,"198402.277.1250.3","NMFS",1984,4,3,94,30,41.983333,-69.916667,2,1,1,2,0,"AL",0.038
"8165",521,"198402.278.1280.5","NMFS",1984,4,3,94,30,42.05,-69.433333,0,0,0,0,0,"AL",0.038
"8166",521,"198402.279.1280.3","NMFS",1984,4,3,94,30,41.933333,-69.266667,0,0,0,0,0,"AL",0.038
"8167",521,"198402.280.1240.5","NMFS",1984,4,3,94,30,41.683333,-69.083333,0,0,0,0,0,"AL",0.038
"8168",521,"198402.281.1240.1","NMFS",1984,4,3,94,30,41.566667,-69.05,0,0,0,0,0,"AL",0.038
"8169",522,"198402.282.1240.4","NMFS",1984,4,4,95,30,41.783333,-68.816667,0,0,0,0,0,"AL",0.038
"8170",522,"198402.283.1240.6","NMFS",1984,4,4,95,30,41.716667,-68.583333,1,1,0,1,0,"AL",0.038
"8171",522,"198402.284.1240.2","NMFS",1984,4,4,95,30,41.983333,-68.35,0,0,0,0,0,"AL",0.038
"8172",522,"198402.285.1220.3","NMFS",1984,4,4,95,30,41.85,-68.116667,0,0,0,0,0,"AL",0.038
"8173",522,"198402.286.1210.4","NMFS",1984,4,4,95,30,41.8,-68.116667,0,0,0,0,0,"AL",0.038
"8174",522,"198402.287.1200.1","NMFS",1984,4,4,95,30,41.616667,-68.25,0,0,0,0,0,"AL",0.038
"8175",522,"198402.288.1200.5","NMFS",1984,4,4,95,30,41.533333,-68.333333,0,0,0,0,0,"AL",0.038
"8176",522,"198402.289.1230.2","NMFS",1984,4,4,95,30,41.5,-68.483333,0,0,0,0,0,"AL",0.038
"8177",522,"198402.290.1230.1","NMFS",1984,4,4,95,30,41.466667,-68.65,0,0,0,0,0,"AL",0.038
"8178",522,"198402.291.1200.3","NMFS",1984,4,4,95,30,41.333333,-68.333333,1,1,0,1,0,"AL",0.038
"8179",522,"198402.292.1200.4","NMFS",1984,4,4,95,30,41.3,-68.283333,0,0,0,0,0,"AL",0.038
"8180",522,"198402.293.1190.7","NMFS",1984,4,4,95,30,41.416667,-67.95,0,0,0,0,0,"AL",0.038
"8181",522,"198402.294.1200.2","NMFS",1984,4,5,96,30,41.733333,-67.666667,0,0,0,0,0,"AL",0.038
"8182",562,"198402.295.1190.4","NMFS",1984,4,5,96,30,41.733333,-67.533333,0,0,0,0,0,"AL",0.038
"8183",522,"198402.296.1200.6","NMFS",1984,4,5,96,30,41.883333,-67.666667,0,0,0,0,0,"AL",0.038
"8184",522,"198402.297.1220.1","NMFS",1984,4,5,96,30,42,-67.933333,0,0,0,0,0,"AL",0.038
"8185",561,"198402.298.1220.2","NMFS",1984,4,5,96,30,42.1,-67.6,0,0,0,0,0,"AL",0.038
"8186",561,"198402.299.1210.1","NMFS",1984,4,5,96,30,42.066667,-67.483333,0,0,0,0,0,"AL",0.038
"8187",561,"198402.300.1290.8","NMFS",1984,4,5,96,30,42.183333,-67.416667,0,0,0,0,0,"AL",0.038
"8188",551,"198402.301.1290.3","NMFS",1984,4,5,96,30,42.25,-67.016667,0,0,0,0,0,"AL",0.038
"8189",551,"198402.302.1220.4","NMFS",1984,4,5,96,30,42.166667,-66.95,0,0,0,0,0,"AL",0.038
"8190",552,"198402.303.1160.8","NMFS",1984,4,5,96,30,41.783333,-66.833333,0,0,0,0,0,"AL",0.038
"8191",562,"198402.304.1160.4","NMFS",1984,4,5,96,30,41.616667,-66.716667,0,0,0,0,0,"AL",0.038
"8192",562,"198402.305.1160.1","NMFS",1984,4,6,97,30,41.616667,-66.983333,0,0,0,0,0,"AL",0.038
"8193",562,"198402.306.1190.8","NMFS",1984,4,6,97,30,41.533333,-67.25,0,0,0,0,0,"AL",0.038
"8194",562,"198402.307.1190.3","NMFS",1984,4,6,97,30,41.5,-67.25,0,0,0,0,0,"AL",0.038
"8195",562,"198402.308.1160.9","NMFS",1984,4,10,101,30,41.333333,-66.933333,0,0,0,0,0,"AL",0.038
"8196",562,"198402.309.1160.2","NMFS",1984,4,10,101,30,41.233333,-66.583333,0,0,0,0,0,"AL",0.038
"8197",562,"198402.310.1180.2","NMFS",1984,4,11,102,30,41.066667,-66.416667,1,0,1,1,0,"AL",0.038
"8198",552,"198402.311.1160.11","NMFS",1984,4,11,102,30,41.416667,-66.366667,0,0,0,0,0,"AL",0.038
"8199",552,"198402.312.1160.5","NMFS",1984,4,11,102,30,41.6,-66.466667,0,0,0,0,0,"AL",0.038
"8200",552,"198402.313.1170.1","NMFS",1984,4,11,102,30,41.383333,-66.15,0,0,0,0,0,"AL",0.038
"8201",552,"198402.314.1180.1","NMFS",1984,4,11,102,30,41.35,-66.083333,0,0,0,0,0,"AL",0.038
"8202",552,"198402.315.1170.4","NMFS",1984,4,11,102,30,41.466667,-66.033333,0,0,0,0,0,"AL",0.038
"8203",552,"198402.316.1160.7","NMFS",1984,4,11,102,30,41.6,-66.016667,0,0,0,0,0,"AL",0.038
"8204",552,"198402.317.1170.2","NMFS",1984,4,11,102,30,41.733333,-65.883333,0,0,0,0,0,"AL",0.038
"8205",552,"198402.318.1160.6","NMFS",1984,4,11,102,30,41.783333,-66.133333,0,0,0,0,0,"AL",0.038
"8206",551,"198402.319.1170.3","NMFS",1984,4,11,102,30,42,-65.95,0,0,0,0,0,"AL",0.038
"8207",551,"198402.320.1160.3","NMFS",1984,4,12,103,30,41.95,-66.166667,0,0,0,0,0,"AL",0.038
"8208",551,"198402.321.1210.3","NMFS",1984,4,12,103,30,42.083333,-66.233333,0,0,0,0,0,"AL",0.038
"8209",551,"198402.322.1160.10","NMFS",1984,4,12,103,30,42.033333,-66.383333,0,0,0,0,0,"AL",0.038
"8210",551,"198402.323.1210.2","NMFS",1984,4,12,103,21,42.133333,-66.583333,0,0,0,0,0,"AL",0.038
"8211",514,"198402.324.3590.1","NMFS",1984,4,17,108,30,41.833333,-70.333333,4,4,0,3,1,"AL",0.038
"8212",514,"198402.325.3580.1","NMFS",1984,4,17,108,30,41.866667,-70.183333,0,0,0,0,0,"AL",0.038
"8213",514,"198402.326.3600.2","NMFS",1984,4,17,108,30,41.933333,-70.316667,23,7,16,21,2,"AL",0.038
"8214",514,"198402.327.3610.2","NMFS",1984,4,17,108,30,42.033333,-70.25,1,1,0,1,0,"AL",0.038
"8215",514,"198402.328.3600.1","NMFS",1984,4,17,108,30,42.083333,-70.55,5,1,4,5,0,"AL",0.038
"8216",514,"198402.329.3610.1","NMFS",1984,4,17,108,30,42.15,-70.466667,12,5,7,11,1,"AL",0.038
"8217",514,"198402.330.3660.1","NMFS",1984,4,17,108,27,42.283333,-70.6,1,0,1,1,0,"AL",0.038
"8218",514,"198402.331.3630.1","NMFS",1984,4,17,108,20,42.233333,-70.666667,3,1,2,3,0,"AL",0.038
"8219",514,"198402.333.3650.2","NMFS",1984,4,17,108,30,42.5,-70.733333,0,0,0,0,0,"AL",0.038
"8220",514,"198402.334.3660.2","NMFS",1984,4,17,108,30,42.516667,-70.65,8,7,1,8,0,"AL",0.038
"8221",514,"198402.335.1260.4","NMFS",1984,4,17,108,30,42.5,-70.55,1,0,1,1,0,"AL",0.038
"8222",514,"198402.336.1260.1","NMFS",1984,4,17,108,26,42.333333,-70.35,0,0,0,0,0,"AL",0.038
"8223",514,"198402.337.1260.3","NMFS",1984,4,17,108,30,42.266667,-70.05,0,0,0,0,0,"AL",0.038
"8224",514,"198402.338.1270.2","NMFS",1984,4,18,109,30,42.35,-69.95,0,0,0,0,0,"AL",0.038
"8225",521,"198402.339.1280.6","NMFS",1984,4,18,109,30,42.333333,-69.833333,0,0,0,0,0,"AL",0.038
"8226",515,"198402.340.1280.7","NMFS",1984,4,18,109,30,42.416667,-69.233333,0,0,0,0,0,"AL",0.038
"8227",515,"198402.341.1280.4","NMFS",1984,4,18,109,30,42.6,-69.316667,0,0,0,0,0,"AL",0.038
"8228",515,"198402.342.1370.1","NMFS",1984,4,18,109,30,42.716667,-69.283333,0,0,0,0,0,"AL",0.038
"8229",515,"198402.343.1370.2","NMFS",1984,4,18,109,30,42.883333,-69.133333,0,0,0,0,0,"AL",0.038
"8230",513,"198402.344.1370.3","NMFS",1984,4,18,109,30,42.883333,-69.433333,0,0,0,0,0,"AL",0.038
"8231",513,"198402.345.1370.5","NMFS",1984,4,18,109,30,42.866667,-69.583333,0,0,0,0,0,"AL",0.038
"8232",514,"198402.346.1280.2","NMFS",1984,4,18,109,30,42.65,-69.766667,0,0,0,0,0,"AL",0.038
"8233",514,"198402.347.1280.1","NMFS",1984,4,18,109,30,42.7,-69.916667,0,0,0,0,0,"AL",0.038
"8234",514,"198402.348.1270.1","NMFS",1984,4,18,109,30,42.6,-69.966667,0,0,0,0,0,"AL",0.038
"8235",514,"198402.349.1260.5","NMFS",1984,4,18,109,30,42.6,-70.233333,0,0,0,0,0,"AL",0.038
"8236",514,"198402.351.1270.3","NMFS",1984,4,19,110,30,42.833333,-70.416667,0,0,0,0,0,"AL",0.038
"8237",513,"198402.352.1400.3","NMFS",1984,4,19,110,30,43.233333,-70.216667,0,0,0,0,0,"AL",0.038
"8238",513,"198402.353.1270.4","NMFS",1984,4,19,110,30,43.283333,-70.116667,0,0,0,0,0,"AL",0.038
"8239",513,"198402.354.1400.2","NMFS",1984,4,19,110,30,43.483333,-70.066667,1,1,0,1,0,"AL",0.038
"8240",513,"198402.355.1400.1","NMFS",1984,4,19,110,30,43.566667,-69.733333,0,0,0,0,0,"AL",0.038
"8241",513,"198402.356.1380.2","NMFS",1984,4,19,110,30,43.35,-69.483333,0,0,0,0,0,"AL",0.038
"8242",512,"198402.357.1380.4","NMFS",1984,4,19,110,30,43.516667,-68.9,0,0,0,0,0,"AL",0.038
"8243",512,"198402.359.1380.1","NMFS",1984,4,19,110,30,43.666667,-68.7,0,0,0,0,0,"AL",0.038
"8244",512,"198402.360.1390.5","NMFS",1984,4,19,110,30,43.85,-68.583333,1,1,0,1,0,"AL",0.038
"8245",512,"198402.361.1380.3","NMFS",1984,4,20,111,30,43.733333,-68.433333,0,0,0,0,0,"AL",0.038
"8246",512,"198402.362.1380.5","NMFS",1984,4,20,111,30,43.483333,-68.25,0,0,0,0,0,"AL",0.038
"8247",512,"198402.363.1360.5","NMFS",1984,4,20,111,30,43.5,-67.766667,0,0,0,0,0,"AL",0.038
"8248",465,"198402.364.1360.1","NMFS",1984,4,20,111,30,43.466667,-67.583333,1,0,1,1,0,"AL",0.038
"8249",512,"198402.365.1360.8","NMFS",1984,4,20,111,30,43.633333,-67.8,1,1,0,1,0,"AL",0.038
"8250",511,"198402.366.1360.4","NMFS",1984,4,20,111,30,44.05,-67.583333,0,0,0,0,0,"AL",0.038
"8251",512,"198402.367.1390.2","NMFS",1984,4,20,111,30,44.133333,-67.916667,1,0,1,1,0,"AL",0.038
"8252",512,"198402.368.1390.3","NMFS",1984,4,20,111,30,44.25,-67.9,0,0,0,0,0,"AL",0.038
"8253",511,"198402.369.1390.1","NMFS",1984,4,20,111,30,44.266667,-67.733333,1,1,0,1,0,"AL",0.038
"8254",511,"198402.371.1350.1","NMFS",1984,4,21,112,30,44.116667,-66.966667,0,0,0,0,0,"AL",0.038
"8255",466,"198402.372.1330.4","NMFS",1984,4,21,112,30,44.116667,-66.6,1,0,1,1,0,"AL",0.038
"8256",511,"198402.374.1340.4","NMFS",1984,4,21,112,30,43.933333,-66.933333,0,0,0,0,0,"AL",0.038
"8257",465,"198402.375.1340.6","NMFS",1984,4,21,112,30,43.733333,-67.133333,0,0,0,0,0,"AL",0.038
"8258",465,"198402.376.1340.2","NMFS",1984,4,21,112,30,43.633333,-67.05,0,0,0,0,0,"AL",0.038
"8259",465,"198402.377.1340.1","NMFS",1984,4,21,112,30,43.65,-66.9,0,0,0,0,0,"AL",0.038
"8260",465,"198402.378.1330.1","NMFS",1984,4,21,112,30,43.733333,-66.516667,0,0,0,0,0,"AL",0.038
"8261",465,"198402.380.1330.5","NMFS",1984,4,21,112,23,43.583333,-66.433333,0,0,0,0,0,"AL",0.038
"8262",465,"198402.381.1340.5","NMFS",1984,4,21,112,30,43.25,-66.8,1,0,1,1,0,"AL",0.038
"8263",465,"198402.382.1340.3","NMFS",1984,4,22,113,30,43.066667,-66.866667,0,0,0,0,0,"AL",0.038
"8264",464,"198402.384.1360.9","NMFS",1984,4,22,113,30,42.883333,-66.783333,0,0,0,0,0,"AL",0.038
"8265",464,"198402.385.1310.2","NMFS",1984,4,22,113,30,42.616667,-66.75,0,0,0,0,0,"AL",0.038
"8266",464,"198402.386.1310.3","NMFS",1984,4,22,113,30,42.683333,-66.4,2,0,2,2,0,"AL",0.038
"8267",464,"198402.387.1320.1","NMFS",1984,4,23,114,30,42.733333,-66.266667,1,1,0,1,0,"AL",0.038
"8268",464,"198402.388.1320.4","NMFS",1984,4,23,114,30,42.716667,-66.05,0,0,0,0,0,"AL",0.038
"8269",464,"198402.389.1320.5","NMFS",1984,4,23,114,30,42.766667,-65.883333,1,1,0,1,0,"AL",0.038
"8270",464,"198402.390.1310.4","NMFS",1984,4,23,114,30,42.7,-65.8,0,0,0,0,0,"AL",0.038
"8271",464,"198402.391.1320.3","NMFS",1984,4,23,114,30,42.65,-65.616667,0,0,0,0,0,"AL",0.038
"8272",464,"198402.393.1320.2","NMFS",1984,4,23,114,30,42.466667,-65.633333,0,0,0,0,0,"AL",0.038
"8273",464,"198402.394.1290.6","NMFS",1984,4,23,114,30,42.316667,-65.783333,0,0,0,0,0,"AL",0.038
"8274",464,"198402.395.1310.5","NMFS",1984,4,23,114,30,42.5,-65.85,12,9,3,12,0,"AL",0.038
"8275",464,"198402.396.1290.2","NMFS",1984,4,23,114,30,42.483333,-66.016667,8,7,1,8,0,"AL",0.038
"8276",551,"198402.397.1290.1","NMFS",1984,4,23,114,30,42.216667,-66.45,0,0,0,0,0,"AL",0.038
"8277",464,"198402.398.1300.2","NMFS",1984,4,24,115,30,42.4,-66.75,0,0,0,0,0,"AL",0.038
"8278",464,"198402.399.1300.1","NMFS",1984,4,24,115,30,42.416667,-66.883333,0,0,0,0,0,"AL",0.038
"8279",464,"198402.400.1300.3","NMFS",1984,4,24,115,30,42.483333,-67.2,0,0,0,0,0,"AL",0.038
"8280",464,"198402.401.1290.5","NMFS",1984,4,24,115,30,42.683333,-67.516667,1,1,0,1,0,"AL",0.038
"8281",515,"198402.402.1360.2","NMFS",1984,4,24,115,30,42.8,-67.916667,0,0,0,0,0,"AL",0.038
"8282",515,"198402.403.1290.4","NMFS",1984,4,24,115,30,42.45,-67.95,0,0,0,0,0,"AL",0.038
"8283",515,"198402.404.1290.7","NMFS",1984,4,24,115,30,42.666667,-68.35,0,0,0,0,0,"AL",0.038
"8284",515,"198402.405.1360.6","NMFS",1984,4,24,115,30,42.95,-68.333333,0,0,0,0,0,"AL",0.038
"8285",515,"198402.407.1370.4","NMFS",1984,4,25,116,30,42.783333,-68.716667,0,0,0,0,0,"AL",0.038
"8286",526,"198405.215.3550.3","NMFS",1984,10,5,279,30,41.016667,-69.616667,1,1,0,1,0,"AL",0.038
"8287",526,"198405.216.3550.2","NMFS",1984,10,6,280,30,40.95,-69.5,0,0,0,0,0,"AL",0.038
"8288",526,"198405.217.1090.4","NMFS",1984,10,6,280,30,40.65,-69.633333,2,1,1,2,0,"AL",0.038
"8289",526,"198405.218.1090.3","NMFS",1984,10,6,280,30,40.65,-69.55,6,4,2,6,0,"AL",0.038
"8290",526,"198405.219.1100.6","NMFS",1984,10,6,280,30,40.466667,-69.483333,3,1,2,3,0,"AL",0.038
"8291",526,"198405.220.1100.3","NMFS",1984,10,6,280,30,40.533333,-69.8,4,1,3,4,0,"AL",0.038
"8292",526,"198405.226.1120.1","NMFS",1984,10,7,281,30,39.95,-69.983333,2,0,2,2,0,"AL",0.038
"8293",526,"198405.227.1110.3","NMFS",1984,10,7,281,30,40.033333,-69.7,0,0,0,0,0,"AL",0.038
"8294",526,"198405.228.1120.2","NMFS",1984,10,7,281,30,39.983333,-69.216667,10,6,4,8,2,"AL",0.038
"8295",525,"198405.229.1140.2","NMFS",1984,10,7,281,30,40.166667,-68.75,3,2,1,3,0,"AL",0.038
"8296",525,"198405.230.1150.2","NMFS",1984,10,7,281,30,40.133333,-68.6,3,1,2,2,1,"AL",0.038
"8297",525,"198405.231.1140.1","NMFS",1984,10,7,281,30,40.266667,-68.4,1,0,1,1,0,"AL",0.038
"8298",525,"198405.232.1130.8","NMFS",1984,10,7,281,30,40.383333,-68.683333,2,2,0,2,0,"AL",0.038
"8299",525,"198405.233.1130.3","NMFS",1984,10,7,281,30,40.516667,-68.683333,0,0,0,0,0,"AL",0.038
"8300",526,"198405.234.1100.4","NMFS",1984,10,7,281,30,40.483333,-69.033333,0,0,0,0,0,"AL",0.038
"8301",526,"198405.235.1100.7","NMFS",1984,10,7,281,30,40.683333,-69.183333,1,1,0,0,1,"AL",0.038
"8302",526,"198405.236.1100.5","NMFS",1984,10,7,281,30,40.816667,-69.016667,5,1,4,5,0,"AL",0.038
"8303",526,"198405.237.1130.2","NMFS",1984,10,8,282,30,40.816667,-68.866667,4,3,1,4,0,"AL",0.038
"8304",525,"198405.238.1190.1","NMFS",1984,10,8,282,30,40.95,-68.583333,0,0,0,0,0,"AL",0.038
"8305",525,"198405.239.1190.5","NMFS",1984,10,8,282,30,40.916667,-68.4,0,0,0,0,0,"AL",0.038
"8306",525,"198405.240.1190.6","NMFS",1984,10,8,282,30,40.8,-68.383333,2,0,2,2,0,"AL",0.038
"8307",525,"198405.241.1130.7","NMFS",1984,10,8,282,30,40.883333,-68.05,0,0,0,0,0,"AL",0.038
"8308",525,"198405.242.1130.1","NMFS",1984,10,8,282,30,40.883333,-67.7,0,0,0,0,0,"AL",0.038
"8309",525,"198405.243.1130.5","NMFS",1984,10,8,282,30,40.766667,-67.7,0,0,0,0,0,"AL",0.038
"8310",525,"198405.244.1130.4","NMFS",1984,10,8,282,30,40.733333,-67.816667,1,1,0,1,0,"AL",0.038
"8311",525,"198405.245.1150.1","NMFS",1984,10,8,282,30,40.4,-67.683333,0,0,0,0,0,"AL",0.038
"8312",525,"198405.246.1140.4","NMFS",1984,10,8,282,30,40.55,-67.2,0,0,0,0,0,"AL",0.038
"8313",525,"198405.247.1140.3","NMFS",1984,10,8,282,30,40.683333,-66.983333,0,0,0,0,0,"AL",0.038
"8314",562,"198405.248.1150.3","NMFS",1984,10,8,282,30,40.683333,-66.816667,0,0,0,0,0,"AL",0.038
"8315",525,"198405.249.1130.9","NMFS",1984,10,9,283,30,40.8,-67.233333,0,0,0,0,0,"AL",0.038
"8316",525,"198405.250.1130.6","NMFS",1984,10,9,283,30,41.05,-67.5,0,0,0,0,0,"AL",0.038
"8317",562,"198405.251.1190.3","NMFS",1984,10,9,283,30,41.3,-67.35,0,0,0,0,0,"AL",0.038
"8318",562,"198405.252.1160.9","NMFS",1984,10,9,283,30,41.1,-67.116667,0,0,0,0,0,"AL",0.038
"8319",562,"198405.253.1160.10","NMFS",1984,10,9,283,30,40.95,-66.8,0,0,0,0,0,"AL",0.038
"8320",562,"198405.254.1180.1","NMFS",1984,10,9,283,30,41.15,-66.316667,0,0,0,0,0,"AL",0.038
"8321",552,"198405.255.1160.8","NMFS",1984,10,9,283,30,41.333333,-66.4,0,0,0,0,0,"AL",0.038
"8322",552,"198405.256.1160.2","NMFS",1984,10,9,283,30,41.533333,-66.483333,1,1,0,1,0,"AL",0.038
"8323",552,"198405.257.1160.5","NMFS",1984,10,9,283,30,41.55,-66.4,4,4,0,4,0,"AL",0.038
"8324",552,"198405.258.1170.3","NMFS",1984,10,9,283,30,41.483333,-66.1,0,0,0,0,0,"AL",0.038
"8325",552,"198405.259.1180.3","NMFS",1984,10,10,284,30,41.65,-65.833333,0,0,0,0,0,"AL",0.038
"8326",552,"198405.260.1170.4","NMFS",1984,10,10,284,30,41.7,-65.866667,0,0,0,0,0,"AL",0.038
"8327",552,"198405.261.1160.6","NMFS",1984,10,10,284,30,41.766667,-65.983333,0,0,0,0,0,"AL",0.038
"8328",552,"198405.262.1160.7","NMFS",1984,10,10,284,30,41.75,-66.133333,0,0,0,0,0,"AL",0.038
"8329",551,"198405.263.1160.4","NMFS",1984,10,10,284,30,41.883333,-65.966667,0,0,0,0,0,"AL",0.038
"8330",551,"198405.264.1170.2","NMFS",1984,10,10,284,30,41.85,-65.8,0,0,0,0,0,"AL",0.038
"8331",551,"198405.265.1180.2","NMFS",1984,10,10,284,30,41.966667,-65.766667,0,0,0,0,0,"AL",0.038
"8332",551,"198405.266.1170.1","NMFS",1984,10,10,284,30,41.983333,-65.883333,0,0,0,0,0,"AL",0.038
"8333",551,"198405.267.1290.3","NMFS",1984,10,10,284,30,42.216667,-66.3,0,0,0,0,0,"AL",0.038
"8334",551,"198405.268.1210.2","NMFS",1984,10,10,284,30,42.116667,-66.483333,0,0,0,0,0,"AL",0.038
"8335",551,"198405.269.1160.3","NMFS",1984,10,10,284,30,41.916667,-66.466667,0,0,0,0,0,"AL",0.038
"8336",562,"198405.270.1190.8","NMFS",1984,10,10,284,30,41.8,-67,0,0,0,0,0,"AL",0.038
"8337",562,"198405.271.1160.1","NMFS",1984,10,10,284,30,41.6,-67.083333,0,0,0,0,0,"AL",0.038
"8338",562,"198405.272.1190.7","NMFS",1984,10,11,285,30,41.683333,-67.2,8,3,5,7,1,"AL",0.038
"8339",562,"198405.273.1190.2","NMFS",1984,10,11,285,30,41.716667,-67.5,3,2,1,2,1,"AL",0.038
"8340",522,"198405.274.1190.4","NMFS",1984,10,11,285,30,41.383333,-67.85,1,1,0,1,0,"AL",0.038
"8341",521,"198405.275.1230.2","NMFS",1984,10,11,285,30,41.05,-69.133333,0,0,0,0,0,"AL",0.038
"8342",521,"198405.276.1250.4","NMFS",1984,10,11,285,30,41.116667,-69.266667,0,0,0,0,0,"AL",0.038
"8343",521,"198405.277.1250.2","NMFS",1984,10,11,285,30,41.216667,-69.35,0,0,0,0,0,"AL",0.038
"8344",521,"198405.278.3550.1","NMFS",1984,10,11,285,30,41.333333,-69.55,16,11,5,14,2,"AL",0.038
"8345",521,"198405.279.1230.3","NMFS",1984,10,11,285,30,41.516667,-69.333333,0,0,0,0,0,"AL",0.038
"8346",521,"198405.281.1250.1","NMFS",1984,10,11,285,23,41.516667,-69.65,5,2,3,5,0,"AL",0.038
"8347",521,"198405.282.3550.4","NMFS",1984,10,11,285,30,41.516667,-69.816667,0,0,0,0,0,"AL",0.038
"8348",514,"198405.284.3580.2","NMFS",1984,10,16,290,30,41.766667,-70.3,0,0,0,0,0,"AL",0.038
"8349",514,"198405.285.3590.1","NMFS",1984,10,16,290,30,41.833333,-70.283333,10,1,9,9,1,"AL",0.038
"8350",514,"198405.286.3600.2","NMFS",1984,10,16,290,30,41.9,-70.3,15,6,9,10,5,"AL",0.038
"8351",514,"198405.287.3600.1","NMFS",1984,10,17,291,30,41.95,-70.25,2,1,1,2,0,"AL",0.038
"8352",514,"198405.288.3610.1","NMFS",1984,10,17,291,30,42.016667,-70.383333,17,9,8,16,1,"AL",0.038
"8353",514,"198405.289.3610.2","NMFS",1984,10,17,291,30,42.066667,-70.266667,0,0,0,0,0,"AL",0.038
"8354",514,"198405.290.1260.2","NMFS",1984,10,17,291,30,42.233333,-70.15,1,1,0,1,0,"AL",0.038
"8355",514,"198405.291.1270.1","NMFS",1984,10,17,291,30,42.283333,-70,0,0,0,0,0,"AL",0.038
"8356",521,"198405.292.1270.4","NMFS",1984,10,17,291,30,42.133333,-69.866667,0,0,0,0,0,"AL",0.038
"8357",521,"198405.293.1280.4","NMFS",1984,10,17,291,30,42.233333,-69.516667,0,0,0,0,0,"AL",0.038
"8358",521,"198405.294.1280.5","NMFS",1984,10,17,291,30,42.166667,-69.45,0,0,0,0,0,"AL",0.038
"8359",521,"198405.295.1240.2","NMFS",1984,10,17,291,30,42,-69.7,0,0,0,0,0,"AL",0.038
"8360",521,"198405.297.3560.2","NMFS",1984,10,17,291,30,41.733333,-69.883333,1,0,1,1,0,"AL",0.038
"8361",522,"198405.299.1230.1","NMFS",1984,10,18,292,30,41.266667,-68.566667,1,0,1,1,0,"AL",0.038
"8362",522,"198405.300.1190.9","NMFS",1984,10,18,292,30,41.2,-68.3,0,0,0,0,0,"AL",0.038
"8363",522,"198405.301.1200.1","NMFS",1984,10,18,292,30,41.316667,-68.233333,0,0,0,0,0,"AL",0.038
"8364",522,"198405.302.1230.4","NMFS",1984,10,18,292,30,41.4,-68.383333,1,1,0,1,0,"AL",0.038
"8365",522,"198405.303.1200.2","NMFS",1984,10,18,292,30,41.483333,-68.266667,0,0,0,0,0,"AL",0.038
"8366",522,"198405.304.1240.6","NMFS",1984,10,18,292,30,41.65,-68.6,0,0,0,0,0,"AL",0.038
"8367",521,"198405.305.1240.3","NMFS",1984,10,18,292,30,41.916667,-68.883333,0,0,0,0,0,"AL",0.038
"8368",522,"198405.306.1240.5","NMFS",1984,10,18,292,30,41.766667,-68.566667,0,0,0,0,0,"AL",0.038
"8369",522,"198405.307.1220.3","NMFS",1984,10,18,292,30,41.766667,-68.433333,0,0,0,0,0,"AL",0.038
"8370",522,"198405.309.1200.3","NMFS",1984,10,19,293,30,41.75,-67.983333,8,5,3,8,0,"AL",0.038
"8371",522,"198405.310.1200.4","NMFS",1984,10,19,293,30,41.666667,-67.833333,0,0,0,0,0,"AL",0.038
"8372",522,"198405.311.1210.4","NMFS",1984,10,19,293,30,41.85,-67.95,0,0,0,0,0,"AL",0.038
"8373",522,"198405.312.1220.2","NMFS",1984,10,19,293,30,41.933333,-68.016667,0,0,0,0,0,"AL",0.038
"8374",522,"198405.313.1210.1","NMFS",1984,10,19,293,30,41.966667,-67.816667,0,0,0,0,0,"AL",0.038
"8375",522,"198405.315.1220.4","NMFS",1984,10,19,293,30,42.1,-67.783333,0,0,0,0,0,"AL",0.038
"8376",561,"198405.317.1200.5","NMFS",1984,10,19,293,30,41.966667,-67.55,1,1,0,1,0,"AL",0.038
"8377",561,"198405.318.1200.6","NMFS",1984,10,19,293,30,41.916667,-67.316667,0,0,0,0,0,"AL",0.038
"8378",561,"198405.320.1220.1","NMFS",1984,10,19,293,30,42.15,-67.416667,0,0,0,0,0,"AL",0.038
"8379",561,"198405.321.1290.5","NMFS",1984,10,19,293,30,42.216667,-67.333333,0,0,0,0,0,"AL",0.038
"8380",551,"198405.323.1210.3","NMFS",1984,10,20,294,30,42.15,-67.116667,1,0,1,1,0,"AL",0.038
"8381",464,"198405.352.1290.6","NMFS",1984,10,22,296,30,42.166667,-65.866667,0,0,0,0,0,"AL",0.038
"8382",464,"198405.353.1290.8","NMFS",1984,10,22,296,30,42.283333,-65.85,0,0,0,0,0,"AL",0.038
"8383",464,"198405.354.1310.2","NMFS",1984,10,22,296,30,42.35,-65.7,0,0,0,0,0,"AL",0.038
"8384",464,"198405.357.1320.3","NMFS",1984,10,22,296,30,42.45,-65.616667,0,0,0,0,0,"AL",0.038
"8385",464,"198405.358.1310.6","NMFS",1984,10,22,296,30,42.516667,-65.566667,2,1,1,2,0,"AL",0.038
"8386",464,"198405.360.1320.1","NMFS",1984,10,22,296,23,42.666667,-65.6,0,0,0,0,0,"AL",0.038
"8387",464,"198405.361.1320.6","NMFS",1984,10,22,296,30,42.683333,-65.583333,0,0,0,0,0,"AL",0.038
"8388",464,"198405.363.1320.2","NMFS",1984,10,22,296,30,42.75,-65.983333,1,0,1,1,0,"AL",0.038
"8389",464,"198405.364.1320.5","NMFS",1984,10,22,296,22,42.75,-66.283333,4,0,4,4,0,"AL",0.038
"8390",464,"198405.365.1310.7","NMFS",1984,10,23,297,30,42.6,-66.466667,0,0,0,0,0,"AL",0.038
"8391",464,"198405.366.1310.5","NMFS",1984,10,23,297,30,42.666667,-66.683333,0,0,0,0,0,"AL",0.038
"8392",465,"198405.367.1340.6","NMFS",1984,10,23,297,30,43.066667,-66.866667,2,1,1,2,0,"AL",0.038
"8393",465,"198405.368.1360.4","NMFS",1984,10,23,297,30,43.366667,-67.083333,1,1,0,1,0,"AL",0.038
"8394",465,"198405.369.1330.4","NMFS",1984,10,23,297,30,43.45,-66.45,1,0,1,1,0,"AL",0.038
"8395",465,"198405.370.1330.2","NMFS",1984,10,23,297,30,43.583333,-66.433333,3,2,1,3,0,"AL",0.038
"8396",465,"198405.371.1330.3","NMFS",1984,10,23,297,30,43.7,-66.483333,4,3,1,4,0,"AL",0.038
"8397",465,"198405.372.1340.4","NMFS",1984,10,23,297,30,43.733333,-66.833333,3,2,1,3,0,"AL",0.038
"8398",465,"198405.373.1340.1","NMFS",1984,10,23,297,30,43.75,-66.933333,2,0,2,2,0,"AL",0.038
"8399",465,"198405.374.1340.3","NMFS",1984,10,23,297,30,43.783333,-67.016667,1,1,0,1,0,"AL",0.038
"8400",511,"198405.375.1340.5","NMFS",1984,10,23,297,30,43.9,-67.083333,0,0,0,0,0,"AL",0.038
"8401",465,"198405.376.1340.2","NMFS",1984,10,24,298,30,43.983333,-66.8,0,0,0,0,0,"AL",0.038
"8402",465,"198405.377.1330.1","NMFS",1984,10,24,298,30,43.95,-66.416667,12,6,6,12,0,"AL",0.038
"8403",466,"198405.378.1350.3","NMFS",1984,10,24,298,30,44.116667,-66.833333,0,0,0,0,0,"AL",0.038
"8404",511,"198405.379.1350.4","NMFS",1984,10,24,298,30,44.35,-67.05,2,0,2,2,0,"AL",0.038
"8405",511,"198405.380.1350.1","NMFS",1984,10,24,298,30,44.316667,-67.3,0,0,0,0,0,"AL",0.038
"8406",511,"198405.381.1350.2","NMFS",1984,10,24,298,30,44.2,-67.233333,0,0,0,0,0,"AL",0.038
"8407",512,"198405.382.1360.1","NMFS",1984,10,24,298,30,43.433333,-67.866667,0,0,0,0,0,"AL",0.038
"8408",512,"198405.383.1360.5","NMFS",1984,10,24,298,30,43.433333,-67.95,0,0,0,0,0,"AL",0.038
"8409",515,"198405.384.1360.3","NMFS",1984,10,25,299,30,43.3,-68.116667,1,1,0,1,0,"AL",0.038
"8410",515,"198405.385.1360.8","NMFS",1984,10,25,299,30,43.033333,-68.366667,0,0,0,0,0,"AL",0.038
"8411",515,"198405.386.1370.1","NMFS",1984,10,25,299,30,43.033333,-68.65,0,0,0,0,0,"AL",0.038
"8412",515,"198405.387.1370.5","NMFS",1984,10,25,299,30,42.783333,-68.783333,0,0,0,0,0,"AL",0.038
"8413",515,"198405.388.1280.7","NMFS",1984,10,25,299,30,42.55,-68.883333,0,0,0,0,0,"AL",0.038
"8414",522,"198405.389.1240.1","NMFS",1984,10,25,299,30,42.266667,-68.65,0,0,0,0,0,"AL",0.038
"8415",522,"198405.390.1240.4","NMFS",1984,10,25,299,30,42.133333,-68.416667,0,0,0,0,0,"AL",0.038
"8416",514,"198405.393.1260.4","NMFS",1984,10,30,304,30,42.3,-70.483333,1,1,0,1,0,"AL",0.038
"8417",514,"198405.395.1260.3","NMFS",1984,10,30,304,30,42.466667,-70.533333,1,1,0,1,0,"AL",0.038
"8418",514,"198405.396.1260.5","NMFS",1984,10,30,304,30,42.5,-70.183333,0,0,0,0,0,"AL",0.038
"8419",514,"198405.397.1280.1","NMFS",1984,10,30,304,30,42.6,-69.816667,0,0,0,0,0,"AL",0.038
"8420",515,"198405.398.1280.6","NMFS",1984,10,30,304,30,42.583333,-69.583333,1,1,0,1,0,"AL",0.038
"8421",515,"198405.399.1280.2","NMFS",1984,10,30,304,30,42.566667,-69.366667,0,0,0,0,0,"AL",0.038
"8422",515,"198405.400.1280.3","NMFS",1984,10,30,304,30,42.6,-69.166667,0,0,0,0,0,"AL",0.038
"8423",513,"198405.401.1370.2","NMFS",1984,10,31,305,30,42.933333,-69.45,0,0,0,0,0,"AL",0.038
"8424",513,"198405.402.1270.2","NMFS",1984,10,31,305,30,42.933333,-70.2,0,0,0,0,0,"AL",0.038
"8425",513,"198405.403.1270.3","NMFS",1984,10,31,305,30,43.116667,-70.316667,0,0,0,0,0,"AL",0.038
"8426",513,"198405.404.1400.2","NMFS",1984,10,31,305,30,43.216667,-70.216667,3,3,0,3,0,"AL",0.038
"8427",513,"198405.405.1400.3","NMFS",1984,10,31,305,30,43.433333,-70.166667,12,9,3,12,0,"AL",0.038
"8428",513,"198405.406.1380.1","NMFS",1984,10,31,305,30,43.366667,-69.95,0,0,0,0,0,"AL",0.038
"8429",513,"198405.410.1370.4","NMFS",1984,10,31,305,30,43.116667,-69.166667,0,0,0,0,0,"AL",0.038
"8430",515,"198405.411.1370.3","NMFS",1984,11,1,306,28,43.283333,-68.95,0,0,0,0,0,"AL",0.038
"8431",512,"198405.412.1380.2","NMFS",1984,11,1,306,30,43.466667,-69,0,0,0,0,0,"AL",0.038
"8432",512,"198405.415.1380.3","NMFS",1984,11,1,306,30,43.65,-68.65,0,0,0,0,0,"AL",0.038
"8433",512,"198405.416.1380.5","NMFS",1984,11,1,306,30,43.8,-68.15,0,0,0,0,0,"AL",0.038
"8434",512,"198405.417.1380.4","NMFS",1984,11,1,306,30,43.866667,-68.066667,0,0,0,0,0,"AL",0.038
"8435",512,"198405.418.1390.4","NMFS",1984,11,1,306,30,44.066667,-68.066667,3,3,0,3,0,"AL",0.038
"8436",512,"198405.419.1390.1","NMFS",1984,11,1,306,30,44.116667,-67.966667,3,2,1,3,0,"AL",0.038
"8437",511,"198405.420.1390.2","NMFS",1984,11,1,306,30,44.216667,-67.8,2,1,1,2,0,"AL",0.038
"8438",511,"198405.421.1390.3","NMFS",1984,11,1,306,30,44.266667,-67.716667,0,0,0,0,0,"AL",0.038
"8439",465,"198405.422.1360.7","NMFS",1984,11,2,307,30,43.283333,-67.566667,0,0,0,0,0,"AL",0.038
"8440",465,"198405.423.1360.6","NMFS",1984,11,2,307,30,43.25,-67.583333,0,0,0,0,0,"AL",0.038
"8441",464,"198405.424.1360.2","NMFS",1984,11,2,307,30,42.8,-67.633333,0,0,0,0,0,"AL",0.038
"8442",515,"198405.425.1290.4","NMFS",1984,11,2,307,30,42.433333,-68.216667,0,0,0,0,0,"AL",0.038
"8443",464,"198405.426.1290.2","NMFS",1984,11,2,307,30,42.383333,-67.633333,0,0,0,0,0,"AL",0.038
"8444",464,"198405.427.1300.3","NMFS",1984,11,2,307,30,42.45,-67.266667,0,0,0,0,0,"AL",0.038
"8445",464,"198405.428.1290.7","NMFS",1984,11,3,308,30,42.666667,-67.283333,0,0,0,0,0,"AL",0.038
"8446",464,"198405.429.1290.1","NMFS",1984,11,3,308,30,42.6,-66.95,2,1,1,2,0,"AL",0.038
"8447",464,"198405.430.1300.1","NMFS",1984,11,3,308,30,42.433333,-66.733333,0,0,0,0,0,"AL",0.038
"8448",464,"198405.431.1300.2","NMFS",1984,11,3,308,30,42.416667,-66.7,0,0,0,0,0,"AL",0.038
"8449",514,"198405.464.1400.4","NMFS",1984,11,6,311,30,42.766667,-70.55,1,0,1,1,0,"AL",0.038
"8450",514,"198405.465.3660.2","NMFS",1984,11,6,311,30,42.7,-70.483333,1,0,1,1,0,"AL",0.038
"8451",526,"198502.219.1090.5","NMFS",1985,3,23,82,30,40.766667,-69.75,0,0,0,0,0,"AL",0.038
"8452",526,"198502.220.1090.2","NMFS",1985,3,23,82,30,40.9,-69.6,0,0,0,0,0,"AL",0.038
"8453",526,"198502.221.3550.4","NMFS",1985,3,23,82,30,41.066667,-69.6,0,0,0,0,0,"AL",0.038
"8454",526,"198502.223.3550.3","NMFS",1985,3,23,82,30,40.983333,-69.55,0,0,0,0,0,"AL",0.038
"8455",526,"198502.225.1090.6","NMFS",1985,3,23,82,27,40.816667,-69.4,0,0,0,0,0,"AL",0.038
"8456",521,"198502.226.1250.4","NMFS",1985,3,23,82,30,41.033333,-69.283333,0,0,0,0,0,"AL",0.038
"8457",526,"198502.227.1100.1","NMFS",1985,3,23,82,30,40.95,-69.1,0,0,0,0,0,"AL",0.038
"8458",526,"198502.228.1100.2","NMFS",1985,3,23,82,30,40.633333,-69,0,0,0,0,0,"AL",0.038
"8459",526,"198502.229.1100.5","NMFS",1985,3,23,82,30,40.483333,-69.3,0,0,0,0,0,"AL",0.038
"8460",526,"198502.230.1100.4","NMFS",1985,3,23,82,30,40.6,-69.583333,1,0,1,1,0,"AL",0.038
"8461",526,"198502.231.1100.6","NMFS",1985,3,23,82,30,40.316667,-69.65,2,1,1,2,0,"AL",0.038
"8462",526,"198502.232.1120.1","NMFS",1985,3,24,83,30,40.05,-69.1,1,0,1,1,0,"AL",0.038
"8463",526,"198502.233.1100.7","NMFS",1985,3,24,83,30,40.316667,-68.933333,0,0,0,0,0,"AL",0.038
"8464",525,"198502.234.1150.1","NMFS",1985,3,24,83,20,40.133333,-68.616667,0,0,0,0,0,"AL",0.038
"8465",525,"198502.235.1140.2","NMFS",1985,3,24,83,30,40.283333,-68.483333,0,0,0,0,0,"AL",0.038
"8466",525,"198502.236.1130.3","NMFS",1985,3,24,83,30,40.633333,-68.716667,0,0,0,0,0,"AL",0.038
"8467",525,"198502.237.1130.1","NMFS",1985,3,24,83,30,40.65,-68.6,0,0,0,0,0,"AL",0.038
"8468",525,"198502.238.1190.9","NMFS",1985,3,24,83,30,40.683333,-68.583333,0,0,0,0,0,"AL",0.038
"8469",525,"198502.239.1130.7","NMFS",1985,3,24,83,30,40.633333,-68.366667,0,0,0,0,0,"AL",0.038
"8470",525,"198502.240.1190.3","NMFS",1985,3,24,83,30,40.833333,-68.65,0,0,0,0,0,"AL",0.038
"8471",525,"198502.241.1130.6","NMFS",1985,3,25,84,30,40.733333,-67.616667,0,0,0,0,0,"AL",0.038
"8472",525,"198502.242.1130.2","NMFS",1985,3,25,84,30,40.666667,-67.566667,0,0,0,0,0,"AL",0.038
"8473",525,"198502.243.1130.8","NMFS",1985,3,25,84,30,40.583333,-67.95,0,0,0,0,0,"AL",0.038
"8474",525,"198502.244.1140.1","NMFS",1985,3,25,84,30,40.35,-68,0,0,0,0,0,"AL",0.038
"8475",525,"198502.245.1150.2","NMFS",1985,3,25,84,30,40.333333,-67.816667,3,1,2,3,0,"AL",0.038
"8476",525,"198502.246.1140.3","NMFS",1985,3,25,84,30,40.5,-67.733333,0,0,0,0,0,"AL",0.038
"8477",525,"198502.247.1140.5","NMFS",1985,3,25,84,30,40.5,-67.383333,0,0,0,0,0,"AL",0.038
"8478",525,"198502.248.1140.4","NMFS",1985,3,25,84,30,40.6,-67.15,0,0,0,0,0,"AL",0.038
"8479",525,"198502.249.1130.9","NMFS",1985,3,26,85,30,40.866667,-67.2,0,0,0,0,0,"AL",0.038
"8480",562,"198502.250.1180.2","NMFS",1985,3,26,85,30,40.933333,-66.533333,0,0,0,0,0,"AL",0.038
"8481",562,"198502.252.1170.3","NMFS",1985,3,26,85,23,41.133333,-66.45,0,0,0,0,0,"AL",0.038
"8482",562,"198502.253.1160.2","NMFS",1985,3,26,85,30,41.3,-66.766667,0,0,0,0,0,"AL",0.038
"8483",562,"198502.254.1160.9","NMFS",1985,3,26,85,30,41.216667,-66.983333,0,0,0,0,0,"AL",0.038
"8484",562,"198502.255.1190.6","NMFS",1985,3,27,86,30,41.316667,-67.3,0,0,0,0,0,"AL",0.038
"8485",525,"198502.256.1130.4","NMFS",1985,3,27,86,30,41.15,-67.4,0,0,0,0,0,"AL",0.038
"8486",525,"198502.257.1130.5","NMFS",1985,3,27,86,30,41.066667,-67.6,1,0,1,1,0,"AL",0.038
"8487",525,"198502.258.1190.2","NMFS",1985,3,27,86,30,41.15,-67.65,0,0,0,0,0,"AL",0.038
"8488",522,"198502.259.1200.4","NMFS",1985,3,27,86,30,41.25,-68.533333,0,0,0,0,0,"AL",0.038
"8489",521,"198502.261.1230.5","NMFS",1985,3,27,86,30,41.283333,-69.166667,1,1,0,1,0,"AL",0.038
"8490",521,"198502.263.1250.2","NMFS",1985,3,27,86,20,41.433333,-69.55,0,0,0,0,0,"AL",0.038
"8491",521,"198502.264.3550.1","NMFS",1985,3,28,87,30,41.666667,-69.85,14,0,14,10,4,"AL",0.038
"8492",521,"198502.266.3560.1","NMFS",1985,3,28,87,30,41.983333,-69.983333,0,0,0,0,0,"AL",0.038
"8493",521,"198502.267.1230.2","NMFS",1985,3,28,87,30,42.033333,-69.916667,0,0,0,0,0,"AL",0.038
"8494",514,"198502.268.3610.1","NMFS",1985,3,28,87,30,42.116667,-70.083333,1,1,0,1,0,"AL",0.038
"8495",514,"198502.269.1260.1","NMFS",1985,3,28,87,30,42.25,-70.116667,0,0,0,0,0,"AL",0.038
"8496",514,"198502.271.1260.6","NMFS",1985,3,28,87,30,42.1,-70.333333,3,0,3,3,0,"AL",0.038
"8497",514,"198502.272.3610.2","NMFS",1985,3,28,87,30,42.066667,-70.45,9,5,4,9,0,"AL",0.038
"8498",514,"198502.274.3600.3","NMFS",1985,3,28,87,30,41.933333,-70.45,2,1,1,2,0,"AL",0.038
"8499",514,"198502.275.3600.2","NMFS",1985,3,28,87,30,41.883333,-70.333333,0,0,0,0,0,"AL",0.038
"8500",514,"198502.276.3590.1","NMFS",1985,3,28,87,30,41.816667,-70.333333,0,0,0,0,0,"AL",0.038
"8501",514,"198502.277.3580.1","NMFS",1985,3,28,87,30,41.866667,-70.183333,0,0,0,0,0,"AL",0.038
"8502",522,"198502.278.1230.1","NMFS",1985,4,2,92,30,41.4,-68.6,0,0,0,0,0,"AL",0.038
"8503",522,"198502.279.1230.3","NMFS",1985,4,2,92,30,41.433333,-68.433333,0,0,0,0,0,"AL",0.038
"8504",522,"198502.280.1200.1","NMFS",1985,4,2,92,30,41.5,-68.316667,2,0,2,2,0,"AL",0.038
"8505",522,"198502.281.1200.2","NMFS",1985,4,2,92,30,41.65,-68.3,0,0,0,0,0,"AL",0.038
"8506",522,"198502.282.1240.3","NMFS",1985,4,2,92,30,41.733333,-68.516667,0,0,0,0,0,"AL",0.038
"8507",522,"198502.283.1210.3","NMFS",1985,4,2,92,30,41.816667,-68.183333,0,0,0,0,0,"AL",0.038
"8508",522,"198502.285.1200.3","NMFS",1985,4,2,92,30,41.733333,-68.033333,1,0,1,1,0,"AL",0.038
"8509",522,"198502.286.1220.5","NMFS",1985,4,2,92,30,41.883333,-68.083333,3,2,1,3,0,"AL",0.038
"8510",522,"198502.287.1220.1","NMFS",1985,4,2,92,30,42.016667,-68.033333,1,0,1,1,0,"AL",0.038
"8511",522,"198502.288.1220.3","NMFS",1985,4,2,92,30,42.1,-67.75,3,1,2,3,0,"AL",0.038
"8512",561,"198502.289.1200.5","NMFS",1985,4,3,93,30,41.916667,-67.6,0,0,0,0,0,"AL",0.038
"8513",522,"198502.290.1200.6","NMFS",1985,4,3,93,30,41.733333,-67.833333,0,0,0,0,0,"AL",0.038
"8514",522,"198502.291.1190.4","NMFS",1985,4,3,93,30,41.35,-67.9,0,0,0,0,0,"AL",0.038
"8515",522,"198502.292.1190.5","NMFS",1985,4,3,93,30,41.416667,-67.716667,0,0,0,0,0,"AL",0.038
"8516",562,"198502.293.1190.7","NMFS",1985,4,3,93,30,41.633333,-67.466667,0,0,0,0,0,"AL",0.038
"8517",562,"198502.294.1190.1","NMFS",1985,4,3,93,30,41.666667,-67.416667,0,0,0,0,0,"AL",0.038
"8518",561,"198502.295.1190.8","NMFS",1985,4,3,93,30,41.916667,-67.15,1,0,1,1,0,"AL",0.038
"8519",551,"198502.296.1210.1","NMFS",1985,4,3,93,30,42.083333,-66.733333,0,0,0,0,0,"AL",0.038
"8520",551,"198502.297.1160.10","NMFS",1985,4,3,93,30,42.05,-66.683333,0,0,0,0,0,"AL",0.038
"8521",551,"198502.298.1160.4","NMFS",1985,4,3,93,30,41.883333,-66.65,0,0,0,0,0,"AL",0.038
"8522",552,"198502.299.1160.7","NMFS",1985,4,3,93,30,41.666667,-66.666667,0,0,0,0,0,"AL",0.038
"8523",562,"198502.300.1160.6","NMFS",1985,4,3,93,30,41.566667,-66.916667,0,0,0,0,0,"AL",0.038
"8524",552,"198502.301.1160.1","NMFS",1985,4,4,94,30,41.483333,-66.266667,0,0,0,0,0,"AL",0.038
"8525",552,"198502.302.1170.4","NMFS",1985,4,4,94,30,41.5,-66.033333,0,0,0,0,0,"AL",0.038
"8526",552,"198502.303.1160.8","NMFS",1985,4,4,94,30,41.616667,-66.033333,0,0,0,0,0,"AL",0.038
"8527",552,"198502.304.1170.2","NMFS",1985,4,4,94,30,41.7,-65.85,0,0,0,0,0,"AL",0.038
"8528",552,"198502.305.1160.3","NMFS",1985,4,4,94,30,41.816667,-66.166667,0,0,0,0,0,"AL",0.038
"8529",551,"198502.306.1180.3","NMFS",1985,4,4,94,30,41.95,-65.75,1,1,0,1,0,"AL",0.038
"8530",551,"198502.307.1170.1","NMFS",1985,4,4,94,30,41.966667,-65.916667,0,0,0,0,0,"AL",0.038
"8531",551,"198502.308.1160.5","NMFS",1985,4,4,94,30,42.033333,-66.266667,0,0,0,0,0,"AL",0.038
"8532",551,"198502.309.1210.2","NMFS",1985,4,4,94,30,42.116667,-66.166667,0,0,0,0,0,"AL",0.038
"8533",551,"198502.310.1220.2","NMFS",1985,4,4,94,30,42.15,-66.366667,0,0,0,0,0,"AL",0.038
"8534",551,"198502.311.1220.4","NMFS",1985,4,4,94,30,42.15,-66.666667,0,0,0,0,0,"AL",0.038
"8535",464,"198502.312.1300.1","NMFS",1985,4,5,95,30,42.416667,-66.766667,3,3,0,3,0,"AL",0.038
"8536",464,"198502.313.1300.3","NMFS",1985,4,5,95,30,42.433333,-67.266667,1,0,1,1,0,"AL",0.038
"8537",464,"198502.314.1300.2","NMFS",1985,4,5,95,20,42.583333,-67.25,2,2,0,2,0,"AL",0.038
"8538",464,"198502.315.1290.7","NMFS",1985,4,5,95,30,42.633333,-67.283333,0,0,0,0,0,"AL",0.038
"8539",464,"198502.316.1290.2","NMFS",1985,4,5,95,30,42.583333,-66.616667,0,0,0,0,0,"AL",0.038
"8540",464,"198502.317.1290.4","NMFS",1985,4,5,95,30,42.416667,-66.366667,1,1,0,1,0,"AL",0.038
"8541",464,"198502.318.1290.6","NMFS",1985,4,5,95,30,42.466667,-66.283333,1,0,1,1,0,"AL",0.038
"8542",464,"198502.319.1290.8","NMFS",1985,4,5,95,30,42.45,-66.016667,45,43,2,45,0,"AL",0.038
"8543",464,"198502.321.1290.5","NMFS",1985,4,5,95,30,42.4,-65.933333,16,14,2,16,0,"AL",0.038
"8544",464,"198502.322.1310.5","NMFS",1985,4,6,96,30,42.45,-65.8,1,0,1,1,0,"AL",0.038
"8545",464,"198502.323.1320.5","NMFS",1985,4,6,96,30,42.483333,-65.733333,0,0,0,0,0,"AL",0.038
"8546",464,"198502.326.1320.2","NMFS",1985,4,6,96,30,42.683333,-65.533333,0,0,0,0,0,"AL",0.038
"8547",464,"198502.328.1310.4","NMFS",1985,4,6,96,30,42.766667,-65.766667,0,0,0,0,0,"AL",0.038
"8548",464,"198502.331.1320.3","NMFS",1985,4,6,96,30,42.7,-66.066667,0,0,0,0,0,"AL",0.038
"8549",464,"198502.334.1340.6","NMFS",1985,4,7,97,27,42.966667,-66.916667,0,0,0,0,0,"AL",0.038
"8550",465,"198502.335.1340.1","NMFS",1985,4,7,97,20,43.15,-66.916667,0,0,0,0,0,"AL",0.038
"8551",465,"198502.337.1330.2","NMFS",1985,4,7,97,20,43.233333,-66.366667,0,0,0,0,0,"AL",0.038
"8552",465,"198502.338.1340.2","NMFS",1985,4,7,97,30,43.466667,-66.633333,0,0,0,0,0,"AL",0.038
"8553",465,"198502.339.1340.5","NMFS",1985,4,7,97,26,43.566667,-66.6,0,0,0,0,0,"AL",0.038
"8554",465,"198502.340.1330.3","NMFS",1985,4,7,97,30,43.65,-66.4,3,0,3,3,0,"AL",0.038
"8555",465,"198502.341.1330.1","NMFS",1985,4,8,98,30,43.95,-66.45,0,0,0,0,0,"AL",0.038
"8556",465,"198502.342.1340.3","NMFS",1985,4,8,98,30,43.816667,-66.8,0,0,0,0,0,"AL",0.038
"8557",511,"198502.343.1340.4","NMFS",1985,4,8,98,30,43.983333,-66.95,1,1,0,1,0,"AL",0.038
"8558",466,"198502.344.1350.2","NMFS",1985,4,8,98,20,44.066667,-66.8,0,0,0,0,0,"AL",0.038
"8559",511,"198502.345.1350.3","NMFS",1985,4,8,98,30,44.116667,-66.916667,0,0,0,0,0,"AL",0.038
"8560",511,"198502.346.1350.1","NMFS",1985,4,8,98,30,44.2,-67.116667,0,0,0,0,0,"AL",0.038
"8561",511,"198502.347.1390.1","NMFS",1985,4,8,98,30,44.366667,-67.65,0,0,0,0,0,"AL",0.038
"8562",512,"198502.348.1390.2","NMFS",1985,4,8,98,30,44.216667,-67.9,1,0,1,1,0,"AL",0.038
"8563",512,"198502.349.1390.4","NMFS",1985,4,8,98,30,44.166667,-68.05,0,0,0,0,0,"AL",0.038
"8564",512,"198502.350.1380.4","NMFS",1985,4,8,98,30,44.016667,-67.9,0,0,0,0,0,"AL",0.038
"8565",512,"198502.351.1380.5","NMFS",1985,4,9,99,30,43.7,-68.4,0,0,0,0,0,"AL",0.038
"8566",513,"198502.353.1380.1","NMFS",1985,4,9,99,30,43.383333,-69.4,0,0,0,0,0,"AL",0.038
"8567",513,"198502.354.1380.2","NMFS",1985,4,9,99,30,43.3,-69.916667,0,0,0,0,0,"AL",0.038
"8568",513,"198502.355.1270.2","NMFS",1985,4,9,99,30,43.25,-70.166667,0,0,0,0,0,"AL",0.038
"8569",513,"198502.356.1400.3","NMFS",1985,4,9,99,30,43.283333,-70.216667,1,0,1,1,0,"AL",0.038
"8570",513,"198502.357.1400.2","NMFS",1985,4,9,99,20,43.383333,-70.083333,1,0,1,1,0,"AL",0.038
"8571",513,"198502.358.1260.5","NMFS",1985,4,9,99,30,43.133333,-70.033333,2,2,0,2,0,"AL",0.038
"8572",513,"198502.359.1270.3","NMFS",1985,4,9,99,30,43.016667,-70.333333,0,0,0,0,0,"AL",0.038
"8573",513,"198502.360.1400.1","NMFS",1985,4,10,100,30,42.866667,-70.45,1,0,1,1,0,"AL",0.038
"8574",514,"198502.361.1270.1","NMFS",1985,4,10,100,30,42.733333,-70.116667,0,0,0,0,0,"AL",0.038
"8575",514,"198502.362.1270.4","NMFS",1985,4,10,100,30,42.683333,-70.116667,0,0,0,0,0,"AL",0.038
"8576",514,"198502.363.1260.4","NMFS",1985,4,10,100,30,42.666667,-70.333333,0,0,0,0,0,"AL",0.038
"8577",514,"198502.364.1260.2","NMFS",1985,4,10,100,30,42.583333,-70.4,2,0,2,2,0,"AL",0.038
"8578",514,"198502.365.3660.1","NMFS",1985,4,10,100,21,42.516667,-70.7,9,5,4,7,2,"AL",0.038
"8579",514,"198502.366.3650.2","NMFS",1985,4,10,100,30,42.333333,-70.733333,7,3,4,6,1,"AL",0.038
"8580",514,"198502.367.3650.1","NMFS",1985,4,10,100,20,42.233333,-70.583333,0,0,0,0,0,"AL",0.038
"8581",514,"198502.368.3660.2","NMFS",1985,4,10,100,30,42.25,-70.6,1,0,1,1,0,"AL",0.038
"8582",521,"198502.369.1280.1","NMFS",1985,4,10,100,30,42.283333,-69.9,0,0,0,0,0,"AL",0.038
"8583",521,"198502.370.1280.6","NMFS",1985,4,10,100,30,42.133333,-69.366667,0,0,0,0,0,"AL",0.038
"8584",521,"198502.371.1240.1","NMFS",1985,4,11,101,30,42.2,-69,0,0,0,0,0,"AL",0.038
"8585",522,"198502.372.1240.4","NMFS",1985,4,11,101,30,42.15,-68.683333,1,0,1,1,0,"AL",0.038
"8586",522,"198502.373.1240.5","NMFS",1985,4,11,101,20,42.116667,-68.566667,0,0,0,0,0,"AL",0.038
"8587",522,"198502.374.1240.2","NMFS",1985,4,11,101,30,42.316667,-68.616667,0,0,0,0,0,"AL",0.038
"8588",515,"198502.375.1280.3","NMFS",1985,4,11,101,30,42.533333,-68.666667,0,0,0,0,0,"AL",0.038
"8589",515,"198502.376.1280.4","NMFS",1985,4,11,101,30,42.5,-68.933333,0,0,0,0,0,"AL",0.038
"8590",515,"198502.377.1370.3","NMFS",1985,4,11,101,30,42.616667,-68.916667,0,0,0,0,0,"AL",0.038
"8591",515,"198502.378.1370.4","NMFS",1985,4,11,101,30,42.666667,-69.05,0,0,0,0,0,"AL",0.038
"8592",515,"198502.379.1280.2","NMFS",1985,4,11,101,30,42.616667,-69.316667,1,1,0,1,0,"AL",0.038
"8593",515,"198502.380.1370.2","NMFS",1985,4,11,101,30,42.766667,-69.4,0,0,0,0,0,"AL",0.038
"8594",515,"198502.381.1370.1","NMFS",1985,4,11,101,30,43.016667,-68.666667,0,0,0,0,0,"AL",0.038
"8595",515,"198502.382.1360.6","NMFS",1985,4,12,102,30,43.033333,-68.466667,1,1,0,1,0,"AL",0.038
"8596",515,"198502.383.1370.5","NMFS",1985,4,12,102,30,43.266667,-68.65,0,0,0,0,0,"AL",0.038
"8597",512,"198502.384.1380.3","NMFS",1985,4,12,102,28,43.416667,-68.516667,0,0,0,0,0,"AL",0.038
"8598",512,"198502.385.1360.4","NMFS",1985,4,12,102,30,43.733333,-67.883333,0,0,0,0,0,"AL",0.038
"8599",512,"198502.386.1360.3","NMFS",1985,4,12,102,30,43.816667,-67.683333,0,0,0,0,0,"AL",0.038
"8600",465,"198502.387.1360.5","NMFS",1985,4,12,102,30,43.6,-67.5,0,0,0,0,0,"AL",0.038
"8601",465,"198502.388.1360.1","NMFS",1985,4,12,102,30,43.233333,-67.516667,2,0,2,2,0,"AL",0.038
"8602",515,"198502.389.1360.2","NMFS",1985,4,12,102,30,42.983333,-67.933333,0,0,0,0,0,"AL",0.038
"8603",515,"198502.390.1290.1","NMFS",1985,4,12,102,30,42.716667,-68.45,0,0,0,0,0,"AL",0.038
"8604",515,"198502.391.1280.5","NMFS",1985,4,13,103,30,42.35,-69.183333,0,0,0,0,0,"AL",0.038
"8605",526,"198508.166.1110.1","NMFS",1985,10,18,291,30,40.1,-69.883333,0,0,0,0,0,"DE",0.038
"8606",526,"198508.178.1090.3","NMFS",1985,10,19,292,30,40.7,-69.95,5,3,2,3,2,"DE",0.038
"8607",526,"198508.179.1100.7","NMFS",1985,10,19,292,30,40.216667,-69.733333,0,0,0,0,0,"DE",0.038
"8608",526,"198508.180.1120.3","NMFS",1985,10,19,292,30,39.9,-69.716667,0,0,0,0,0,"DE",0.038
"8609",526,"198508.181.1110.3","NMFS",1985,10,19,292,30,40.066667,-69.8,0,0,0,0,0,"DE",0.038
"8610",526,"198508.182.1100.8","NMFS",1985,10,19,292,30,40.166667,-69.583333,2,1,1,2,0,"DE",0.038
"8611",526,"198508.183.1100.1","NMFS",1985,10,19,292,25,40.4,-69.183333,3,0,3,2,1,"DE",0.038
"8612",526,"198508.184.1110.2","NMFS",1985,10,19,292,30,40.216667,-69.016667,0,0,0,0,0,"DE",0.038
"8613",526,"198508.185.1100.4","NMFS",1985,10,20,293,30,40.25,-68.916667,1,0,1,1,0,"DE",0.038
"8614",526,"198508.186.1100.5","NMFS",1985,10,20,293,30,40.433333,-69,0,0,0,0,0,"DE",0.038
"8615",525,"198508.187.1130.7","NMFS",1985,10,20,293,30,40.55,-68.7,0,0,0,0,0,"DE",0.038
"8616",525,"198508.188.1130.5","NMFS",1985,10,20,293,30,40.583333,-68.383333,0,0,0,0,0,"DE",0.038
"8617",525,"198508.189.1140.4","NMFS",1985,10,20,293,30,40.366667,-68.35,0,0,0,0,0,"DE",0.038
"8618",525,"198508.190.1150.3","NMFS",1985,10,20,293,30,40.333333,-68.083333,0,0,0,0,0,"DE",0.038
"8619",525,"198508.191.1140.3","NMFS",1985,10,20,293,30,40.35,-67.983333,0,0,0,0,0,"DE",0.038
"8620",525,"198508.192.1130.6","NMFS",1985,10,20,293,30,40.533333,-68.066667,0,0,0,0,0,"DE",0.038
"8621",525,"198508.193.1130.1","NMFS",1985,10,20,293,30,40.516667,-67.883333,1,1,0,1,0,"DE",0.038
"8622",525,"198508.194.1150.1","NMFS",1985,10,20,293,30,40.4,-67.566667,0,0,0,0,0,"DE",0.038
"8623",525,"198508.195.1140.2","NMFS",1985,10,21,294,30,40.533333,-67.583333,0,0,0,0,0,"DE",0.038
"8624",525,"198508.196.1130.3","NMFS",1985,10,21,294,30,40.783333,-67.683333,1,1,0,1,0,"DE",0.038
"8625",525,"198508.197.1130.9","NMFS",1985,10,21,294,30,40.933333,-67.383333,0,0,0,0,0,"DE",0.038
"8626",525,"198508.198.1130.8","NMFS",1985,10,21,294,30,40.7,-67.25,3,3,0,3,0,"DE",0.038
"8627",525,"198508.200.1140.1","NMFS",1985,10,22,295,30,40.75,-66.866667,0,0,0,0,0,"DE",0.038
"8628",562,"198508.202.1190.8","NMFS",1985,10,22,295,30,41.566667,-67.316667,2,1,1,2,0,"DE",0.038
"8629",562,"198508.203.1190.4","NMFS",1985,10,22,295,30,41.833333,-67.066667,3,3,0,3,0,"DE",0.038
"8630",561,"198508.204.1200.4","NMFS",1985,10,22,295,30,41.933333,-67.466667,0,0,0,0,0,"DE",0.038
"8631",562,"198508.205.1190.9","NMFS",1985,10,22,295,20,41.666667,-67.5,1,0,1,1,0,"DE",0.038
"8632",562,"198508.206.1200.5","NMFS",1985,10,22,295,30,41.716667,-67.65,0,0,0,0,0,"DE",0.038
"8633",522,"198508.207.1200.6","NMFS",1985,10,22,295,30,41.783333,-67.766667,0,0,0,0,0,"DE",0.038
"8634",522,"198508.208.1190.5","NMFS",1985,10,22,295,30,41.416667,-67.916667,2,1,1,2,0,"DE",0.038
"8635",525,"198508.209.1190.2","NMFS",1985,10,23,296,30,41.15,-68.083333,4,0,4,4,0,"DE",0.038
"8636",522,"198508.210.1190.1","NMFS",1985,10,23,296,30,41.25,-68.233333,1,1,0,1,0,"DE",0.038
"8637",522,"198508.211.1200.2","NMFS",1985,10,23,296,30,41.416667,-68.15,1,0,1,1,0,"DE",0.038
"8638",522,"198508.212.1200.1","NMFS",1985,10,23,296,30,41.45,-68.25,0,0,0,0,0,"DE",0.038
"8639",522,"198508.213.1230.1","NMFS",1985,10,23,296,30,41.366667,-68.416667,1,0,1,1,0,"DE",0.038
"8640",522,"198508.214.1230.4","NMFS",1985,10,23,296,30,41.55,-68.483333,1,1,0,1,0,"DE",0.038
"8641",522,"198508.215.1240.6","NMFS",1985,10,23,296,30,41.566667,-68.7,0,0,0,0,0,"DE",0.038
"8642",522,"198508.217.1190.6","NMFS",1985,10,23,296,30,41.083333,-68.533333,0,0,0,0,0,"DE",0.038
"8643",525,"198508.218.1190.7","NMFS",1985,10,23,296,30,40.866667,-68.433333,0,0,0,0,0,"DE",0.038
"8644",521,"198508.221.3520.4","NMFS",1985,10,24,297,30,41.4,-69.716667,0,0,0,0,0,"DE",0.038
"8645",521,"198508.222.1250.1","NMFS",1985,10,24,297,30,41.433333,-69.333333,0,0,0,0,0,"DE",0.038
"8646",521,"198508.223.1230.2","NMFS",1985,10,24,297,30,41.333333,-69.266667,0,0,0,0,0,"DE",0.038
"8647",521,"198508.224.1240.5","NMFS",1985,10,24,297,30,41.283333,-68.966667,0,0,0,0,0,"DE",0.038
"8648",521,"198508.225.1230.5","NMFS",1985,10,24,297,30,41.183333,-68.95,0,0,0,0,0,"DE",0.038
"8649",521,"198508.226.1230.3","NMFS",1985,10,24,297,30,41.066667,-68.85,2,1,1,2,0,"DE",0.038
"8650",525,"198508.227.1130.4","NMFS",1985,10,25,298,30,40.816667,-68.75,1,1,0,1,0,"DE",0.038
"8651",526,"198508.228.1130.2","NMFS",1985,10,25,298,30,40.883333,-68.85,2,0,2,2,0,"DE",0.038
"8652",526,"198508.229.1100.6","NMFS",1985,10,25,298,30,40.983333,-68.916667,2,1,1,2,0,"DE",0.038
"8653",521,"198508.230.1250.3","NMFS",1985,10,25,298,30,41.05,-69.2,1,1,0,1,0,"DE",0.038
"8654",526,"198508.231.3550.1","NMFS",1985,10,25,298,30,40.916667,-69.533333,0,0,0,0,0,"DE",0.038
"8655",526,"198508.232.3550.2","NMFS",1985,10,25,298,30,40.983333,-69.566667,0,0,0,0,0,"DE",0.038
"8656",526,"198508.233.3550.3","NMFS",1985,10,25,298,30,41,-69.716667,0,0,0,0,0,"DE",0.038
"8657",526,"198508.234.3520.1","NMFS",1985,10,25,298,30,40.85,-69.883333,0,0,0,0,0,"DE",0.038
"8658",526,"198508.235.3520.3","NMFS",1985,10,25,298,30,40.933333,-69.983333,0,0,0,0,0,"DE",0.038
"8659",526,"198508.236.3520.2","NMFS",1985,10,25,298,30,40.983333,-69.916667,0,0,0,0,0,"DE",0.038
"8660",521,"198508.275.1240.1","NMFS",1985,10,23,296,30,41.933333,-69.583333,0,0,0,0,0,"AL",0.038
"8661",521,"198508.276.1280.7","NMFS",1985,10,23,296,30,41.95,-69.466667,0,0,0,0,0,"AL",0.038
"8662",521,"198508.277.1280.1","NMFS",1985,10,23,296,30,42.033333,-69.233333,1,1,0,1,0,"AL",0.038
"8663",521,"198508.278.1240.3","NMFS",1985,10,23,296,30,42.183333,-68.933333,0,0,0,0,0,"AL",0.038
"8664",522,"198508.279.1240.2","NMFS",1985,10,23,296,30,42.25,-68.833333,0,0,0,0,0,"AL",0.038
"8665",521,"198508.280.1280.5","NMFS",1985,10,23,296,30,42.333333,-68.866667,0,0,0,0,0,"AL",0.038
"8666",522,"198508.281.1240.4","NMFS",1985,10,23,296,30,42.2,-68.616667,0,0,0,0,0,"AL",0.038
"8667",522,"198508.282.1210.2","NMFS",1985,10,23,296,30,41.816667,-68.116667,0,0,0,0,0,"AL",0.038
"8668",522,"198508.283.1220.4","NMFS",1985,10,23,296,30,41.9,-68.15,0,0,0,0,0,"AL",0.038
"8669",522,"198508.284.1220.2","NMFS",1985,10,23,296,30,42.033333,-67.983333,0,0,0,0,0,"AL",0.038
"8670",522,"198508.285.1210.3","NMFS",1985,10,24,297,30,42,-67.8,0,0,0,0,0,"AL",0.038
"8671",522,"198508.286.1220.3","NMFS",1985,10,24,297,30,42.066667,-67.783333,0,0,0,0,0,"AL",0.038
"8672",561,"198508.287.1290.4","NMFS",1985,10,24,297,30,42.233333,-67.65,0,0,0,0,0,"AL",0.038
"8673",551,"198508.288.1220.1","NMFS",1985,10,24,297,30,42.2,-67.066667,0,0,0,0,0,"AL",0.038
"8674",551,"198508.289.1210.1","NMFS",1985,10,24,297,30,42.15,-66.983333,0,0,0,0,0,"AL",0.038
"8675",551,"198508.290.1160.6","NMFS",1985,10,24,297,30,41.95,-66.616667,0,0,0,0,0,"AL",0.038
"8676",552,"198508.291.1160.7","NMFS",1985,10,24,297,30,41.566667,-66.55,5,4,1,5,0,"AL",0.038
"8677",562,"198508.292.1160.5","NMFS",1985,10,24,297,30,41.383333,-66.766667,1,1,0,1,0,"AL",0.038
"8678",562,"198508.293.1160.9","NMFS",1985,10,24,297,30,41.383333,-66.883333,0,0,0,0,0,"AL",0.038
"8679",562,"198508.294.1160.1","NMFS",1985,10,24,297,30,41.333333,-66.983333,0,0,0,0,0,"AL",0.038
"8680",562,"198508.295.1160.10","NMFS",1985,10,24,297,30,41.133333,-66.983333,0,0,0,0,0,"AL",0.038
"8681",562,"198508.296.1160.4","NMFS",1985,10,24,297,30,41.25,-66.766667,0,0,0,0,0,"AL",0.038
"8682",552,"198508.297.1160.8","NMFS",1985,10,25,298,30,41.383333,-66.416667,2,2,0,1,1,"AL",0.038
"8683",552,"198508.298.1180.1","NMFS",1985,10,25,298,30,41.316667,-66.183333,2,2,0,2,0,"AL",0.038
"8684",552,"198508.299.1170.3","NMFS",1985,10,25,298,30,41.4,-66.133333,2,2,0,2,0,"AL",0.038
"8685",552,"198508.300.1180.3","NMFS",1985,10,25,298,30,41.466667,-65.95,0,0,0,0,0,"AL",0.038
"8686",552,"198508.301.1170.2","NMFS",1985,10,25,298,30,41.633333,-65.9,0,0,0,0,0,"AL",0.038
"8687",552,"198508.302.1160.3","NMFS",1985,10,25,298,30,41.75,-66,0,0,0,0,0,"AL",0.038
"8688",552,"198508.303.1170.4","NMFS",1985,10,25,298,30,41.733333,-65.866667,0,0,0,0,0,"AL",0.038
"8689",552,"198508.304.1180.2","NMFS",1985,10,25,298,30,41.833333,-65.7,0,0,0,0,0,"AL",0.038
"8690",551,"198508.305.1170.1","NMFS",1985,10,25,298,30,41.9,-65.816667,0,0,0,0,0,"AL",0.038
"8691",551,"198508.306.1160.2","NMFS",1985,10,25,298,30,42,-66.233333,0,0,0,0,0,"AL",0.038
"8692",551,"198508.307.1210.4","NMFS",1985,10,25,298,30,42.116667,-66.166667,0,0,0,0,0,"AL",0.038
"8693",551,"198508.309.1290.1","NMFS",1985,10,26,299,30,42.183333,-66.35,0,0,0,0,0,"AL",0.038
"8694",515,"198508.311.1280.6","NMFS",1985,10,31,304,30,42.366667,-69.466667,0,0,0,0,0,"AL",0.038
"8695",515,"198508.312.1280.4","NMFS",1985,10,31,304,30,42.566667,-69.483333,0,0,0,0,0,"AL",0.038
"8696",515,"198508.313.1280.3","NMFS",1985,10,31,304,30,42.666667,-69.383333,0,0,0,0,0,"AL",0.038
"8697",515,"198508.314.1280.2","NMFS",1985,10,31,304,30,42.533333,-68.9,0,0,0,0,0,"AL",0.038
"8698",515,"198508.315.1370.4","NMFS",1985,10,31,304,30,42.6,-68.816667,0,0,0,0,0,"AL",0.038
"8699",515,"198508.316.1290.3","NMFS",1985,10,31,304,30,42.616667,-67.8,0,0,0,0,0,"AL",0.038
"8700",515,"198508.317.1290.2","NMFS",1985,10,31,304,30,42.4,-67.866667,0,0,0,0,0,"AL",0.038
"8701",464,"198508.318.1300.1","NMFS",1985,11,1,305,30,42.416667,-67.333333,0,0,0,0,0,"AL",0.038
"8702",464,"198508.319.1300.3","NMFS",1985,11,1,305,30,42.366667,-67.016667,0,0,0,0,0,"AL",0.038
"8703",464,"198508.320.1300.2","NMFS",1985,11,1,305,30,42.366667,-66.716667,0,0,0,0,0,"AL",0.038
"8704",464,"198508.321.1290.5","NMFS",1985,11,1,305,30,42.483333,-66.283333,1,0,1,1,0,"AL",0.038
"8705",464,"198508.322.1310.4","NMFS",1985,11,1,305,30,42.533333,-66.066667,0,0,0,0,0,"AL",0.038
"8706",464,"198508.323.1320.3","NMFS",1985,11,1,305,30,42.516667,-65.733333,2,1,1,2,0,"AL",0.038
"8707",464,"198508.330.1320.5","NMFS",1985,11,2,306,30,42.816667,-65.883333,0,0,0,0,0,"AL",0.038
"8708",464,"198508.332.1320.6","NMFS",1985,11,2,306,30,42.766667,-66.1,1,1,0,1,0,"AL",0.038
"8709",464,"198508.333.1320.2","NMFS",1985,11,2,306,30,42.683333,-66.316667,2,2,0,2,0,"AL",0.038
"8710",464,"198508.334.1310.8","NMFS",1985,11,2,306,30,42.716667,-66.433333,0,0,0,0,0,"AL",0.038
"8711",464,"198508.335.1310.2","NMFS",1985,11,2,306,30,42.85,-66.583333,0,0,0,0,0,"AL",0.038
"8712",464,"198508.336.1360.8","NMFS",1985,11,3,307,30,42.966667,-66.766667,0,0,0,0,0,"AL",0.038
"8713",465,"198508.338.1340.7","NMFS",1985,11,3,307,30,43.066667,-66.85,1,0,1,1,0,"AL",0.038
"8714",465,"198508.339.1340.6","NMFS",1985,11,3,307,30,43.166667,-66.983333,1,0,1,1,0,"AL",0.038
"8715",465,"198508.340.1340.1","NMFS",1985,11,3,307,21,43.183333,-66.766667,2,1,1,2,0,"AL",0.038
"8716",465,"198508.342.1330.1","NMFS",1985,11,3,307,30,43.5,-66.416667,5,1,4,5,0,"AL",0.038
"8717",466,"198508.344.1330.4","NMFS",1985,11,4,308,30,44.166667,-66.55,6,3,3,6,0,"AL",0.038
"8718",466,"198508.345.1350.3","NMFS",1985,11,4,308,30,44.483333,-66.3,0,0,0,0,0,"AL",0.038
"8719",466,"198508.346.1350.1","NMFS",1985,11,4,308,30,44.666667,-66.2,1,1,0,1,0,"AL",0.038
"8720",467,"198508.347.1350.4","NMFS",1985,11,4,308,30,44.733333,-66.533333,0,0,0,0,0,"AL",0.038
"8721",466,"198508.348.1350.2","NMFS",1985,11,4,308,30,44.333333,-66.683333,0,0,0,0,0,"AL",0.038
"8722",511,"198508.349.3900.1","NMFS",1985,11,4,308,30,44.416667,-67.166667,3,2,1,3,0,"AL",0.038
"8723",511,"198508.350.3900.2","NMFS",1985,11,4,308,30,44.6,-67.1,5,0,5,5,0,"AL",0.038
"8724",511,"198508.351.3890.1","NMFS",1985,11,4,308,30,44.516667,-67.433333,10,5,5,10,0,"AL",0.038
"8725",511,"198508.352.1340.5","NMFS",1985,11,5,309,30,44.083333,-67.266667,3,2,1,3,0,"AL",0.038
"8726",511,"198508.353.1340.4","NMFS",1985,11,5,309,30,44.033333,-67.05,1,1,0,1,0,"AL",0.038
"8727",511,"198508.354.1340.2","NMFS",1985,11,5,309,30,43.966667,-67.066667,2,2,0,2,0,"AL",0.038
"8728",465,"198508.355.1360.1","NMFS",1985,11,5,309,30,43.616667,-67.466667,0,0,0,0,0,"AL",0.038
"8729",465,"198508.356.1360.4","NMFS",1985,11,5,309,30,43.266667,-67.516667,0,0,0,0,0,"AL",0.038
"8730",515,"198508.357.1360.5","NMFS",1985,11,5,309,30,43.25,-67.95,1,0,1,1,0,"AL",0.038
"8731",515,"198508.358.1360.3","NMFS",1985,11,5,309,22,43.166667,-68.1,0,0,0,0,0,"AL",0.038
"8732",515,"198508.359.1360.6","NMFS",1985,11,6,310,30,42.883333,-68,0,0,0,0,0,"AL",0.038
"8733",515,"198508.360.1360.7","NMFS",1985,11,6,310,30,42.9,-68.266667,0,0,0,0,0,"AL",0.038
"8734",515,"198508.361.1360.2","NMFS",1985,11,6,310,30,43.15,-68.416667,0,0,0,0,0,"AL",0.038
"8735",512,"198508.362.1380.3","NMFS",1985,11,6,310,30,43.4,-68.55,0,0,0,0,0,"AL",0.038
"8736",512,"198508.363.1380.1","NMFS",1985,11,6,310,30,43.95,-68.233333,3,3,0,3,0,"AL",0.038
"8737",512,"198508.364.1390.4","NMFS",1985,11,6,310,30,44.1,-68.016667,5,3,2,5,0,"AL",0.038
"8738",512,"198508.365.1390.1","NMFS",1985,11,6,310,30,43.916667,-68.366667,2,1,1,2,0,"AL",0.038
"8739",512,"198508.366.1390.2","NMFS",1985,11,7,311,30,43.783333,-68.583333,3,3,0,3,0,"AL",0.038
"8740",512,"198508.367.1390.5","NMFS",1985,11,7,311,30,43.766667,-68.75,2,0,2,2,0,"AL",0.038
"8741",513,"198508.368.1370.5","NMFS",1985,11,7,311,30,43.233333,-69.116667,0,0,0,0,0,"AL",0.038
"8742",515,"198508.369.1370.1","NMFS",1985,11,7,311,30,43.1,-68.816667,0,0,0,0,0,"AL",0.038
"8743",515,"198508.370.1370.2","NMFS",1985,11,7,311,30,42.966667,-68.833333,0,0,0,0,0,"AL",0.038
"8744",521,"198508.374.1250.2","NMFS",1985,11,8,312,30,41.816667,-69.866667,3,0,3,2,1,"AL",0.038
"8745",521,"198508.375.1250.4","NMFS",1985,11,8,312,30,41.666667,-69.833333,32,15,17,26,6,"AL",0.038
"8746",514,"198508.376.3580.1","NMFS",1985,11,12,316,30,41.766667,-70.266667,0,0,0,0,0,"AL",0.038
"8747",514,"198508.377.3590.1","NMFS",1985,11,13,317,30,41.783333,-70.35,13,0,13,11,2,"AL",0.038
"8748",514,"198508.378.3600.1","NMFS",1985,11,13,317,30,41.883333,-70.383333,53,21,32,39,14,"AL",0.038
"8749",514,"198508.379.3600.2","NMFS",1985,11,13,317,30,41.9,-70.283333,13,2,11,12,1,"AL",0.038
"8750",514,"198508.381.3610.2","NMFS",1985,11,13,317,30,42.116667,-70.15,12,9,3,12,0,"AL",0.038
"8751",521,"198508.382.1270.4","NMFS",1985,11,13,317,30,42.15,-69.966667,0,0,0,0,0,"AL",0.038
"8752",514,"198508.383.1260.2","NMFS",1985,11,13,317,20,42.4,-70.083333,0,0,0,0,0,"AL",0.038
"8753",514,"198508.385.1260.1","NMFS",1985,11,13,317,30,42.433333,-70.1,0,0,0,0,0,"AL",0.038
"8754",514,"198508.386.1260.4","NMFS",1985,11,13,317,30,42.2,-70.4,24,15,9,24,0,"AL",0.038
"8755",514,"198508.388.3660.1","NMFS",1985,11,13,317,20,42.25,-70.55,12,9,3,12,0,"AL",0.038
"8756",514,"198508.389.3650.1","NMFS",1985,11,13,317,20,42.283333,-70.666667,67,28,39,66,1,"AL",0.038
"8757",514,"198508.390.3640.1","NMFS",1985,11,13,317,20,42.3,-70.75,200,90,110,186,14,"AL",0.038
"8758",514,"198508.391.3650.2","NMFS",1985,11,14,318,20,42.416667,-70.816667,154,61,93,140,14,"AL",0.038
"8759",514,"198508.392.1260.3","NMFS",1985,11,14,318,30,42.466667,-70.533333,1,1,0,1,0,"AL",0.038
"8760",514,"198508.393.1270.1","NMFS",1985,11,14,318,30,42.833333,-70.066667,0,0,0,0,0,"AL",0.038
"8761",513,"198508.394.1260.5","NMFS",1985,11,14,318,30,42.883333,-70.116667,0,0,0,0,0,"AL",0.038
"8762",513,"198508.395.1270.3","NMFS",1985,11,14,318,30,43.033333,-69.983333,0,0,0,0,0,"AL",0.038
"8763",513,"198508.396.1370.3","NMFS",1985,11,14,318,30,43.116667,-69.616667,1,1,0,1,0,"AL",0.038
"8764",513,"198508.397.1380.4","NMFS",1985,11,14,318,30,43.516667,-69.3,2,2,0,2,0,"AL",0.038
"8765",512,"198508.398.1390.3","NMFS",1985,11,14,318,22,43.75,-68.883333,30,18,12,25,5,"AL",0.038
"8766",513,"198508.399.1380.5","NMFS",1985,11,15,319,20,43.6,-69.45,1,1,0,1,0,"AL",0.038
"8767",513,"198508.400.1380.2","NMFS",1985,11,15,319,30,43.383333,-69.816667,0,0,0,0,0,"AL",0.038
"8768",513,"198508.401.1400.1","NMFS",1985,11,15,319,30,43.3,-70.166667,2,2,0,2,0,"AL",0.038
"8769",513,"198508.402.1270.2","NMFS",1985,11,15,319,30,43.216667,-70.066667,1,1,0,1,0,"AL",0.038
"8770",513,"198508.403.1400.3","NMFS",1985,11,15,319,30,42.95,-70.4,0,0,0,0,0,"AL",0.038
"8771",514,"198508.404.1400.2","NMFS",1985,11,15,319,30,42.75,-70.566667,2,1,1,1,1,"AL",0.038
"8772",514,"198508.405.3660.2","NMFS",1985,11,15,319,30,42.75,-70.65,69,36,33,68,1,"AL",0.038
"8773",526,"198603.189.1120.1","NMFS",1986,4,1,91,20,39.933333,-69.866667,0,0,0,0,0,"AL",0.038
"8774",526,"198603.190.1110.1","NMFS",1986,4,1,91,30,40.05,-69.916667,1,1,0,0,1,"AL",0.038
"8775",526,"198603.191.1100.6","NMFS",1986,4,1,91,30,40.316667,-69.75,14,4,10,14,0,"AL",0.038
"8776",526,"198603.192.1100.3","NMFS",1986,4,1,91,30,40.316667,-69.45,2,0,2,2,0,"AL",0.038
"8777",521,"198603.193.1250.3","NMFS",1986,4,2,92,30,41.033333,-69.233333,0,0,0,0,0,"AL",0.038
"8778",521,"198603.194.1250.1","NMFS",1986,4,2,92,20,41.116667,-69.233333,0,0,0,0,0,"AL",0.038
"8779",521,"198603.195.1250.4","NMFS",1986,4,2,92,22.5,41.5,-69.533333,7,1,6,7,0,"AL",0.038
"8780",521,"198603.196.3550.3","NMFS",1986,4,2,92,30,41.533333,-69.75,2,0,2,2,0,"AL",0.038
"8781",521,"198603.197.3550.1","NMFS",1986,4,2,92,30,41.383333,-69.7,0,0,0,0,0,"AL",0.038
"8782",526,"198603.198.3550.5","NMFS",1986,4,2,92,30,41,-69.733333,1,0,1,1,0,"AL",0.038
"8783",526,"198603.199.3550.2","NMFS",1986,4,2,92,30,41.033333,-69.633333,0,0,0,0,0,"AL",0.038
"8784",521,"198603.200.3550.4","NMFS",1986,4,2,92,30,41.166667,-69.55,0,0,0,0,0,"AL",0.038
"8785",521,"198603.211.1250.2","NMFS",1986,4,8,98,30,41.6,-69.65,0,0,0,0,0,"AL",0.038
"8786",521,"198603.212.1240.5","NMFS",1986,4,8,98,30,41.616667,-69.2,2,1,1,2,0,"AL",0.038
"8787",521,"198603.213.1240.1","NMFS",1986,4,8,98,30,41.733333,-69.133333,0,0,0,0,0,"AL",0.038
"8788",521,"198603.214.1280.7","NMFS",1986,4,8,98,30,41.866667,-69.316667,0,0,0,0,0,"AL",0.038
"8789",522,"198603.215.1240.6","NMFS",1986,4,8,98,30,41.816667,-68.7,0,0,0,0,0,"AL",0.038
"8790",522,"198603.216.1220.2","NMFS",1986,4,8,98,30,41.716667,-68.4,0,0,0,0,0,"AL",0.038
"8791",522,"198603.217.1230.5","NMFS",1986,4,8,98,30,41.5,-68.433333,0,0,0,0,0,"AL",0.038
"8792",522,"198603.218.1200.3","NMFS",1986,4,8,98,30,41.25,-68.416667,1,1,0,1,0,"AL",0.038
"8793",522,"198603.219.1230.4","NMFS",1986,4,8,98,30,41.333333,-68.65,0,0,0,0,0,"AL",0.038
"8794",521,"198603.220.1240.3","NMFS",1986,4,9,99,30,41.483333,-68.883333,1,1,0,1,0,"AL",0.038
"8795",521,"198603.221.1240.4","NMFS",1986,4,9,99,30,41.366667,-69.116667,1,1,0,1,0,"AL",0.038
"8796",522,"198603.222.1230.2","NMFS",1986,4,9,99,30,41.15,-68.783333,0,0,0,0,0,"AL",0.038
"8797",521,"198603.223.1230.3","NMFS",1986,4,9,99,30,41.133333,-68.85,1,0,1,1,0,"AL",0.038
"8798",521,"198603.224.1230.1","NMFS",1986,4,9,99,30,41.016667,-69.016667,0,0,0,0,0,"AL",0.038
"8799",526,"198603.225.1130.1","NMFS",1986,4,9,99,23.5,40.933333,-68.85,0,0,0,0,0,"AL",0.038
"8800",525,"198603.226.1130.9","NMFS",1986,4,9,99,30,40.816667,-68.816667,0,0,0,0,0,"AL",0.038
"8801",526,"198603.227.1100.1","NMFS",1986,4,9,99,30,40.566667,-69.216667,0,0,0,0,0,"AL",0.038
"8802",526,"198603.228.1120.3","NMFS",1986,4,9,99,30,40.016667,-69.116667,5,2,3,2,3,"AL",0.038
"8803",526,"198603.229.1110.2","NMFS",1986,4,9,99,30,40.166667,-68.966667,0,0,0,0,0,"AL",0.038
"8804",526,"198603.230.1100.8","NMFS",1986,4,10,100,30,40.266667,-68.85,0,0,0,0,0,"AL",0.038
"8805",525,"198603.231.1140.4","NMFS",1986,4,10,100,30,40.133333,-68.7,1,0,1,0,1,"AL",0.038
"8806",525,"198603.232.1150.3","NMFS",1986,4,10,100,30,40.166667,-68.35,3,2,1,3,0,"AL",0.038
"8807",525,"198603.233.1140.2","NMFS",1986,4,10,100,30,40.283333,-68.416667,0,0,0,0,0,"AL",0.038
"8808",525,"198603.234.1140.1","NMFS",1986,4,10,100,30,40.4,-68.233333,0,0,0,0,0,"AL",0.038
"8809",525,"198603.235.1140.3","NMFS",1986,4,10,100,30,40.366667,-67.983333,0,0,0,0,0,"AL",0.038
"8810",525,"198603.236.1150.1","NMFS",1986,4,10,100,30,40.35,-67.9,0,0,0,0,0,"AL",0.038
"8811",525,"198603.237.1130.5","NMFS",1986,4,10,100,30,40.666667,-68.416667,0,0,0,0,0,"AL",0.038
"8812",525,"198603.238.1190.2","NMFS",1986,4,10,100,30,40.716667,-68.5,0,0,0,0,0,"AL",0.038
"8813",525,"198603.239.1190.5","NMFS",1986,4,11,101,30,40.866667,-68.3,0,0,0,0,0,"AL",0.038
"8814",525,"198603.240.1130.2","NMFS",1986,4,11,101,30,40.866667,-68.05,0,0,0,0,0,"AL",0.038
"8815",525,"198603.241.1190.4","NMFS",1986,4,11,101,30,40.95,-68.083333,0,0,0,0,0,"AL",0.038
"8816",525,"198603.242.1190.9","NMFS",1986,4,11,101,30,40.983333,-67.8,0,0,0,0,0,"AL",0.038
"8817",525,"198603.243.1130.7","NMFS",1986,4,11,101,30,40.966667,-67.616667,0,0,0,0,0,"AL",0.038
"8818",525,"198603.244.1130.4","NMFS",1986,4,11,101,30,40.983333,-67.5,0,0,0,0,0,"AL",0.038
"8819",525,"198603.245.1130.6","NMFS",1986,4,11,101,30,40.716667,-67.533333,0,0,0,0,0,"AL",0.038
"8820",525,"198603.246.1150.2","NMFS",1986,4,11,101,30,40.5,-67.133333,7,4,3,7,0,"AL",0.038
"8821",525,"198603.248.1130.8","NMFS",1986,4,11,101,30,40.783333,-66.866667,0,0,0,0,0,"AL",0.038
"8822",562,"198603.249.1160.6","NMFS",1986,4,11,101,30,40.95,-66.966667,0,0,0,0,0,"AL",0.038
"8823",562,"198603.250.1160.4","NMFS",1986,4,12,102,30,41.233333,-67.2,0,0,0,0,0,"AL",0.038
"8824",562,"198603.251.1160.2","NMFS",1986,4,12,102,30,41.35,-66.9,0,0,0,0,0,"AL",0.038
"8825",562,"198603.252.1160.5","NMFS",1986,4,12,102,30,40.95,-66.6,0,0,0,0,0,"AL",0.038
"8826",562,"198603.253.1180.1","NMFS",1986,4,12,102,28,41.033333,-66.4,3,3,0,2,1,"AL",0.038
"8827",562,"198603.254.1170.1","NMFS",1986,4,12,102,30,41.066667,-66.466667,0,0,0,0,0,"AL",0.038
"8828",562,"198603.255.1160.9","NMFS",1986,4,12,102,30,41.2,-66.516667,0,0,0,0,0,"AL",0.038
"8829",552,"198603.256.1170.4","NMFS",1986,4,12,102,30,41.383333,-66.1,2,2,0,2,0,"AL",0.038
"8830",552,"198603.257.1180.3","NMFS",1986,4,12,102,30,41.4,-65.966667,6,4,2,6,0,"AL",0.038
"8831",552,"198603.258.1160.7","NMFS",1986,4,12,102,30,41.516667,-66.216667,0,0,0,0,0,"AL",0.038
"8832",552,"198603.259.1160.3","NMFS",1986,4,12,102,30,41.683333,-66.633333,0,0,0,0,0,"AL",0.038
"8833",552,"198603.260.1160.10","NMFS",1986,4,13,103,30,41.733333,-66.516667,0,0,0,0,0,"AL",0.038
"8834",551,"198603.261.1160.1","NMFS",1986,4,13,103,30,41.866667,-66.033333,0,0,0,0,0,"AL",0.038
"8835",552,"198603.262.1170.3","NMFS",1986,4,13,103,30,41.8,-65.85,0,0,0,0,0,"AL",0.038
"8836",552,"198603.263.1170.2","NMFS",1986,4,13,103,30,41.783333,-65.733333,0,0,0,0,0,"AL",0.038
"8837",551,"198603.264.1180.2","NMFS",1986,4,13,103,30,41.883333,-65.75,0,0,0,0,0,"AL",0.038
"8838",551,"198603.265.1210.2","NMFS",1986,4,13,103,30,42.1,-66.4,0,0,0,0,0,"AL",0.038
"8839",464,"198603.266.1290.5","NMFS",1986,4,13,103,30,42.35,-66.066667,4,3,1,4,0,"AL",0.038
"8840",464,"198603.267.1290.4","NMFS",1986,4,13,103,30,42.383333,-66.3,0,0,0,0,0,"AL",0.038
"8841",464,"198603.268.1290.3","NMFS",1986,4,13,103,30,42.433333,-66.533333,1,1,0,1,0,"AL",0.038
"8842",464,"198603.269.1300.3","NMFS",1986,4,13,103,30,42.45,-66.783333,0,0,0,0,0,"AL",0.038
"8843",464,"198603.270.1300.2","NMFS",1986,4,14,104,30,42.466667,-67.05,2,2,0,2,0,"AL",0.038
"8844",464,"198603.271.1300.1","NMFS",1986,4,14,104,30,42.35,-66.883333,0,0,0,0,0,"AL",0.038
"8845",551,"198603.272.1220.4","NMFS",1986,4,14,104,30,42.2,-67.016667,0,0,0,0,0,"AL",0.038
"8846",551,"198603.273.1210.1","NMFS",1986,4,14,104,30,42.066667,-66.816667,0,0,0,0,0,"AL",0.038
"8847",551,"198603.274.1160.8","NMFS",1986,4,14,104,30,42.016667,-67,3,2,1,3,0,"AL",0.038
"8848",562,"198603.275.1190.8","NMFS",1986,4,14,104,30,41.75,-67.083333,1,0,1,1,0,"AL",0.038
"8849",562,"198603.276.1190.7","NMFS",1986,4,14,104,30,41.566667,-67.383333,0,0,0,0,0,"AL",0.038
"8850",562,"198603.277.1190.1","NMFS",1986,4,14,104,30,41.616667,-67.45,0,0,0,0,0,"AL",0.038
"8851",522,"198603.278.1190.6","NMFS",1986,4,14,104,30,41.433333,-67.666667,0,0,0,0,0,"AL",0.038
"8852",522,"198603.279.1190.3","NMFS",1986,4,14,104,30,41.433333,-67.766667,0,0,0,0,0,"AL",0.038
"8853",522,"198603.280.1200.5","NMFS",1986,4,14,104,30,41.466667,-68.05,0,0,0,0,0,"AL",0.038
"8854",522,"198603.281.1200.2","NMFS",1986,4,14,104,30,41.383333,-68.116667,2,2,0,2,0,"AL",0.038
"8855",522,"198603.282.1200.4","NMFS",1986,4,16,106,30,41.616667,-68,0,0,0,0,0,"AL",0.038
"8856",522,"198603.283.1200.6","NMFS",1986,4,16,106,30,41.8,-67.816667,2,0,2,2,0,"AL",0.038
"8857",522,"198603.284.1220.1","NMFS",1986,4,16,106,30,41.966667,-67.916667,2,1,1,2,0,"AL",0.038
"8858",522,"198603.285.1290.8","NMFS",1986,4,16,106,30,42.15,-68.016667,0,0,0,0,0,"AL",0.038
"8859",522,"198603.286.1220.3","NMFS",1986,4,16,106,30,42.1,-67.766667,2,2,0,2,0,"AL",0.038
"8860",561,"198603.287.1210.3","NMFS",1986,4,16,106,30,42.05,-67.633333,0,0,0,0,0,"AL",0.038
"8861",561,"198603.288.1200.1","NMFS",1986,4,16,106,30,42.016667,-67.4,0,0,0,0,0,"AL",0.038
"8862",561,"198603.289.1210.4","NMFS",1986,4,16,106,30,42.1,-67.383333,0,0,0,0,0,"AL",0.038
"8863",464,"198603.290.1290.7","NMFS",1986,4,17,107,30,42.383333,-67.583333,0,0,0,0,0,"AL",0.038
"8864",464,"198603.291.1290.2","NMFS",1986,4,17,107,30,42.733333,-67.433333,0,0,0,0,0,"AL",0.038
"8865",464,"198603.292.1360.6","NMFS",1986,4,17,107,30,42.8,-67.1,0,0,0,0,0,"AL",0.038
"8866",465,"198603.293.1340.2","NMFS",1986,4,17,107,30,43.083333,-67.033333,0,0,0,0,0,"AL",0.038
"8867",465,"198603.294.1360.7","NMFS",1986,4,17,107,30,43.216667,-67.083333,3,2,1,3,0,"AL",0.038
"8868",465,"198603.295.1360.2","NMFS",1986,4,17,107,30,43.233333,-66.916667,3,2,1,3,0,"AL",0.038
"8869",464,"198603.297.1310.1","NMFS",1986,4,17,107,30,42.816667,-66.65,0,0,0,0,0,"AL",0.038
"8870",464,"198603.298.1320.1","NMFS",1986,4,18,108,30,42.733333,-66.3,0,0,0,0,0,"AL",0.038
"8871",464,"198603.300.1320.2","NMFS",1986,4,18,108,30,42.75,-66.233333,0,0,0,0,0,"AL",0.038
"8872",464,"198603.301.1320.5","NMFS",1986,4,18,108,30,42.716667,-66.15,0,0,0,0,0,"AL",0.038
"8873",464,"198603.302.1320.3","NMFS",1986,4,18,108,30,42.7,-66.016667,0,0,0,0,0,"AL",0.038
"8874",464,"198603.303.1320.4","NMFS",1986,4,18,108,30,42.383333,-65.6,0,0,0,0,0,"AL",0.038
"8875",465,"198603.308.1330.2","NMFS",1986,4,21,111,30,43.45,-66.283333,1,1,0,1,0,"AL",0.038
"8876",465,"198603.309.1330.1","NMFS",1986,4,21,111,30,43.6,-66.366667,2,1,1,2,0,"AL",0.038
"8877",465,"198603.310.1340.6","NMFS",1986,4,21,111,30,43.533333,-66.8,0,0,0,0,0,"AL",0.038
"8878",465,"198603.311.1340.5","NMFS",1986,4,21,111,30,43.65,-66.716667,1,0,1,1,0,"AL",0.038
"8879",465,"198603.312.1340.4","NMFS",1986,4,21,111,30,43.766667,-66.983333,0,0,0,0,0,"AL",0.038
"8880",465,"198603.313.1330.4","NMFS",1986,4,21,111,30,43.85,-66.6,0,0,0,0,0,"AL",0.038
"8881",465,"198603.314.1340.1","NMFS",1986,4,21,111,30,43.983333,-66.783333,0,0,0,0,0,"AL",0.038
"8882",511,"198603.315.1340.3","NMFS",1986,4,21,111,30,44.066667,-67.083333,1,1,0,1,0,"AL",0.038
"8883",511,"198603.316.1350.2","NMFS",1986,4,21,111,30,44.133333,-67,0,0,0,0,0,"AL",0.038
"8884",511,"198603.317.1350.3","NMFS",1986,4,21,111,30,44.233333,-66.9,0,0,0,0,0,"AL",0.038
"8885",511,"198603.318.1350.1","NMFS",1986,4,22,112,30,44.333333,-67.15,0,0,0,0,0,"AL",0.038
"8886",511,"198603.319.1360.1","NMFS",1986,4,22,112,30,44.166667,-67.35,0,0,0,0,0,"AL",0.038
"8887",511,"198603.320.1390.2","NMFS",1986,4,22,112,30,44.316667,-67.5,1,1,0,1,0,"AL",0.038
"8888",511,"198603.321.1390.3","NMFS",1986,4,22,112,30,44.25,-67.866667,1,0,1,0,1,"AL",0.038
"8889",511,"198603.322.1380.3","NMFS",1986,4,22,112,30,44.033333,-67.733333,0,0,0,0,0,"AL",0.038
"8890",465,"198603.323.1360.8","NMFS",1986,4,22,112,30,43.616667,-67.633333,3,1,2,3,0,"AL",0.038
"8891",465,"198603.324.1360.5","NMFS",1986,4,22,112,30,43.366667,-67.566667,1,0,1,1,0,"AL",0.038
"8892",512,"198603.325.1360.3","NMFS",1986,4,22,112,30,43.5,-67.933333,0,0,0,0,0,"AL",0.038
"8893",512,"198603.326.1390.1","NMFS",1986,4,23,113,30,43.983333,-68.416667,2,1,1,1,1,"AL",0.038
"8894",512,"198603.327.1390.4","NMFS",1986,4,23,113,30,43.833333,-68.45,0,0,0,0,0,"AL",0.038
"8895",512,"198603.328.1390.5","NMFS",1986,4,23,113,28,43.716667,-68.966667,0,0,0,0,0,"AL",0.038
"8896",512,"198603.329.1380.5","NMFS",1986,4,23,113,30,43.483333,-68.833333,3,3,0,3,0,"AL",0.038
"8897",513,"198603.330.1380.1","NMFS",1986,4,23,113,30,43.25,-69.116667,0,0,0,0,0,"AL",0.038
"8898",515,"198603.331.1370.1","NMFS",1986,4,23,113,30,43,-69.016667,0,0,0,0,0,"AL",0.038
"8899",515,"198603.332.1370.5","NMFS",1986,4,23,113,30,42.983333,-68.916667,0,0,0,0,0,"AL",0.038
"8900",515,"198603.333.1370.3","NMFS",1986,4,23,113,30,43.133333,-68.633333,0,0,0,0,0,"AL",0.038
"8901",515,"198603.334.1360.4","NMFS",1986,4,24,114,30,42.766667,-68.266667,3,3,0,3,0,"AL",0.038
"8902",515,"198603.335.1290.1","NMFS",1986,4,24,114,30,42.7,-68.366667,0,0,0,0,0,"AL",0.038
"8903",515,"198603.336.1370.2","NMFS",1986,4,24,114,30,42.716667,-68.5,0,0,0,0,0,"AL",0.038
"8904",515,"198603.337.1290.6","NMFS",1986,4,24,114,30,42.616667,-68.466667,0,0,0,0,0,"AL",0.038
"8905",515,"198603.338.1280.1","NMFS",1986,4,24,114,30,42.383333,-68.783333,0,0,0,0,0,"AL",0.038
"8906",515,"198603.339.1280.6","NMFS",1986,4,24,114,30,42.35,-68.883333,0,0,0,0,0,"AL",0.038
"8907",515,"198603.340.1280.5","NMFS",1986,4,24,114,30,42.566667,-69.016667,0,0,0,0,0,"AL",0.038
"8908",515,"198603.341.1280.3","NMFS",1986,4,24,114,30,42.583333,-69.116667,0,0,0,0,0,"AL",0.038
"8909",513,"198603.342.1370.4","NMFS",1986,4,24,114,30,42.866667,-69.583333,0,0,0,0,0,"AL",0.038
"8910",513,"198603.343.1380.2","NMFS",1986,4,25,115,30,43.266667,-69.616667,0,0,0,0,0,"AL",0.038
"8911",513,"198603.344.1380.4","NMFS",1986,4,25,115,30,43.383333,-69.6,0,0,0,0,0,"AL",0.038
"8912",513,"198603.345.1400.2","NMFS",1986,4,25,115,30,43.533333,-69.766667,0,0,0,0,0,"AL",0.038
"8913",513,"198603.346.1400.1","NMFS",1986,4,25,115,30,43.283333,-70.183333,0,0,0,0,0,"AL",0.038
"8914",514,"198603.348.3650.1","NMFS",1986,4,25,115,30,42.75,-70.666667,0,0,0,0,0,"AL",0.038
"8915",513,"198603.349.1270.3","NMFS",1986,4,25,115,30,43,-70.283333,0,0,0,0,0,"AL",0.038
"8916",513,"198603.350.1260.2","NMFS",1986,4,25,115,30,43.083333,-70.033333,0,0,0,0,0,"AL",0.038
"8917",513,"198603.351.1270.4","NMFS",1986,4,26,116,30,42.983333,-69.966667,0,0,0,0,0,"AL",0.038
"8918",513,"198603.352.1280.4","NMFS",1986,4,26,116,30,42.966667,-69.933333,0,0,0,0,0,"AL",0.038
"8919",514,"198603.353.1270.1","NMFS",1986,4,26,116,30,42.783333,-70.05,0,0,0,0,0,"AL",0.038
"8920",514,"198603.354.1280.2","NMFS",1986,4,26,116,30,42.683333,-69.933333,0,0,0,0,0,"AL",0.038
"8921",514,"198603.355.1260.1","NMFS",1986,4,26,116,30,42.583333,-70.15,0,0,0,0,0,"AL",0.038
"8922",514,"198603.356.3660.1","NMFS",1986,4,26,116,30,42.483333,-70.65,6,2,4,6,0,"AL",0.038
"8923",514,"198603.357.3660.2","NMFS",1986,4,26,116,30,42.25,-70.516667,3,1,2,3,0,"AL",0.038
"8924",514,"198603.358.1260.4","NMFS",1986,4,26,116,30,42.283333,-70.433333,3,1,2,3,0,"AL",0.038
"8925",514,"198603.359.1260.5","NMFS",1986,4,26,116,30,42.266667,-70.183333,0,0,0,0,0,"AL",0.038
"8926",521,"198603.360.1270.2","NMFS",1986,4,26,116,30,42.283333,-69.933333,1,1,0,1,0,"AL",0.038
"8927",521,"198603.361.1240.2","NMFS",1986,4,26,116,30,41.966667,-69.766667,0,0,0,0,0,"AL",0.038
"8928",521,"198603.362.1260.3","NMFS",1986,4,26,116,30,42.05,-69.916667,3,3,0,3,0,"AL",0.038
"8929",514,"198603.363.3610.2","NMFS",1986,4,27,117,30,42.083333,-70.016667,0,0,0,0,0,"AL",0.038
"8930",514,"198603.364.3610.1","NMFS",1986,4,27,117,30,42.033333,-70.466667,20,7,13,20,0,"AL",0.038
"8931",514,"198603.365.3600.2","NMFS",1986,4,27,117,30,41.95,-70.183333,0,0,0,0,0,"AL",0.038
"8932",514,"198603.366.3600.1","NMFS",1986,4,27,117,30,41.883333,-70.25,1,1,0,1,0,"AL",0.038
"8933",514,"198603.367.3590.1","NMFS",1986,4,27,117,30,41.8,-70.35,10,5,5,9,1,"AL",0.038
"8934",514,"198603.368.3580.1","NMFS",1986,4,27,117,30,41.766667,-70.316667,2,1,1,2,0,"AL",0.038
"8935",526,"198606.178.1100.2","NMFS",1986,10,8,281,30,40.2,-69.966667,3,2,1,2,1,"DE",0.038
"8936",526,"198606.179.1100.6","NMFS",1986,10,8,281,30,40.15,-69.666667,0,0,0,0,0,"DE",0.038
"8937",526,"198606.180.1100.4","NMFS",1986,10,8,281,30,40.233333,-69.55,3,1,2,2,1,"DE",0.038
"8938",526,"198606.181.1100.3","NMFS",1986,10,8,281,30,40.55,-69.516667,14,5,9,12,2,"DE",0.038
"8939",526,"198606.182.1100.1","NMFS",1986,10,8,281,30,40.533333,-69.2,0,0,0,0,0,"DE",0.038
"8940",526,"198606.183.1100.5","NMFS",1986,10,8,281,30,40.483333,-68.95,0,0,0,0,0,"DE",0.038
"8941",526,"198606.184.1100.7","NMFS",1986,10,8,281,30,40.666667,-69,1,1,0,1,0,"DE",0.038
"8942",525,"198606.185.1130.1","NMFS",1986,10,8,281,30,40.783333,-68.833333,2,1,1,2,0,"DE",0.038
"8943",522,"198606.186.1230.1","NMFS",1986,10,8,281,30,41.133333,-68.8,1,1,0,1,0,"DE",0.038
"8944",522,"198606.187.1230.3","NMFS",1986,10,8,281,30,41.2,-68.6,0,0,0,0,0,"DE",0.038
"8945",525,"198606.188.1190.5","NMFS",1986,10,8,281,30,41,-68.25,0,0,0,0,0,"DE",0.038
"8946",522,"198606.189.1230.2","NMFS",1986,10,9,282,30,41.333333,-68.35,5,3,2,5,0,"DE",0.038
"8947",522,"198606.190.1230.4","NMFS",1986,10,9,282,30,41.433333,-68.683333,0,0,0,0,0,"DE",0.038
"8948",521,"198606.191.1240.2","NMFS",1986,10,9,282,30,41.5,-68.9,0,0,0,0,0,"DE",0.038
"8949",522,"198606.192.1240.3","NMFS",1986,10,9,282,30,41.733333,-68.766667,0,0,0,0,0,"DE",0.038
"8950",521,"198606.193.1240.6","NMFS",1986,10,9,282,30,41.733333,-69.116667,0,0,0,0,0,"DE",0.038
"8951",521,"198606.194.1240.5","NMFS",1986,10,9,282,30,41.45,-69.066667,0,0,0,0,0,"DE",0.038
"8952",521,"198606.195.1240.1","NMFS",1986,10,9,282,30,41.55,-69.183333,0,0,0,0,0,"DE",0.038
"8953",521,"198606.196.1230.5","NMFS",1986,10,9,282,30,41.45,-69.316667,0,0,0,0,0,"DE",0.038
"8954",521,"198606.197.1250.3","NMFS",1986,10,9,282,23,41.4,-69.516667,8,3,5,8,0,"DE",0.038
"8955",521,"198606.199.1250.2","NMFS",1986,10,9,282,30,41.6,-69.616667,0,0,0,0,0,"DE",0.038
"8956",521,"198606.200.1250.4","NMFS",1986,10,10,283,30,41.716667,-69.816667,7,3,4,6,1,"DE",0.038
"8957",521,"198606.201.3560.1","NMFS",1986,10,11,284,30,41.733333,-69.883333,2,1,1,2,0,"DE",0.038
"8958",526,"198606.217.1120.3","NMFS",1986,10,17,290,30,39.933333,-69.833333,17,12,5,15,2,"AL",0.038
"8959",526,"198606.218.1110.1","NMFS",1986,10,17,290,30,39.983333,-69.45,0,0,0,0,0,"AL",0.038
"8960",525,"198606.219.1130.2","NMFS",1986,10,17,290,30,40.533333,-68.3,0,0,0,0,0,"AL",0.038
"8961",525,"198606.220.1130.9","NMFS",1986,10,18,291,30,40.616667,-67.983333,0,0,0,0,0,"AL",0.038
"8962",525,"198606.221.1140.3","NMFS",1986,10,18,291,30,40.4,-67.766667,1,1,0,0,1,"AL",0.038
"8963",525,"198606.222.1150.1","NMFS",1986,10,18,291,24,40.333333,-67.8,2,0,2,2,0,"AL",0.038
"8964",525,"198606.223.1150.2","NMFS",1986,10,18,291,30,40.366667,-67.533333,0,0,0,0,0,"AL",0.038
"8965",525,"198606.224.1140.1","NMFS",1986,10,18,291,30,40.533333,-67.283333,0,0,0,0,0,"AL",0.038
"8966",525,"198606.225.1130.6","NMFS",1986,10,18,291,30,40.683333,-67.35,0,0,0,0,0,"AL",0.038
"8967",525,"198606.226.1130.7","NMFS",1986,10,19,292,30,40.633333,-67.233333,0,0,0,0,0,"AL",0.038
"8968",562,"198606.227.1150.3","NMFS",1986,10,19,292,30,40.683333,-66.8,1,1,0,1,0,"AL",0.038
"8969",562,"198606.228.1180.2","NMFS",1986,10,19,292,30,40.783333,-66.7,0,0,0,0,0,"AL",0.038
"8970",525,"198606.229.1140.2","NMFS",1986,10,19,292,30,40.733333,-66.916667,1,1,0,1,0,"AL",0.038
"8971",525,"198606.230.1130.3","NMFS",1986,10,19,292,30,40.8,-67.283333,1,1,0,1,0,"AL",0.038
"8972",525,"198606.231.1130.4","NMFS",1986,10,19,292,30,40.866667,-67.55,0,0,0,0,0,"AL",0.038
"8973",525,"198606.232.1130.5","NMFS",1986,10,19,292,30,40.9,-67.516667,0,0,0,0,0,"AL",0.038
"8974",525,"198606.233.1130.8","NMFS",1986,10,19,292,30,41,-67.283333,1,1,0,1,0,"AL",0.038
"8975",562,"198606.234.1160.5","NMFS",1986,10,19,292,30,41.083333,-67.116667,0,0,0,0,0,"AL",0.038
"8976",562,"198606.235.1160.7","NMFS",1986,10,20,293,30,41.15,-67.033333,0,0,0,0,0,"AL",0.038
"8977",562,"198606.236.1190.4","NMFS",1986,10,20,293,30,41.3,-67.316667,0,0,0,0,0,"AL",0.038
"8978",562,"198606.237.1190.3","NMFS",1986,10,20,293,30,41.383333,-67.6,0,0,0,0,0,"AL",0.038
"8979",562,"198606.238.1190.7","NMFS",1986,10,20,293,30,41.516667,-67.533333,0,0,0,0,0,"AL",0.038
"8980",562,"198606.239.1190.9","NMFS",1986,10,20,293,28,41.533333,-67.633333,0,0,0,0,0,"AL",0.038
"8981",522,"198606.240.1190.8","NMFS",1986,10,20,293,30,41.633333,-67.666667,0,0,0,0,0,"AL",0.038
"8982",562,"198606.241.1190.6","NMFS",1986,10,20,293,30,41.65,-67.466667,3,3,0,2,1,"AL",0.038
"8983",562,"198606.242.1190.1","NMFS",1986,10,20,293,30,41.533333,-67.333333,2,1,1,2,0,"AL",0.038
"8984",562,"198606.243.1190.2","NMFS",1986,10,20,293,30,41.516667,-67.166667,1,1,0,1,0,"AL",0.038
"8985",562,"198606.244.1160.3","NMFS",1986,10,20,293,30,41.783333,-66.883333,7,2,5,7,0,"AL",0.038
"8986",562,"198606.245.1160.9","NMFS",1986,10,20,293,30,41.5,-66.683333,4,2,2,3,1,"AL",0.038
"8987",562,"198606.246.1160.2","NMFS",1986,10,20,293,30,41.283333,-66.783333,0,0,0,0,0,"AL",0.038
"8988",562,"198606.247.1160.10","NMFS",1986,10,21,294,30,41.283333,-66.466667,0,0,0,0,0,"AL",0.038
"8989",552,"198606.248.1160.4","NMFS",1986,10,21,294,30,41.266667,-66.383333,0,0,0,0,0,"AL",0.038
"8990",552,"198606.249.1170.1","NMFS",1986,10,21,294,30,41.333333,-66.233333,1,1,0,1,0,"AL",0.038
"8991",552,"198606.250.1170.2","NMFS",1986,10,21,294,30,41.516667,-66.016667,1,1,0,1,0,"AL",0.038
"8992",552,"198606.251.1170.4","NMFS",1986,10,21,294,30,41.766667,-65.8,0,0,0,0,0,"AL",0.038
"8993",551,"198606.252.1170.3","NMFS",1986,10,21,294,30,41.883333,-65.833333,0,0,0,0,0,"AL",0.038
"8994",551,"198606.253.1180.1","NMFS",1986,10,21,294,30,41.9,-65.7,0,0,0,0,0,"AL",0.038
"8995",551,"198606.254.1180.3","NMFS",1986,10,21,294,30,42.016667,-65.85,0,0,0,0,0,"AL",0.038
"8996",551,"198606.255.1210.3","NMFS",1986,10,21,294,30,42.133333,-66.183333,0,0,0,0,0,"AL",0.038
"8997",551,"198606.256.1160.1","NMFS",1986,10,21,294,30,42.066667,-66.35,0,0,0,0,0,"AL",0.038
"8998",551,"198606.257.1290.1","NMFS",1986,10,21,294,30,42.183333,-66.383333,1,0,1,1,0,"AL",0.038
"8999",551,"198606.258.1160.6","NMFS",1986,10,22,295,30,42,-66.816667,1,1,0,1,0,"AL",0.038
"9000",551,"198606.259.1160.8","NMFS",1986,10,22,295,30,42.066667,-66.866667,0,0,0,0,0,"AL",0.038
"9001",551,"198606.260.1220.2","NMFS",1986,10,22,295,30,42.2,-67.083333,0,0,0,0,0,"AL",0.038
"9002",551,"198606.261.1210.2","NMFS",1986,10,22,295,20,42.15,-67.15,0,0,0,0,0,"AL",0.038
"9003",561,"198606.262.1200.1","NMFS",1986,10,22,295,30,42.016667,-67.533333,0,0,0,0,0,"AL",0.038
"9004",561,"198606.263.1210.4","NMFS",1986,10,22,295,30,42.083333,-67.516667,0,0,0,0,0,"AL",0.038
"9005",561,"198606.264.1220.4","NMFS",1986,10,22,295,30,42.1,-67.566667,0,0,0,0,0,"AL",0.038
"9006",522,"198606.265.1220.1","NMFS",1986,10,22,295,30,42,-68.033333,0,0,0,0,0,"AL",0.038
"9007",522,"198606.266.1210.1","NMFS",1986,10,22,295,30,41.833333,-68.1,0,0,0,0,0,"AL",0.038
"9008",522,"198606.267.1200.2","NMFS",1986,10,22,295,30,41.816667,-67.9,51,29,22,36,15,"AL",0.038
"9009",522,"198606.268.1200.3","NMFS",1986,10,23,296,30,41.666667,-68.016667,1,0,1,1,0,"AL",0.038
"9010",522,"198606.270.1200.4","NMFS",1986,10,23,296,30,41.483333,-68.133333,7,5,2,6,1,"AL",0.038
"9011",522,"198606.271.1200.5","NMFS",1986,10,23,296,30,41.583333,-68.366667,0,0,0,0,0,"AL",0.038
"9012",522,"198606.272.1220.3","NMFS",1986,10,23,296,30,41.7,-68.45,1,0,1,1,0,"AL",0.038
"9013",522,"198606.273.1240.4","NMFS",1986,10,23,296,30,41.9,-68.783333,0,0,0,0,0,"AL",0.038
"9014",521,"198606.274.3550.2","NMFS",1986,10,23,296,30,41.033333,-69.383333,0,0,0,0,0,"AL",0.038
"9015",526,"198606.275.3550.1","NMFS",1986,10,23,296,30,40.95,-69.6,1,1,0,1,0,"AL",0.038
"9016",526,"198606.276.1090.2","NMFS",1986,10,23,296,30,40.916667,-69.766667,0,0,0,0,0,"AL",0.038
"9017",514,"198606.277.3590.1","NMFS",1986,10,23,296,30,41.833333,-70.416667,32,23,9,27,5,"DE",0.038
"9018",514,"198606.278.3600.1","NMFS",1986,10,23,296,30,41.9,-70.433333,150,83,67,122,28,"DE",0.038
"9019",514,"198606.279.3610.2","NMFS",1986,10,23,296,30,42.05,-70.4,65,25,40,62,3,"DE",0.038
"9020",514,"198606.280.3600.2","NMFS",1986,10,23,296,30,42.016667,-70.533333,141,74,67,80,61,"DE",0.038
"9021",514,"198606.281.3610.1","NMFS",1986,10,23,296,30,42.066667,-70.466667,68,34,34,45,23,"DE",0.038
"9022",514,"198606.282.3660.2","NMFS",1986,10,23,296,29,42.233333,-70.516667,9,0,9,9,0,"DE",0.038
"9023",514,"198606.283.3660.1","NMFS",1986,10,23,296,21,42.416667,-70.683333,17,6,11,17,0,"DE",0.038
"9024",514,"198606.284.1260.1","NMFS",1986,10,28,301,30,42.15,-70.2,6,1,5,6,0,"AL",0.038
"9025",521,"198606.285.1270.2","NMFS",1986,10,28,301,23,42.25,-69.966667,0,0,0,0,0,"AL",0.038
"9026",514,"198606.286.1280.7","NMFS",1986,10,28,301,30,42.366667,-69.916667,0,0,0,0,0,"AL",0.038
"9027",514,"198606.287.1270.4","NMFS",1986,10,28,301,30,42.5,-69.983333,0,0,0,0,0,"AL",0.038
"9028",515,"198606.288.1280.5","NMFS",1986,10,28,301,30,42.583333,-69.45,0,0,0,0,0,"AL",0.038
"9029",521,"198606.289.1280.2","NMFS",1986,10,28,301,30,42.316667,-69.183333,0,0,0,0,0,"AL",0.038
"9030",515,"198606.290.1280.6","NMFS",1986,10,28,301,30,42.533333,-69.083333,0,0,0,0,0,"AL",0.038
"9031",515,"198606.291.1370.4","NMFS",1986,10,28,301,30,42.7,-69,0,0,0,0,0,"AL",0.038
"9032",515,"198606.292.1370.5","NMFS",1986,10,28,301,30,42.916667,-69.3,0,0,0,0,0,"AL",0.038
"9033",515,"198606.293.1370.2","NMFS",1986,10,29,302,30,42.883333,-69.033333,0,0,0,0,0,"AL",0.038
"9034",515,"198606.294.1370.1","NMFS",1986,10,29,302,30,42.8,-68.8,0,0,0,0,0,"AL",0.038
"9035",515,"198606.295.1280.4","NMFS",1986,10,29,302,30,42.533333,-68.55,0,0,0,0,0,"AL",0.038
"9036",515,"198606.296.1290.5","NMFS",1986,10,29,302,30,42.55,-68.433333,0,0,0,0,0,"AL",0.038
"9037",515,"198606.297.1290.6","NMFS",1986,10,29,302,30,42.65,-68.233333,0,0,0,0,0,"AL",0.038
"9038",515,"198606.298.1290.7","NMFS",1986,10,29,302,30,42.633333,-67.816667,0,0,0,0,0,"AL",0.038
"9039",464,"198606.299.1360.3","NMFS",1986,10,29,302,30,42.85,-67.633333,1,0,1,1,0,"AL",0.038
"9040",464,"198606.300.1360.2","NMFS",1986,10,29,302,30,42.916667,-67.316667,0,0,0,0,0,"AL",0.038
"9041",464,"198606.301.1290.8","NMFS",1986,10,29,302,30,42.716667,-67.316667,0,0,0,0,0,"AL",0.038
"9042",464,"198606.302.1300.3","NMFS",1986,10,29,302,23,42.4,-67.5,1,1,0,1,0,"AL",0.038
"9043",464,"198606.303.1300.2","NMFS",1986,10,30,303,30,42.466667,-67.033333,0,0,0,0,0,"AL",0.038
"9044",551,"198606.304.1290.3","NMFS",1986,10,30,303,30,42.25,-66.716667,0,0,0,0,0,"AL",0.038
"9045",551,"198606.305.1300.1","NMFS",1986,10,30,303,30,42.333333,-66.583333,0,0,0,0,0,"AL",0.038
"9046",464,"198606.306.1290.4","NMFS",1986,10,30,303,30,42.383333,-66.333333,0,0,0,0,0,"AL",0.038
"9047",464,"198606.307.1290.2","NMFS",1986,10,30,303,30,42.366667,-65.95,1,0,1,1,0,"AL",0.038
"9048",464,"198606.308.1310.4","NMFS",1986,10,30,303,30,42.366667,-65.716667,1,0,1,1,0,"AL",0.038
"9049",464,"198606.312.1310.6","NMFS",1986,10,30,303,30,42.5,-65.533333,2,2,0,2,0,"AL",0.038
"9050",464,"198606.313.1320.1","NMFS",1986,10,30,303,30,42.633333,-65.633333,0,0,0,0,0,"AL",0.038
"9051",464,"198606.314.1320.2","NMFS",1986,10,31,304,30,42.583333,-65.8,0,0,0,0,0,"AL",0.038
"9052",464,"198606.315.1310.2","NMFS",1986,10,31,304,30,42.533333,-65.916667,4,4,0,4,0,"AL",0.038
"9053",464,"198606.316.1320.4","NMFS",1986,10,31,304,30,42.666667,-66.15,0,0,0,0,0,"AL",0.038
"9054",464,"198606.317.1320.3","NMFS",1986,10,31,304,30,42.733333,-66.316667,3,3,0,3,0,"AL",0.038
"9055",464,"198606.318.1310.3","NMFS",1986,10,31,304,21,42.883333,-66.166667,0,0,0,0,0,"AL",0.038
"9056",465,"198606.320.1330.1","NMFS",1986,10,31,304,30,43.266667,-66.25,0,0,0,0,0,"AL",0.038
"9057",465,"198606.322.1330.5","NMFS",1986,11,1,305,30,43.666667,-66.5,8,7,1,6,2,"AL",0.038
"9058",465,"198606.323.1330.3","NMFS",1986,11,1,305,30,43.866667,-66.6,10,7,3,10,0,"AL",0.038
"9059",466,"198606.324.1330.2","NMFS",1986,11,1,305,30,44.183333,-66.516667,10,6,4,10,0,"AL",0.038
"9060",466,"198606.325.1350.3","NMFS",1986,11,1,305,30,44.366667,-66.616667,1,0,1,1,0,"AL",0.038
"9061",466,"198606.326.1350.4","NMFS",1986,11,1,305,30,44.383333,-66.7,0,0,0,0,0,"AL",0.038
"9062",467,"198606.327.1350.2","NMFS",1986,11,1,305,30,44.366667,-66.833333,2,0,2,2,0,"AL",0.038
"9063",511,"198606.328.1350.1","NMFS",1986,11,1,305,30,44.183333,-67.016667,2,2,0,2,0,"AL",0.038
"9064",511,"198606.329.1340.5","NMFS",1986,11,2,306,30,44.066667,-66.966667,2,1,1,2,0,"AL",0.038
"9065",511,"198606.330.1340.1","NMFS",1986,11,2,306,30,43.95,-66.916667,1,1,0,1,0,"AL",0.038
"9066",465,"198606.331.1340.4","NMFS",1986,11,2,306,30,43.666667,-67.016667,2,1,1,2,0,"AL",0.038
"9067",465,"198606.332.1340.6","NMFS",1986,11,2,306,30,43.6,-66.916667,2,2,0,2,0,"AL",0.038
"9068",465,"198606.333.1340.3","NMFS",1986,11,2,306,30,43.416667,-66.85,0,0,0,0,0,"AL",0.038
"9069",465,"198606.334.1340.2","NMFS",1986,11,2,306,30,43.166667,-66.9,5,2,3,5,0,"AL",0.038
"9070",465,"198606.335.1360.6","NMFS",1986,11,2,306,30,43.15,-67.4,0,0,0,0,0,"AL",0.038
"9071",465,"198606.336.1360.8","NMFS",1986,11,2,306,30,43.283333,-67.483333,0,0,0,0,0,"AL",0.038
"9072",515,"198606.337.1360.7","NMFS",1986,11,3,307,30,43.1,-67.716667,0,0,0,0,0,"AL",0.038
"9073",515,"198606.338.1360.1","NMFS",1986,11,3,307,30,42.95,-67.916667,0,0,0,0,0,"AL",0.038
"9074",515,"198606.339.1360.5","NMFS",1986,11,3,307,30,43.116667,-68.283333,0,0,0,0,0,"AL",0.038
"9075",515,"198606.340.1370.3","NMFS",1986,11,3,307,30,43.216667,-68.75,0,0,0,0,0,"AL",0.038
"9076",512,"198606.341.1380.5","NMFS",1986,11,3,307,30,43.433333,-68.55,0,0,0,0,0,"AL",0.038
"9077",512,"198606.342.1380.3","NMFS",1986,11,3,307,30,43.45,-68.416667,0,0,0,0,0,"AL",0.038
"9078",512,"198606.343.1380.2","NMFS",1986,11,3,307,30,43.733333,-68.216667,0,0,0,0,0,"AL",0.038
"9079",512,"198606.344.1360.4","NMFS",1986,11,3,307,30,43.85,-67.833333,0,0,0,0,0,"AL",0.038
"9080",512,"198606.345.1390.4","NMFS",1986,11,3,307,30,44.15,-67.916667,2,1,1,2,0,"AL",0.038
"9081",512,"198606.346.1390.3","NMFS",1986,11,4,308,30,44.166667,-68.016667,4,2,2,4,0,"AL",0.038
"9082",512,"198606.347.1390.1","NMFS",1986,11,4,308,30,43.866667,-68.433333,2,1,1,1,1,"AL",0.038
"9083",512,"198606.348.1390.5","NMFS",1986,11,4,308,30,43.916667,-68.616667,2,2,0,2,0,"AL",0.038
"9084",512,"198606.349.1390.2","NMFS",1986,11,4,308,30,43.8,-68.75,9,5,4,8,1,"AL",0.038
"9085",513,"198606.350.1380.4","NMFS",1986,11,4,308,20,43.65,-69.216667,2,1,1,2,0,"AL",0.038
"9086",513,"198606.351.1380.1","NMFS",1986,11,4,308,30,43.383333,-69.283333,0,0,0,0,0,"AL",0.038
"9087",513,"198606.352.1400.2","NMFS",1986,11,4,308,30,43.45,-70.066667,1,1,0,1,0,"AL",0.038
"9088",513,"198606.353.1270.1","NMFS",1986,11,5,309,30,43.216667,-70.1,0,0,0,0,0,"AL",0.038
"9089",513,"198606.354.1280.3","NMFS",1986,11,5,309,30,42.916667,-69.85,0,0,0,0,0,"AL",0.038
"9090",513,"198606.355.1280.1","NMFS",1986,11,5,309,30,42.983333,-69.933333,0,0,0,0,0,"AL",0.038
"9091",513,"198606.356.1270.3","NMFS",1986,11,5,309,30,42.966667,-70.133333,1,1,0,1,0,"AL",0.038
"9092",513,"198606.357.1400.1","NMFS",1986,11,5,309,30,43.066667,-70.45,1,0,1,1,0,"AL",0.038
"9093",513,"198606.358.1400.3","NMFS",1986,11,5,309,30,42.9,-70.383333,1,1,0,1,0,"AL",0.038
"9094",514,"198606.359.3650.1","NMFS",1986,11,5,309,30,42.766667,-70.666667,12,6,6,11,1,"AL",0.038
"9095",514,"198606.360.1260.3","NMFS",1986,11,5,309,30,42.55,-70.2,0,0,0,0,0,"AL",0.038
"9096",514,"198606.361.1260.5","NMFS",1986,11,5,309,30,42.5,-70.333333,1,0,1,1,0,"AL",0.038
"9097",514,"198606.362.1260.4","NMFS",1986,11,5,309,20,42.483333,-70.566667,7,1,6,7,0,"AL",0.038
"9098",514,"198606.364.1260.2","NMFS",1986,11,6,310,30,42.25,-70.45,16,12,4,15,1,"AL",0.038
"9099",526,"198702.171.1120.1","NMFS",1987,4,12,102,30,39.95,-69.866667,15,7,8,15,0,"AL",0.038
"9100",526,"198702.172.1110.3","NMFS",1987,4,12,102,30,39.933333,-69.533333,0,0,0,0,0,"AL",0.038
"9101",526,"198702.173.1120.3","NMFS",1987,4,12,102,30,39.933333,-69.366667,0,0,0,0,0,"AL",0.038
"9102",526,"198702.174.1100.1","NMFS",1987,4,12,102,30,40.216667,-69.483333,0,0,0,0,0,"AL",0.038
"9103",526,"198702.175.1100.5","NMFS",1987,4,12,102,30,40.15,-69.25,0,0,0,0,0,"AL",0.038
"9104",526,"198702.176.1120.2","NMFS",1987,4,13,103,30,40.1,-69.066667,2,2,0,1,1,"AL",0.038
"9105",525,"198702.178.1150.3","NMFS",1987,4,13,103,30,40.116667,-68.666667,1,0,1,1,0,"AL",0.038
"9106",525,"198702.179.1140.4","NMFS",1987,4,13,103,30,40.15,-68.766667,0,0,0,0,0,"AL",0.038
"9107",526,"198702.180.1100.4","NMFS",1987,4,13,103,30,40.483333,-68.95,0,0,0,0,0,"AL",0.038
"9108",526,"198702.181.1100.3","NMFS",1987,4,13,103,30,40.666667,-68.916667,0,0,0,0,0,"AL",0.038
"9109",525,"198702.182.1130.9","NMFS",1987,4,13,103,27,40.783333,-68.7,2,1,1,2,0,"AL",0.038
"9110",525,"198702.183.1190.9","NMFS",1987,4,13,103,30,40.8,-68.333333,0,0,0,0,0,"AL",0.038
"9111",525,"198702.184.1190.1","NMFS",1987,4,14,104,30,41.15,-68.116667,0,0,0,0,0,"AL",0.038
"9112",522,"198702.185.1200.4","NMFS",1987,4,14,104,30,41.25,-68.366667,0,0,0,0,0,"AL",0.038
"9113",525,"198702.186.1190.3","NMFS",1987,4,14,104,30,41.083333,-68.283333,0,0,0,0,0,"AL",0.038
"9114",522,"198702.187.1190.5","NMFS",1987,4,15,105,30,41.016667,-68.416667,0,0,0,0,0,"AL",0.038
"9115",525,"198702.188.1130.3","NMFS",1987,4,15,105,30,40.966667,-68.7,0,0,0,0,0,"AL",0.038
"9116",522,"198702.189.1230.5","NMFS",1987,4,15,105,30,41.05,-68.75,0,0,0,0,0,"AL",0.038
"9117",522,"198702.190.1230.1","NMFS",1987,4,15,105,30,41.216667,-68.783333,0,0,0,0,0,"AL",0.038
"9118",521,"198702.191.1230.2","NMFS",1987,4,15,105,30,41.216667,-69.183333,0,0,0,0,0,"AL",0.038
"9119",521,"198702.192.1250.1","NMFS",1987,4,15,105,30,41.3,-69.4,0,0,0,0,0,"AL",0.038
"9120",521,"198702.193.1250.4","NMFS",1987,4,15,105,30,41.166667,-69.4,0,0,0,0,0,"AL",0.038
"9121",526,"198702.194.1100.8","NMFS",1987,4,15,105,30,40.95,-69.216667,2,1,1,2,0,"AL",0.038
"9122",526,"198702.195.1090.5","NMFS",1987,4,15,105,30,40.816667,-69.383333,1,0,1,1,0,"AL",0.038
"9123",526,"198702.196.3550.1","NMFS",1987,4,16,106,30,40.9,-69.533333,0,0,0,0,0,"AL",0.038
"9124",526,"198702.197.1090.3","NMFS",1987,4,16,106,30,40.883333,-69.566667,0,0,0,0,0,"AL",0.038
"9125",526,"198702.198.3550.3","NMFS",1987,4,16,106,30,41.066667,-69.55,0,0,0,0,0,"AL",0.038
"9126",526,"198702.199.3550.4","NMFS",1987,4,16,106,30,41.066667,-69.633333,0,0,0,0,0,"AL",0.038
"9127",526,"198702.200.3550.5","NMFS",1987,4,16,106,30,40.95,-69.75,0,0,0,0,0,"AL",0.038
"9128",526,"198702.201.1090.1","NMFS",1987,4,16,106,30,40.833333,-69.833333,0,0,0,0,0,"AL",0.038
"9129",521,"198702.203.1250.3","NMFS",1987,4,21,111,30,41.516667,-69.6,3,1,2,3,0,"AL",0.038
"9130",521,"198702.204.1230.4","NMFS",1987,4,21,111,30,41.55,-69.366667,0,0,0,0,0,"AL",0.038
"9131",522,"198702.205.1240.1","NMFS",1987,4,21,111,30,41.5,-68.783333,0,0,0,0,0,"AL",0.038
"9132",522,"198702.206.1240.6","NMFS",1987,4,21,111,30,41.616667,-68.6,1,1,0,1,0,"AL",0.038
"9133",522,"198702.207.1240.3","NMFS",1987,4,21,111,30,41.816667,-68.516667,0,0,0,0,0,"AL",0.038
"9134",522,"198702.208.1200.6","NMFS",1987,4,21,111,30,41.666667,-68.35,0,0,0,0,0,"AL",0.038
"9135",522,"198702.209.1200.1","NMFS",1987,4,21,111,30,41.733333,-68.166667,0,0,0,0,0,"AL",0.038
"9136",522,"198702.210.1210.4","NMFS",1987,4,21,111,30,41.8,-68.216667,0,0,0,0,0,"AL",0.038
"9137",522,"198702.211.1220.3","NMFS",1987,4,21,111,30,41.866667,-68.15,0,0,0,0,0,"AL",0.038
"9138",522,"198702.212.1210.1","NMFS",1987,4,21,111,30,41.833333,-68.05,0,0,0,0,0,"AL",0.038
"9139",522,"198702.213.1220.2","NMFS",1987,4,21,111,30,41.95,-68.033333,0,0,0,0,0,"AL",0.038
"9140",522,"198702.214.1290.7","NMFS",1987,4,21,111,30,42,-68.083333,1,1,0,1,0,"AL",0.038
"9141",522,"198702.215.1220.1","NMFS",1987,4,21,111,30,42.016667,-67.983333,2,2,0,2,0,"AL",0.038
"9142",522,"198702.216.1210.2","NMFS",1987,4,22,112,30,41.95,-67.866667,0,0,0,0,0,"AL",0.038
"9143",561,"198702.217.1200.3","NMFS",1987,4,22,112,30,41.9,-67.6,0,0,0,0,0,"AL",0.038
"9144",561,"198702.218.1200.5","NMFS",1987,4,22,112,30,42.066667,-67.416667,0,0,0,0,0,"AL",0.038
"9145",561,"198702.219.1290.3","NMFS",1987,4,22,112,30,42.233333,-67.6,0,0,0,0,0,"AL",0.038
"9146",561,"198702.220.1290.6","NMFS",1987,4,22,112,30,42.333333,-67.583333,1,1,0,1,0,"AL",0.038
"9147",464,"198702.221.1300.1","NMFS",1987,4,22,112,30,42.433333,-67.333333,3,2,1,3,0,"AL",0.038
"9148",551,"198702.222.1300.3","NMFS",1987,4,22,112,30,42.333333,-67.083333,1,1,0,1,0,"AL",0.038
"9149",551,"198702.223.1220.4","NMFS",1987,4,22,112,30,42.183333,-66.783333,1,1,0,1,0,"AL",0.038
"9150",551,"198702.224.1160.5","NMFS",1987,4,22,112,30,42,-66.983333,0,0,0,0,0,"AL",0.038
"9151",561,"198702.225.1200.2","NMFS",1987,4,22,112,30,42.016667,-67.133333,0,0,0,0,0,"AL",0.038
"9152",561,"198702.226.1190.8","NMFS",1987,4,22,112,30,41.9,-67.266667,0,0,0,0,0,"AL",0.038
"9153",562,"198702.227.1190.4","NMFS",1987,4,22,112,25,41.766667,-67.233333,0,0,0,0,0,"AL",0.038
"9154",562,"198702.228.1190.2","NMFS",1987,4,23,113,30,41.65,-67.316667,0,0,0,0,0,"AL",0.038
"9155",562,"198702.229.1160.9","NMFS",1987,4,23,113,30,41.633333,-66.983333,0,0,0,0,0,"AL",0.038
"9156",562,"198702.230.1190.7","NMFS",1987,4,23,113,30,41.35,-67.2,0,0,0,0,0,"AL",0.038
"9157",562,"198702.231.1190.6","NMFS",1987,4,23,113,30,41.266667,-67.45,0,0,0,0,0,"AL",0.038
"9158",562,"198702.232.1160.10","NMFS",1987,4,23,113,30,41.1,-67.016667,0,0,0,0,0,"AL",0.038
"9159",525,"198702.233.1130.7","NMFS",1987,4,23,113,30,40.9,-67.133333,0,0,0,0,0,"AL",0.038
"9160",525,"198702.234.1130.5","NMFS",1987,4,23,113,30,40.95,-67.433333,0,0,0,0,0,"AL",0.038
"9161",525,"198702.235.1130.8","NMFS",1987,4,23,113,30,40.65,-67.583333,0,0,0,0,0,"AL",0.038
"9162",525,"198702.236.1130.2","NMFS",1987,4,23,113,30,40.616667,-67.916667,0,0,0,0,0,"AL",0.038
"9163",525,"198702.237.1130.6","NMFS",1987,4,23,113,30,40.533333,-68,0,0,0,0,0,"AL",0.038
"9164",525,"198702.238.1130.4","NMFS",1987,4,23,113,30,40.716667,-68.35,0,0,0,0,0,"AL",0.038
"9165",525,"198702.239.1130.1","NMFS",1987,4,24,114,30,40.55,-68.416667,0,0,0,0,0,"AL",0.038
"9166",525,"198702.240.1140.2","NMFS",1987,4,24,114,30,40.366667,-68.216667,0,0,0,0,0,"AL",0.038
"9167",525,"198702.241.1150.1","NMFS",1987,4,24,114,30,40.366667,-67.85,1,0,1,1,0,"AL",0.038
"9168",525,"198702.242.1140.1","NMFS",1987,4,24,114,30,40.516667,-67.633333,0,0,0,0,0,"AL",0.038
"9169",525,"198702.243.1150.2","NMFS",1987,4,24,114,30,40.433333,-67.366667,0,0,0,0,0,"AL",0.038
"9170",525,"198702.244.1140.3","NMFS",1987,4,24,114,30,40.533333,-67.266667,0,0,0,0,0,"AL",0.038
"9171",562,"198702.245.1170.4","NMFS",1987,4,24,114,30,40.966667,-66.516667,0,0,0,0,0,"AL",0.038
"9172",562,"198702.246.1180.2","NMFS",1987,4,24,114,30,40.983333,-66.466667,0,0,0,0,0,"AL",0.038
"9173",552,"198702.247.1180.1","NMFS",1987,4,24,114,30,41.233333,-66.25,0,0,0,0,0,"AL",0.038
"9174",552,"198702.248.1170.1","NMFS",1987,4,24,114,30,41.3,-66.266667,2,1,1,2,0,"AL",0.038
"9175",562,"198702.249.1160.1","NMFS",1987,4,25,115,30,41.283333,-66.466667,0,0,0,0,0,"AL",0.038
"9176",562,"198702.250.1160.4","NMFS",1987,4,25,115,30,41.3,-66.616667,0,0,0,0,0,"AL",0.038
"9177",562,"198702.251.1160.7","NMFS",1987,4,25,115,30,41.366667,-66.683333,0,0,0,0,0,"AL",0.038
"9178",552,"198702.253.1170.2","NMFS",1987,4,25,115,30,41.566667,-65.95,1,0,1,1,0,"AL",0.038
"9179",552,"198702.254.1180.3","NMFS",1987,4,25,115,30,41.6,-65.916667,4,3,1,4,0,"AL",0.038
"9180",552,"198702.255.1160.6","NMFS",1987,4,25,115,30,41.683333,-65.933333,0,0,0,0,0,"AL",0.038
"9181",552,"198702.256.1170.3","NMFS",1987,4,25,115,30,41.816667,-65.866667,0,0,0,0,0,"AL",0.038
"9182",552,"198702.257.1160.8","NMFS",1987,4,25,115,30,41.833333,-66.216667,0,0,0,0,0,"AL",0.038
"9183",552,"198702.258.1160.3","NMFS",1987,4,26,116,30,41.75,-66.583333,0,0,0,0,0,"AL",0.038
"9184",551,"198702.260.1160.2","NMFS",1987,4,26,116,30,42.016667,-66.35,0,0,0,0,0,"AL",0.038
"9185",551,"198702.261.1210.3","NMFS",1987,4,26,116,30,42.066667,-66.066667,0,0,0,0,0,"AL",0.038
"9186",464,"198702.262.1290.4","NMFS",1987,4,26,116,30,42.416667,-66.033333,2,1,1,2,0,"AL",0.038
"9187",464,"198702.263.1310.2","NMFS",1987,4,26,116,30,42.416667,-65.833333,9,6,3,9,0,"AL",0.038
"9188",464,"198702.265.1320.2","NMFS",1987,4,26,116,30,42.583333,-65.683333,0,0,0,0,0,"AL",0.038
"9189",464,"198702.269.1310.3","NMFS",1987,4,26,116,30,42.783333,-65.833333,0,0,0,0,0,"AL",0.038
"9190",464,"198702.270.1320.6","NMFS",1987,4,26,116,30,42.716667,-65.916667,0,0,0,0,0,"AL",0.038
"9191",464,"198702.271.1320.5","NMFS",1987,4,27,117,30,42.833333,-66.083333,0,0,0,0,0,"AL",0.038
"9192",464,"198702.273.1320.1","NMFS",1987,4,27,117,30,42.75,-66.333333,0,0,0,0,0,"AL",0.038
"9193",464,"198702.274.1310.6","NMFS",1987,4,27,117,30,42.85,-66.4,1,1,0,1,0,"AL",0.038
"9194",464,"198702.275.1310.1","NMFS",1987,4,27,117,30,42.883333,-66.516667,1,1,0,1,0,"AL",0.038
"9195",464,"198702.276.1290.8","NMFS",1987,4,27,117,30,42.633333,-66.816667,0,0,0,0,0,"AL",0.038
"9196",464,"198702.277.1300.2","NMFS",1987,4,27,117,30,42.483333,-67.016667,0,0,0,0,0,"AL",0.038
"9197",465,"198702.280.1330.5","NMFS",1987,4,28,118,30,43.633333,-66.4,0,0,0,0,0,"AL",0.038
"9198",465,"198702.281.1330.2","NMFS",1987,4,28,118,30,43.733333,-66.483333,2,1,1,2,0,"AL",0.038
"9199",465,"198702.282.1340.1","NMFS",1987,4,28,118,30,43.683333,-66.6,3,3,0,3,0,"AL",0.038
"9200",465,"198702.283.1340.6","NMFS",1987,4,28,118,30,43.6,-66.65,0,0,0,0,0,"AL",0.038
"9201",465,"198702.284.1340.5","NMFS",1987,4,28,118,30,43.55,-66.966667,0,0,0,0,0,"AL",0.038
"9202",466,"198702.285.1340.4","NMFS",1987,4,28,118,30,44.016667,-66.75,0,0,0,0,0,"AL",0.038
"9203",466,"198702.286.1351.2","NMFS",1987,4,28,118,30,44.116667,-66.75,3,1,2,3,0,"AL",0.038
"9204",466,"198702.287.1330.1","NMFS",1987,4,28,118,30,44.116667,-66.65,0,0,0,0,0,"AL",0.038
"9205",465,"198702.288.1330.3","NMFS",1987,4,28,118,30,43.85,-66.6,1,1,0,1,0,"AL",0.038
"9206",514,"198702.300.3590.1","NMFS",1987,4,21,111,26,41.833333,-70.35,22,11,11,15,7,"DE",0.038
"9207",514,"198702.301.3600.1","NMFS",1987,4,21,111,30,41.883333,-70.416667,20,12,8,13,7,"DE",0.038
"9208",514,"198702.302.3610.2","NMFS",1987,4,21,111,30,41.983333,-70.416667,102,49,53,97,5,"DE",0.038
"9209",514,"198702.303.3600.2","NMFS",1987,4,21,111,25,42,-70.5,36,21,15,34,2,"DE",0.038
"9210",514,"198702.304.3610.1","NMFS",1987,4,21,111,30,42.133333,-70.466667,17,7,10,16,1,"DE",0.038
"9211",514,"198702.305.1260.3","NMFS",1987,4,21,111,30,42.166667,-70.266667,1,0,1,1,0,"DE",0.038
"9212",514,"198702.308.3660.1","NMFS",1987,4,21,111,30,42.416667,-70.7,7,1,6,7,0,"DE",0.038
"9213",514,"198702.309.3660.2","NMFS",1987,4,21,111,30,42.533333,-70.633333,2,1,1,2,0,"DE",0.038
"9214",514,"198702.310.1270.2","NMFS",1987,4,21,111,30,42.483333,-69.9,0,0,0,0,0,"DE",0.038
"9215",521,"198702.311.1260.1","NMFS",1987,4,22,112,30,42.083333,-69.966667,1,1,0,1,0,"DE",0.038
"9216",521,"198702.312.1250.2","NMFS",1987,4,22,112,30,41.916667,-69.85,0,0,0,0,0,"DE",0.038
"9217",521,"198702.313.1230.3","NMFS",1987,4,22,112,30,41.85,-69.8,1,1,0,1,0,"DE",0.038
"9218",521,"198702.314.1240.2","NMFS",1987,4,22,112,30,41.966667,-69.683333,0,0,0,0,0,"DE",0.038
"9219",521,"198702.315.1280.1","NMFS",1987,4,22,112,30,41.966667,-69.516667,1,1,0,1,0,"DE",0.038
"9220",521,"198702.316.1280.2","NMFS",1987,4,22,112,30,42.05,-69.333333,0,0,0,0,0,"DE",0.038
"9221",521,"198702.317.1280.6","NMFS",1987,4,22,112,30,41.8,-69.2,2,2,0,2,0,"DE",0.038
"9222",521,"198702.318.1240.4","NMFS",1987,4,22,112,30,41.933333,-68.933333,0,0,0,0,0,"DE",0.038
"9223",522,"198702.319.1240.5","NMFS",1987,4,23,113,30,42.15,-68.566667,0,0,0,0,0,"DE",0.038
"9224",521,"198702.320.1280.4","NMFS",1987,4,23,113,30,42.316667,-68.933333,0,0,0,0,0,"DE",0.038
"9225",515,"198702.321.1280.3","NMFS",1987,4,23,113,30,42.5,-68.95,0,0,0,0,0,"DE",0.038
"9226",515,"198702.322.1370.4","NMFS",1987,4,23,113,30,42.716667,-68.8,0,0,0,0,0,"DE",0.038
"9227",515,"198702.323.1370.5","NMFS",1987,4,23,113,30,42.95,-68.683333,2,1,1,2,0,"DE",0.038
"9228",515,"198702.324.1370.1","NMFS",1987,4,23,113,30,42.95,-69.033333,0,0,0,0,0,"DE",0.038
"9229",515,"198702.325.1370.2","NMFS",1987,4,23,113,30,42.8,-69.216667,0,0,0,0,0,"DE",0.038
"9230",515,"198702.326.1280.7","NMFS",1987,4,23,113,30,42.7,-69.366667,1,1,0,1,0,"DE",0.038
"9231",514,"198702.327.1280.5","NMFS",1987,4,23,113,30,42.783333,-69.883333,0,0,0,0,0,"DE",0.038
"9232",513,"198702.328.1270.1","NMFS",1987,4,24,114,30,42.95,-70.066667,0,0,0,0,0,"DE",0.038
"9233",513,"198702.330.1400.2","NMFS",1987,4,24,114,30,42.866667,-70.533333,1,1,0,1,0,"DE",0.038
"9234",514,"198702.331.3640.1","NMFS",1987,4,24,114,30,42.766667,-70.733333,0,0,0,0,0,"DE",0.038
"9235",514,"198702.332.3650.1","NMFS",1987,4,24,114,30,42.7,-70.6,0,0,0,0,0,"DE",0.038
"9236",513,"198702.333.1260.4","NMFS",1987,4,25,115,30,43.066667,-70.05,0,0,0,0,0,"DE",0.038
"9237",513,"198702.334.1270.3","NMFS",1987,4,25,115,30,43.166667,-70.2,0,0,0,0,0,"DE",0.038
"9238",513,"198702.335.1400.1","NMFS",1987,4,25,115,30,43.416667,-70.266667,11,2,9,11,0,"DE",0.038
"9239",513,"198702.336.1400.3","NMFS",1987,4,25,115,30,43.616667,-69.75,0,0,0,0,0,"DE",0.038
"9240",513,"198702.337.1370.3","NMFS",1987,4,25,115,30,43.233333,-69.516667,0,0,0,0,0,"DE",0.038
"9241",513,"198702.338.1380.2","NMFS",1987,4,25,115,30,43.316667,-69.483333,0,0,0,0,0,"DE",0.038
"9242",513,"198702.339.1380.3","NMFS",1987,4,25,115,30,43.383333,-69.066667,0,0,0,0,0,"DE",0.038
"9243",512,"198702.340.1390.2","NMFS",1987,4,25,115,29,43.8,-69.066667,1,0,1,1,0,"DE",0.038
"9244",512,"198702.344.1380.4","NMFS",1987,4,26,116,30,43.666667,-68.266667,2,2,0,2,0,"DE",0.038
"9245",512,"198702.345.1380.1","NMFS",1987,4,26,116,30,43.55,-68.233333,0,0,0,0,0,"DE",0.038
"9246",515,"198702.346.1360.1","NMFS",1987,4,26,116,30,43.133333,-68.35,0,0,0,0,0,"DE",0.038
"9247",515,"198702.347.1360.4","NMFS",1987,4,26,116,30,43.333333,-68.016667,0,0,0,0,0,"DE",0.038
"9248",512,"198702.348.1360.5","NMFS",1987,4,26,116,30,43.416667,-67.783333,1,0,1,1,0,"DE",0.038
"9249",512,"198702.349.1360.3","NMFS",1987,4,26,116,30,43.566667,-67.866667,0,0,0,0,0,"DE",0.038
"9250",511,"198702.350.1380.5","NMFS",1987,4,27,117,22,44.216667,-67.716667,0,0,0,0,0,"DE",0.038
"9251",511,"198702.351.1390.5","NMFS",1987,4,27,117,30,44.316667,-67.716667,0,0,0,0,0,"DE",0.038
"9252",511,"198702.352.1351.1","NMFS",1987,4,27,117,30,44.316667,-67.333333,0,0,0,0,0,"DE",0.038
"9253",465,"198702.353.1340.3","NMFS",1987,4,27,117,30,43.8,-67.183333,0,0,0,0,0,"DE",0.038
"9254",465,"198702.354.1360.7","NMFS",1987,4,27,117,30,43.466667,-67.316667,0,0,0,0,0,"DE",0.038
"9255",515,"198702.355.1360.8","NMFS",1987,4,27,117,30,42.983333,-67.666667,0,0,0,0,0,"DE",0.038
"9256",464,"198702.356.1360.2","NMFS",1987,4,27,117,30,42.85,-67.416667,0,0,0,0,0,"DE",0.038
"9257",464,"198702.357.1360.6","NMFS",1987,4,27,117,30,42.766667,-67.466667,5,5,0,5,0,"DE",0.038
"9258",464,"198702.358.1290.2","NMFS",1987,4,27,117,30,42.75,-67.466667,1,1,0,1,0,"DE",0.038
"9259",515,"198702.359.1290.5","NMFS",1987,4,28,118,30,42.466667,-68.083333,1,1,0,1,0,"DE",0.038
"9260",522,"198702.360.1290.1","NMFS",1987,4,28,118,30,42.316667,-68.183333,0,0,0,0,0,"DE",0.038
"9261",526,"198705.165.1100.8","NMFS",1987,10,2,275,30,40.416667,-69.95,10,1,9,7,3,"AL",0.038
"9262",526,"198705.166.1100.1","NMFS",1987,10,2,275,30,40.283333,-69.933333,1,1,0,0,1,"AL",0.038
"9263",526,"198705.169.1120.1","NMFS",1987,10,2,275,30,39.95,-69.95,1,1,0,1,0,"AL",0.038
"9264",526,"198705.170.1110.1","NMFS",1987,10,2,275,30,39.966667,-69.666667,1,1,0,0,1,"AL",0.038
"9265",526,"198705.172.1100.5","NMFS",1987,10,3,276,30,40.083333,-69.25,0,0,0,0,0,"AL",0.038
"9266",526,"198705.173.1100.4","NMFS",1987,10,3,276,30,40.183333,-69.216667,0,0,0,0,0,"AL",0.038
"9267",525,"198705.175.1140.2","NMFS",1987,10,3,276,30,40.233333,-68.65,1,1,0,0,1,"AL",0.038
"9268",525,"198705.176.1140.1","NMFS",1987,10,3,276,30,40.283333,-68.333333,5,2,3,5,0,"AL",0.038
"9269",525,"198705.177.1140.3","NMFS",1987,10,3,276,30,40.433333,-68,0,0,0,0,0,"AL",0.038
"9270",525,"198705.178.1150.1","NMFS",1987,10,3,276,30,40.333333,-67.733333,0,0,0,0,0,"AL",0.038
"9271",525,"198705.179.1130.6","NMFS",1987,10,3,276,30,40.616667,-67.5,1,0,1,1,0,"AL",0.038
"9272",525,"198705.180.1130.1","NMFS",1987,10,3,276,30,40.966667,-67.283333,0,0,0,0,0,"AL",0.038
"9273",562,"198705.182.1160.5","NMFS",1987,10,4,277,30,41.016667,-66.55,0,0,0,0,0,"AL",0.038
"9274",562,"198705.183.1160.9","NMFS",1987,10,4,277,30,41.183333,-66.85,0,0,0,0,0,"AL",0.038
"9275",562,"198705.184.1160.3","NMFS",1987,10,4,277,30,41.366667,-66.683333,0,0,0,0,0,"AL",0.038
"9276",562,"198705.185.1160.4","NMFS",1987,10,4,277,30,41.45,-66.75,0,0,0,0,0,"AL",0.038
"9277",562,"198705.186.1190.7","NMFS",1987,10,5,278,30,41.516667,-67.25,6,4,2,6,0,"AL",0.038
"9278",562,"198705.187.1190.2","NMFS",1987,10,5,278,30,41.516667,-67.45,1,1,0,1,0,"AL",0.038
"9279",525,"198705.188.1190.8","NMFS",1987,10,5,278,30,41.266667,-67.8,0,0,0,0,0,"AL",0.038
"9280",525,"198705.189.1190.6","NMFS",1987,10,5,278,30,41.166667,-67.666667,0,0,0,0,0,"AL",0.038
"9281",525,"198705.191.1130.8","NMFS",1987,10,6,279,30,41.033333,-67.55,0,0,0,0,0,"AL",0.038
"9282",525,"198705.192.1190.1","NMFS",1987,10,6,279,30,41,-67.8,0,0,0,0,0,"AL",0.038
"9283",525,"198705.193.1130.4","NMFS",1987,10,6,279,30,40.866667,-67.583333,0,0,0,0,0,"AL",0.038
"9284",525,"198705.194.1130.7","NMFS",1987,10,6,279,30,40.866667,-67.85,0,0,0,0,0,"AL",0.038
"9285",525,"198705.195.1190.9","NMFS",1987,10,6,279,30,41.016667,-68.2,1,0,1,1,0,"AL",0.038
"9286",525,"198705.196.1130.3","NMFS",1987,10,6,279,30,40.816667,-68.166667,0,0,0,0,0,"AL",0.038
"9287",525,"198705.197.1130.2","NMFS",1987,10,6,279,30,40.666667,-67.983333,0,0,0,0,0,"AL",0.038
"9288",525,"198705.198.1130.9","NMFS",1987,10,6,279,30,40.683333,-68.333333,0,0,0,0,0,"AL",0.038
"9289",525,"198705.199.1190.5","NMFS",1987,10,6,279,30,40.683333,-68.5,0,0,0,0,0,"AL",0.038
"9290",525,"198705.200.1130.5","NMFS",1987,10,6,279,30,40.65,-68.716667,0,0,0,0,0,"AL",0.038
"9291",525,"198705.201.1130.10","NMFS",1987,10,6,279,30,40.966667,-68.716667,0,0,0,0,0,"AL",0.038
"9292",521,"198705.202.1230.4","NMFS",1987,10,6,279,30,41.05,-68.966667,0,0,0,0,0,"AL",0.038
"9293",521,"198705.203.1230.2","NMFS",1987,10,7,280,30,41.033333,-69.033333,0,0,0,0,0,"AL",0.038
"9294",526,"198705.204.1100.6","NMFS",1987,10,7,280,30,40.966667,-69.166667,2,0,2,2,0,"AL",0.038
"9295",526,"198705.205.1100.7","NMFS",1987,10,7,280,30,40.783333,-69.05,1,0,1,1,0,"AL",0.038
"9296",526,"198705.206.1090.1","NMFS",1987,10,7,280,30,40.7,-69.4,1,1,0,1,0,"AL",0.038
"9297",526,"198705.207.1090.4","NMFS",1987,10,7,280,30,40.816667,-69.766667,0,0,0,0,0,"AL",0.038
"9298",526,"198705.208.3550.1","NMFS",1987,10,7,280,30,40.966667,-69.733333,1,1,0,1,0,"AL",0.038
"9299",526,"198705.209.3550.5","NMFS",1987,10,7,280,30,40.916667,-69.533333,1,1,0,1,0,"AL",0.038
"9300",521,"198705.211.1250.2","NMFS",1987,10,7,280,30,41.283333,-69.383333,0,0,0,0,0,"AL",0.038
"9301",521,"198705.212.3550.2","NMFS",1987,10,7,280,27,41.366667,-69.566667,2,0,2,1,1,"AL",0.038
"9302",521,"198705.213.1250.1","NMFS",1987,10,7,280,30,41.516667,-69.533333,0,0,0,0,0,"AL",0.038
"9303",521,"198705.214.3550.4","NMFS",1987,10,8,281,21,41.6,-69.8,3,2,1,3,0,"AL",0.038
"9304",521,"198705.215.1250.3","NMFS",1987,10,8,281,20,41.633333,-69.766667,0,0,0,0,0,"AL",0.038
"9305",521,"198705.218.1230.5","NMFS",1987,10,8,281,30,41.916667,-69.816667,0,0,0,0,0,"AL",0.038
"9306",514,"198705.219.3560.2","NMFS",1987,10,8,281,30,42.05,-70.05,2,0,2,2,0,"AL",0.038
"9307",514,"198705.220.1260.3","NMFS",1987,10,8,281,30,42.233333,-70.15,0,0,0,0,0,"AL",0.038
"9308",514,"198705.221.3610.1","NMFS",1987,10,8,281,30,42.116667,-70.416667,0,0,0,0,0,"AL",0.038
"9309",514,"198705.222.3610.2","NMFS",1987,10,8,281,30,41.983333,-70.433333,94,30,64,90,4,"AL",0.038
"9310",514,"198705.223.3600.1","NMFS",1987,10,8,281,30,41.933333,-70.4,29,14,15,29,0,"AL",0.038
"9311",514,"198705.224.3600.2","NMFS",1987,10,8,281,30,41.883333,-70.366667,23,8,15,23,0,"AL",0.038
"9312",514,"198705.226.3590.2","NMFS",1987,10,8,281,30,41.816667,-70.333333,11,5,6,10,1,"AL",0.038
"9313",514,"198705.227.3580.1","NMFS",1987,10,8,281,30,41.766667,-70.383333,21,10,11,16,5,"AL",0.038
"9314",521,"198705.228.1280.5","NMFS",1987,10,14,287,30,41.933333,-69.566667,0,0,0,0,0,"AL",0.038
"9315",521,"198705.229.1280.1","NMFS",1987,10,14,287,30,42.116667,-69.25,0,0,0,0,0,"AL",0.038
"9316",521,"198705.230.1240.3","NMFS",1987,10,14,287,30,42.066667,-68.95,0,0,0,0,0,"AL",0.038
"9317",521,"198705.231.1240.5","NMFS",1987,10,14,287,30,41.8,-69.033333,0,0,0,0,0,"AL",0.038
"9318",522,"198705.232.1240.4","NMFS",1987,10,14,287,30,41.916667,-68.683333,0,0,0,0,0,"AL",0.038
"9319",522,"198705.233.1240.6","NMFS",1987,10,14,287,30,41.916667,-68.516667,0,0,0,0,0,"AL",0.038
"9320",522,"198705.234.1240.1","NMFS",1987,10,14,287,30,41.866667,-68.383333,0,0,0,0,0,"AL",0.038
"9321",522,"198705.235.1240.2","NMFS",1987,10,15,288,30,41.483333,-68.8,0,0,0,0,0,"AL",0.038
"9322",522,"198705.236.1230.3","NMFS",1987,10,15,288,30,41.483333,-68.533333,0,0,0,0,0,"AL",0.038
"9323",522,"198705.237.1230.1","NMFS",1987,10,15,288,30,41.4,-68.466667,1,0,1,1,0,"AL",0.038
"9324",522,"198705.238.1200.6","NMFS",1987,10,15,288,30,41.416667,-68.283333,3,2,1,3,0,"AL",0.038
"9325",522,"198705.239.1200.4","NMFS",1987,10,15,288,30,41.633333,-68.266667,0,0,0,0,0,"AL",0.038
"9326",522,"198705.240.1200.5","NMFS",1987,10,15,288,30,41.583333,-67.966667,0,0,0,0,0,"AL",0.038
"9327",522,"198705.241.1200.1","NMFS",1987,10,15,288,30,41.7,-68.033333,5,2,3,4,1,"AL",0.038
"9328",522,"198705.242.1220.1","NMFS",1987,10,15,288,30,41.95,-67.9,0,0,0,0,0,"AL",0.038
"9329",522,"198705.243.1200.2","NMFS",1987,10,15,288,30,41.766667,-67.7,0,0,0,0,0,"AL",0.038
"9330",562,"198705.244.1190.3","NMFS",1987,10,15,288,30,41.733333,-67.533333,17,12,5,14,3,"AL",0.038
"9331",561,"198705.245.1200.3","NMFS",1987,10,15,288,30,41.95,-67.333333,1,0,1,1,0,"AL",0.038
"9332",561,"198705.246.1210.1","NMFS",1987,10,15,288,30,42.066667,-67.516667,0,0,0,0,0,"AL",0.038
"9333",561,"198705.247.1220.3","NMFS",1987,10,16,289,30,42.15,-67.616667,0,0,0,0,0,"AL",0.038
"9334",515,"198705.248.1290.7","NMFS",1987,10,16,289,30,42.35,-68,0,0,0,0,0,"AL",0.038
"9335",464,"198705.249.1290.6","NMFS",1987,10,16,289,30,42.35,-67.633333,0,0,0,0,0,"AL",0.038
"9336",561,"198705.250.1290.4","NMFS",1987,10,16,289,30,42.283333,-67.333333,0,0,0,0,0,"AL",0.038
"9337",551,"198705.251.1300.2","NMFS",1987,10,16,289,30,42.316667,-67.1,0,0,0,0,0,"AL",0.038
"9338",551,"198705.252.1220.2","NMFS",1987,10,16,289,30,42.2,-67,2,2,0,2,0,"AL",0.038
"9339",561,"198705.253.1210.3","NMFS",1987,10,16,289,30,42.116667,-67.15,0,0,0,0,0,"AL",0.038
"9340",561,"198705.254.1190.4","NMFS",1987,10,16,289,30,42,-67.033333,5,3,2,4,1,"AL",0.038
"9341",551,"198705.255.1210.2","NMFS",1987,10,16,289,30,42.083333,-66.833333,0,0,0,0,0,"AL",0.038
"9342",551,"198705.256.1220.4","NMFS",1987,10,16,289,30,42.166667,-66.55,1,0,1,1,0,"AL",0.038
"9343",551,"198705.257.1160.10","NMFS",1987,10,17,290,30,42,-66.766667,2,0,2,2,0,"AL",0.038
"9344",551,"198705.258.1160.1","NMFS",1987,10,17,290,30,41.866667,-66.583333,0,0,0,0,0,"AL",0.038
"9345",552,"198705.259.1160.2","NMFS",1987,10,17,290,30,41.766667,-66.483333,1,0,1,1,0,"AL",0.038
"9346",552,"198705.260.1160.7","NMFS",1987,10,17,290,30,41.683333,-66.6,0,0,0,0,0,"AL",0.038
"9347",552,"198705.261.1160.8","NMFS",1987,10,17,290,30,41.6,-66.283333,0,0,0,0,0,"AL",0.038
"9348",552,"198705.262.1170.1","NMFS",1987,10,17,290,30,41.383333,-66.133333,2,2,0,2,0,"AL",0.038
"9349",552,"198705.263.1170.2","NMFS",1987,10,17,290,30,41.55,-66,0,0,0,0,0,"AL",0.038
"9350",552,"198705.264.1180.1","NMFS",1987,10,18,291,30,41.616667,-65.85,0,0,0,0,0,"AL",0.038
"9351",552,"198705.265.1170.3","NMFS",1987,10,18,291,30,41.816667,-65.883333,0,0,0,0,0,"AL",0.038
"9352",551,"198705.266.1160.6","NMFS",1987,10,18,291,30,41.883333,-66.116667,1,1,0,1,0,"AL",0.038
"9353",551,"198705.267.1180.2","NMFS",1987,10,19,292,30,42.016667,-65.85,0,0,0,0,0,"AL",0.038
"9354",551,"198705.268.1210.4","NMFS",1987,10,19,292,30,42.066667,-66.116667,0,0,0,0,0,"AL",0.038
"9355",464,"198705.269.1290.3","NMFS",1987,10,19,292,30,42.35,-66.166667,0,0,0,0,0,"AL",0.038
"9356",464,"198705.272.1290.2","NMFS",1987,10,19,292,30,42.516667,-66.833333,0,0,0,0,0,"AL",0.038
"9357",464,"198705.273.1300.3","NMFS",1987,10,19,292,30,42.45,-66.816667,0,0,0,0,0,"AL",0.038
"9358",464,"198705.274.1300.1","NMFS",1987,10,19,292,30,42.533333,-67.066667,0,0,0,0,0,"AL",0.038
"9359",464,"198705.275.1290.1","NMFS",1987,10,20,293,30,42.75,-67.316667,1,0,1,1,0,"AL",0.038
"9360",464,"198705.276.1360.1","NMFS",1987,10,20,293,30,42.933333,-67.533333,3,1,2,3,0,"AL",0.038
"9361",464,"198705.277.1360.3","NMFS",1987,10,20,293,30,42.783333,-66.866667,0,0,0,0,0,"AL",0.038
"9362",464,"198705.278.1360.7","NMFS",1987,10,20,293,30,42.866667,-66.85,0,0,0,0,0,"AL",0.038
"9363",465,"198705.279.1340.4","NMFS",1987,10,20,293,23,43.133333,-66.883333,0,0,0,0,0,"AL",0.038
"9364",465,"198705.280.1340.3","NMFS",1987,10,20,293,30,43.2,-67.016667,0,0,0,0,0,"AL",0.038
"9365",465,"198705.281.1360.4","NMFS",1987,10,20,293,30,43.283333,-67.066667,0,0,0,0,0,"AL",0.038
"9366",465,"198705.282.1340.5","NMFS",1987,10,20,293,30,43.3,-66.883333,0,0,0,0,0,"AL",0.038
"9367",465,"198705.284.1330.4","NMFS",1987,10,20,293,21,43.383333,-66.483333,1,0,1,1,0,"AL",0.038
"9368",465,"198705.285.1330.3","NMFS",1987,10,21,294,24,43.633333,-66.366667,7,5,2,7,0,"AL",0.038
"9369",465,"198705.286.1330.2","NMFS",1987,10,21,294,30,43.983333,-66.5,16,9,7,16,0,"AL",0.038
"9370",465,"198705.287.1340.1","NMFS",1987,10,21,294,30,43.816667,-67.166667,1,1,0,1,0,"AL",0.038
"9371",511,"198705.288.1340.2","NMFS",1987,10,21,294,30,44,-67.066667,0,0,0,0,0,"AL",0.038
"9372",466,"198705.289.1340.6","NMFS",1987,10,21,294,30,44.033333,-66.783333,0,0,0,0,0,"AL",0.038
"9373",466,"198705.290.1330.1","NMFS",1987,10,21,294,30,44.083333,-66.7,0,0,0,0,0,"AL",0.038
"9374",466,"198705.291.1351.1","NMFS",1987,10,21,294,30,44.15,-66.816667,0,0,0,0,0,"AL",0.038
"9375",511,"198705.292.1351.2","NMFS",1987,10,21,294,29,44.35,-67.266667,0,0,0,0,0,"AL",0.038
"9376",511,"198705.293.1390.4","NMFS",1987,10,22,295,25,44.3,-67.766667,7,7,0,6,1,"AL",0.038
"9377",512,"198705.294.1390.2","NMFS",1987,10,22,295,30,44.183333,-67.916667,4,3,1,4,0,"AL",0.038
"9378",512,"198705.295.1390.3","NMFS",1987,10,22,295,30,44.133333,-68.066667,6,2,4,3,3,"AL",0.038
"9379",513,"198705.297.1400.1","NMFS",1987,10,22,295,30,43.433333,-70.1,0,0,0,0,0,"AL",0.038
"9380",513,"198705.298.1400.3","NMFS",1987,10,22,295,30,43.15,-70.35,0,0,0,0,0,"AL",0.038
"9381",514,"198705.299.3660.2","NMFS",1987,10,27,300,30,42.2,-70.483333,2,0,2,2,0,"AL",0.038
"9382",514,"198705.300.3630.1","NMFS",1987,10,27,300,24.1,42.233333,-70.683333,115,61,54,96,19,"AL",0.038
"9383",514,"198705.302.3660.1","NMFS",1987,10,27,300,30,42.333333,-70.633333,0,0,0,0,0,"AL",0.038
"9384",514,"198705.303.1260.2","NMFS",1987,10,27,300,30,42.316667,-70.583333,3,1,2,3,0,"AL",0.038
"9385",514,"198705.304.1260.5","NMFS",1987,10,27,300,30,42.45,-70.3,0,0,0,0,0,"AL",0.038
"9386",514,"198705.305.1270.2","NMFS",1987,10,27,300,30,42.533333,-69.966667,0,0,0,0,0,"AL",0.038
"9387",514,"198705.306.1270.4","NMFS",1987,10,27,300,30,42.633333,-70.05,0,0,0,0,0,"AL",0.038
"9388",514,"198705.307.1260.1","NMFS",1987,10,27,300,30,42.783333,-70.216667,0,0,0,0,0,"AL",0.038
"9389",514,"198705.308.3650.1","NMFS",1987,10,27,300,30,42.766667,-70.7,4,1,3,4,0,"AL",0.038
"9390",514,"198705.309.3630.2","NMFS",1987,10,27,300,20,42.716667,-70.733333,4,1,3,3,1,"AL",0.038
"9391",514,"198705.310.3640.2","NMFS",1987,10,28,301,30,42.816667,-70.766667,6,3,3,6,0,"AL",0.038
"9392",513,"198705.311.1400.2","NMFS",1987,10,28,301,30,42.9,-70.6,3,2,1,3,0,"AL",0.038
"9393",513,"198705.312.1270.1","NMFS",1987,10,28,301,30,43.166667,-70.05,0,0,0,0,0,"AL",0.038
"9394",513,"198705.313.1270.3","NMFS",1987,10,28,301,30,42.933333,-70.166667,0,0,0,0,0,"AL",0.038
"9395",513,"198705.314.1260.4","NMFS",1987,10,28,301,26,42.9,-70.083333,0,0,0,0,0,"AL",0.038
"9396",514,"198705.315.1280.2","NMFS",1987,10,28,301,30,42.75,-69.866667,0,0,0,0,0,"AL",0.038
"9397",514,"198705.316.1280.7","NMFS",1987,10,28,301,30,42.766667,-69.7,0,0,0,0,0,"AL",0.038
"9398",515,"198705.317.1370.3","NMFS",1987,10,29,302,30,42.783333,-69.333333,0,0,0,0,0,"AL",0.038
"9399",515,"198705.318.1280.4","NMFS",1987,10,29,302,30,42.466667,-68.966667,0,0,0,0,0,"AL",0.038
"9400",521,"198705.319.1280.3","NMFS",1987,10,29,302,30,42.266667,-68.95,0,0,0,0,0,"AL",0.038
"9401",515,"198705.320.1280.6","NMFS",1987,10,29,302,30,42.433333,-68.6,0,0,0,0,0,"AL",0.038
"9402",515,"198705.321.1370.4","NMFS",1987,10,29,302,30,42.666667,-68.783333,0,0,0,0,0,"AL",0.038
"9403",515,"198705.322.1370.2","NMFS",1987,10,29,302,30,42.933333,-69.05,0,0,0,0,0,"AL",0.038
"9404",513,"198705.323.1370.5","NMFS",1987,10,29,302,30,43.05,-69.5,0,0,0,0,0,"AL",0.038
"9405",513,"198705.324.1380.2","NMFS",1987,10,29,302,30,43.3,-69.6,0,0,0,0,0,"AL",0.038
"9406",513,"198705.325.1380.5","NMFS",1987,10,30,303,30,43.5,-69.25,0,0,0,0,0,"AL",0.038
"9407",512,"198705.326.1380.3","NMFS",1987,10,30,303,30,43.35,-68.8,0,0,0,0,0,"AL",0.038
"9408",515,"198705.327.1370.1","NMFS",1987,10,30,303,30,43.283333,-68.616667,0,0,0,0,0,"AL",0.038
"9409",512,"198705.328.1380.1","NMFS",1987,10,30,303,30,43.45,-68.25,0,0,0,0,0,"AL",0.038
"9410",512,"198705.329.1380.4","NMFS",1987,10,30,303,30,43.733333,-68.033333,0,0,0,0,0,"AL",0.038
"9411",512,"198705.330.1360.6","NMFS",1987,10,30,303,30,43.8,-67.7,0,0,0,0,0,"AL",0.038
"9412",465,"198705.331.1360.8","NMFS",1987,10,30,303,30,43.616667,-67.616667,0,0,0,0,0,"AL",0.038
"9413",515,"198705.332.1360.5","NMFS",1987,10,30,303,30,43.333333,-67.75,0,0,0,0,0,"AL",0.038
"9414",465,"198705.333.1360.2","NMFS",1987,10,30,303,30,43.25,-67.65,0,0,0,0,0,"AL",0.038
"9415",464,"198705.334.1290.8","NMFS",1987,10,31,304,30,42.366667,-65.9,0,0,0,0,0,"AL",0.038
"9416",522,"198705.412.1290.5","NMFS",1987,11,5,309,30,42.1,-68.2,0,0,0,0,0,"AL",0.038
"9417",526,"198801.169.1090.4","NMFS",1988,3,25,85,30,40.916667,-69.683333,0,0,0,0,0,"AL",0.038
"9418",526,"198801.170.3550.3","NMFS",1988,3,25,85,30,41.033333,-69.583333,0,0,0,0,0,"AL",0.038
"9419",526,"198801.171.3550.4","NMFS",1988,3,25,85,30,40.9,-69.466667,0,0,0,0,0,"AL",0.038
"9420",526,"198801.172.1100.1","NMFS",1988,3,25,85,30,40.916667,-69.133333,0,0,0,0,0,"AL",0.038
"9421",526,"198801.173.1130.6","NMFS",1988,3,25,85,30,40.983333,-68.883333,0,0,0,0,0,"AL",0.038
"9422",522,"198801.174.1190.5","NMFS",1988,3,25,85,30,41.016667,-68.55,1,1,0,1,0,"AL",0.038
"9423",525,"198801.175.1190.1","NMFS",1988,3,25,85,30,40.916667,-68.366667,1,0,1,1,0,"AL",0.038
"9424",525,"198801.176.1190.3","NMFS",1988,3,26,86,30,40.733333,-68.45,0,0,0,0,0,"AL",0.038
"9425",526,"198801.177.1130.5","NMFS",1988,3,26,86,30,40.65,-68.85,0,0,0,0,0,"AL",0.038
"9426",526,"198801.178.1100.7","NMFS",1988,3,26,86,30,40.233333,-69.183333,0,0,0,0,0,"AL",0.038
"9427",526,"198801.179.1110.2","NMFS",1988,3,26,86,30,40.116667,-68.916667,0,0,0,0,0,"AL",0.038
"9428",525,"198801.180.1130.4","NMFS",1988,3,26,86,30,40.283333,-68.65,0,0,0,0,0,"AL",0.038
"9429",525,"198801.181.1150.1","NMFS",1988,3,26,86,30,40.266667,-68.25,2,2,0,2,0,"AL",0.038
"9430",525,"198801.182.1140.3","NMFS",1988,3,26,86,30,40.45,-68.083333,0,0,0,0,0,"AL",0.038
"9431",525,"198801.183.1130.2","NMFS",1988,3,26,86,30,40.55,-68.25,0,0,0,0,0,"AL",0.038
"9432",525,"198801.184.1130.9","NMFS",1988,3,26,86,30,40.55,-68.15,0,0,0,0,0,"AL",0.038
"9433",525,"198801.185.1130.1","NMFS",1988,3,26,86,30,40.733333,-67.866667,1,0,1,1,0,"AL",0.038
"9434",525,"198801.186.1140.1","NMFS",1988,3,27,87,30,40.466667,-67.55,0,0,0,0,0,"AL",0.038
"9435",525,"198801.187.1140.2","NMFS",1988,3,27,87,30,40.683333,-66.933333,0,0,0,0,0,"AL",0.038
"9436",525,"198801.188.1130.8","NMFS",1988,3,27,87,30,40.85,-67.316667,0,0,0,0,0,"AL",0.038
"9437",525,"198801.189.1130.7","NMFS",1988,3,27,87,30,40.9,-67.266667,0,0,0,0,0,"AL",0.038
"9438",525,"198801.190.1130.3","NMFS",1988,3,27,87,30,41.016667,-67.583333,1,0,1,1,0,"AL",0.038
"9439",525,"198801.191.1190.8","NMFS",1988,3,27,87,30,41.183333,-67.9,0,0,0,0,0,"AL",0.038
"9440",525,"198801.192.1190.4","NMFS",1988,3,27,87,30,41.133333,-68.216667,0,0,0,0,0,"AL",0.038
"9441",562,"198801.193.1190.9","NMFS",1988,3,28,88,30,41.483333,-67.516667,5,3,2,4,1,"AL",0.038
"9442",562,"198801.194.1190.2","NMFS",1988,3,28,88,30,41.583333,-67.233333,0,0,0,0,0,"AL",0.038
"9443",562,"198801.195.1190.6","NMFS",1988,3,28,88,30,41.333333,-67.183333,0,0,0,0,0,"AL",0.038
"9444",562,"198801.196.1190.7","NMFS",1988,3,28,88,30,41.3,-67.316667,0,0,0,0,0,"AL",0.038
"9445",562,"198801.197.1160.1","NMFS",1988,3,28,88,30,41.166667,-67.133333,0,0,0,0,0,"AL",0.038
"9446",562,"198801.198.1160.7","NMFS",1988,3,28,88,30,41.25,-66.716667,0,0,0,0,0,"AL",0.038
"9447",562,"198801.199.1160.2","NMFS",1988,3,28,88,30,41.416667,-66.75,0,0,0,0,0,"AL",0.038
"9448",562,"198801.200.1160.10","NMFS",1988,3,28,88,30,41.5,-66.6,1,1,0,1,0,"AL",0.038
"9449",562,"198801.201.1170.2","NMFS",1988,3,28,88,30,41.133333,-66.45,0,0,0,0,0,"AL",0.038
"9450",552,"198801.202.1170.1","NMFS",1988,3,28,88,30,41.266667,-66.283333,1,1,0,1,0,"AL",0.038
"9451",552,"198801.203.1180.1","NMFS",1988,3,29,89,30,41.516667,-65.933333,2,2,0,2,0,"AL",0.038
"9452",552,"198801.204.1160.9","NMFS",1988,3,29,89,30,41.65,-66.166667,0,0,0,0,0,"AL",0.038
"9453",552,"198801.205.1170.3","NMFS",1988,3,29,89,30,41.75,-65.866667,0,0,0,0,0,"AL",0.038
"9454",551,"198801.206.1160.8","NMFS",1988,3,29,89,30,41.866667,-66,0,0,0,0,0,"AL",0.038
"9455",551,"198801.207.1290.3","NMFS",1988,3,29,89,30,42.216667,-66.083333,2,2,0,2,0,"AL",0.038
"9456",551,"198801.208.1290.1","NMFS",1988,3,29,89,30,42.183333,-66.233333,0,0,0,0,0,"AL",0.038
"9457",464,"198801.209.1290.6","NMFS",1988,3,30,90,30,42.45,-66.216667,1,1,0,1,0,"AL",0.038
"9458",551,"198801.210.1220.2","NMFS",1988,3,30,90,30,42.133333,-66.433333,1,1,0,1,0,"AL",0.038
"9459",551,"198801.211.1210.3","NMFS",1988,3,30,90,30,42.083333,-66.45,0,0,0,0,0,"AL",0.038
"9460",551,"198801.212.1160.4","NMFS",1988,3,30,90,30,42,-66.666667,0,0,0,0,0,"AL",0.038
"9461",551,"198801.213.1160.6","NMFS",1988,3,30,90,30,41.85,-66.816667,1,0,1,1,0,"AL",0.038
"9462",561,"198801.214.1160.5","NMFS",1988,3,30,90,30,41.916667,-66.966667,1,0,1,1,0,"AL",0.038
"9463",551,"198801.215.1160.3","NMFS",1988,3,30,90,30,41.983333,-67,6,2,4,6,0,"AL",0.038
"9464",551,"198801.216.1210.2","NMFS",1988,3,30,90,30,42.116667,-67.05,0,0,0,0,0,"AL",0.038
"9465",551,"198801.217.1290.2","NMFS",1988,3,30,90,30,42.3,-67.066667,0,0,0,0,0,"AL",0.038
"9466",551,"198801.218.1300.2","NMFS",1988,3,30,90,30,42.316667,-66.9,0,0,0,0,0,"AL",0.038
"9467",464,"198801.219.1300.3","NMFS",1988,3,30,90,30,42.533333,-66.983333,2,1,1,2,0,"AL",0.038
"9468",464,"198801.220.1300.1","NMFS",1988,3,31,91,30,42.35,-67.383333,7,5,2,7,0,"AL",0.038
"9469",561,"198801.221.1200.1","NMFS",1988,3,31,91,30,42.083333,-67.266667,0,0,0,0,0,"AL",0.038
"9470",561,"198801.222.1210.4","NMFS",1988,3,31,91,30,42.066667,-67.55,0,0,0,0,0,"AL",0.038
"9471",561,"198801.223.1220.3","NMFS",1988,3,31,91,30,42.083333,-67.6,9,5,4,9,0,"AL",0.038
"9472",561,"198801.224.1200.4","NMFS",1988,3,31,91,30,41.883333,-67.533333,0,0,0,0,0,"AL",0.038
"9473",522,"198801.225.1200.6","NMFS",1988,3,31,91,30,41.8,-67.8,3,3,0,3,0,"AL",0.038
"9474",522,"198801.226.1210.1","NMFS",1988,3,31,91,30,41.95,-67.883333,1,0,1,1,0,"AL",0.038
"9475",522,"198801.227.1220.1","NMFS",1988,3,31,91,30,42.016667,-68.033333,0,0,0,0,0,"AL",0.038
"9476",522,"198801.228.1220.4","NMFS",1988,3,31,91,30,41.883333,-68.066667,1,1,0,1,0,"AL",0.038
"9477",522,"198801.229.1200.2","NMFS",1988,3,31,91,30,41.566667,-67.866667,0,0,0,0,0,"AL",0.038
"9478",522,"198801.230.1200.5","NMFS",1988,3,31,91,30,41.583333,-68.216667,1,0,1,1,0,"AL",0.038
"9479",522,"198801.231.1200.3","NMFS",1988,3,31,91,30,41.566667,-68.333333,0,0,0,0,0,"AL",0.038
"9480",521,"198801.233.3550.6","NMFS",1988,4,5,96,30,41.433333,-69.716667,5,4,1,4,1,"AL",0.038
"9481",521,"198801.234.3550.1","NMFS",1988,4,5,96,30,41.416667,-69.65,0,0,0,0,0,"AL",0.038
"9482",521,"198801.235.3550.2","NMFS",1988,4,5,96,30,41.6,-69.783333,3,2,1,3,0,"AL",0.038
"9483",521,"198801.236.1250.1","NMFS",1988,4,5,96,30,41.816667,-69.866667,0,0,0,0,0,"AL",0.038
"9484",521,"198801.238.3560.2","NMFS",1988,4,5,96,30,41.983333,-69.983333,0,0,0,0,0,"AL",0.038
"9485",521,"198801.239.1240.4","NMFS",1988,4,5,96,30,41.833333,-69.516667,0,0,0,0,0,"AL",0.038
"9486",521,"198801.240.1240.6","NMFS",1988,4,5,96,30,41.783333,-69.1,1,1,0,1,0,"AL",0.038
"9487",521,"198801.241.1240.3","NMFS",1988,4,5,96,30,41.666667,-69.216667,3,2,1,3,0,"AL",0.038
"9488",521,"198801.242.1230.4","NMFS",1988,4,5,96,30,41.483333,-69.35,0,0,0,0,0,"AL",0.038
"9489",521,"198801.243.1250.3","NMFS",1988,4,6,97,30,41.416667,-69.383333,1,1,0,1,0,"AL",0.038
"9490",521,"198801.244.1250.4","NMFS",1988,4,6,97,30,41.333333,-69.45,0,0,0,0,0,"AL",0.038
"9491",521,"198801.245.1250.2","NMFS",1988,4,6,97,30,41.233333,-69.383333,1,1,0,1,0,"AL",0.038
"9492",521,"198801.246.1240.5","NMFS",1988,4,6,97,30,41.216667,-69.066667,0,0,0,0,0,"AL",0.038
"9493",521,"198801.247.1230.3","NMFS",1988,4,6,97,30,41.166667,-68.933333,0,0,0,0,0,"AL",0.038
"9494",522,"198801.248.1230.1","NMFS",1988,4,6,97,30,41.216667,-68.666667,0,0,0,0,0,"AL",0.038
"9495",522,"198801.249.1230.2","NMFS",1988,4,6,97,30,41.3,-68.65,0,0,0,0,0,"AL",0.038
"9496",522,"198801.250.1290.9","NMFS",1988,4,6,97,30,41.816667,-68.45,1,0,1,1,0,"AL",0.038
"9497",522,"198801.251.1240.1","NMFS",1988,4,6,97,30,41.883333,-68.483333,1,1,0,1,0,"AL",0.038
"9498",522,"198801.252.1240.2","NMFS",1988,4,7,98,30,42.283333,-68.7,0,0,0,0,0,"AL",0.038
"9499",515,"198801.253.1290.4","NMFS",1988,4,7,98,30,42.35,-68.35,0,0,0,0,0,"AL",0.038
"9500",515,"198801.254.1290.8","NMFS",1988,4,7,98,30,42.433333,-68.45,0,0,0,0,0,"AL",0.038
"9501",515,"198801.255.1290.7","NMFS",1988,4,7,98,30,42.683333,-68.4,0,0,0,0,0,"AL",0.038
"9502",515,"198801.256.1290.5","NMFS",1988,4,7,98,30,42.716667,-68.333333,0,0,0,0,0,"AL",0.038
"9503",515,"198801.257.1280.2","NMFS",1988,4,7,98,30,42.716667,-68.516667,0,0,0,0,0,"AL",0.038
"9504",515,"198801.258.1370.1","NMFS",1988,4,7,98,30,42.833333,-68.816667,0,0,0,0,0,"AL",0.038
"9505",515,"198801.259.1370.5","NMFS",1988,4,7,98,30,42.9,-68.683333,0,0,0,0,0,"AL",0.038
"9506",515,"198801.260.1370.2","NMFS",1988,4,8,99,30,42.983333,-68.65,0,0,0,0,0,"AL",0.038
"9507",515,"198801.261.1380.1","NMFS",1988,4,8,99,30,43.283333,-68.45,0,0,0,0,0,"AL",0.038
"9508",515,"198801.262.1360.1","NMFS",1988,4,8,99,30,43.183333,-68.283333,1,1,0,1,0,"AL",0.038
"9509",515,"198801.263.1360.5","NMFS",1988,4,8,99,30,42.983333,-68.033333,0,0,0,0,0,"AL",0.038
"9510",464,"198801.264.1360.8","NMFS",1988,4,8,99,30,42.833333,-67.616667,1,0,1,1,0,"AL",0.038
"9511",465,"198801.265.1340.5","NMFS",1988,4,8,99,30,43.1,-66.916667,0,0,0,0,0,"AL",0.038
"9512",465,"198801.269.1330.1","NMFS",1988,4,9,100,30,43.416667,-66.35,14,8,6,13,1,"AL",0.038
"9513",465,"198801.270.1330.2","NMFS",1988,4,9,100,30,43.5,-66.433333,2,1,1,2,0,"AL",0.038
"9514",465,"198801.271.1340.3","NMFS",1988,4,9,100,30,43.533333,-66.65,0,0,0,0,0,"AL",0.038
"9515",465,"198801.272.1340.6","NMFS",1988,4,9,100,30,43.433333,-66.683333,0,0,0,0,0,"AL",0.038
"9516",465,"198801.273.1340.1","NMFS",1988,4,9,100,30,43.316667,-66.766667,0,0,0,0,0,"AL",0.038
"9517",511,"198801.274.1390.4","NMFS",1988,4,10,101,30,44.333333,-67.633333,0,0,0,0,0,"AL",0.038
"9518",512,"198801.275.1380.5","NMFS",1988,4,11,102,30,44.083333,-67.866667,0,0,0,0,0,"AL",0.038
"9519",512,"198801.276.1390.5","NMFS",1988,4,11,102,30,44.05,-67.933333,0,0,0,0,0,"AL",0.038
"9520",512,"198801.277.1380.2","NMFS",1988,4,11,102,30,43.766667,-68.633333,0,0,0,0,0,"AL",0.038
"9521",512,"198801.278.1390.1","NMFS",1988,4,11,102,22,43.9,-68.633333,2,2,0,2,0,"AL",0.038
"9522",512,"198801.279.1390.3","NMFS",1988,4,11,102,26,43.933333,-68.766667,1,1,0,1,0,"AL",0.038
"9523",512,"198801.280.1390.2","NMFS",1988,4,11,102,30,43.816667,-69.066667,0,0,0,0,0,"AL",0.038
"9524",511,"198801.281.1351.2","NMFS",1988,4,13,104,30,44.316667,-67.166667,0,0,0,0,0,"AL",0.038
"9525",511,"198801.282.1351.1","NMFS",1988,4,13,104,30,44.216667,-66.866667,0,0,0,0,0,"AL",0.038
"9526",466,"198801.283.1330.4","NMFS",1988,4,13,104,30,44.116667,-66.583333,0,0,0,0,0,"AL",0.038
"9527",511,"198801.284.1340.4","NMFS",1988,4,13,104,30,43.85,-66.983333,0,0,0,0,0,"AL",0.038
"9528",465,"198801.285.1340.2","NMFS",1988,4,13,104,30,43.5,-66.85,0,0,0,0,0,"AL",0.038
"9529",465,"198801.286.1360.3","NMFS",1988,4,13,104,30,43.533333,-67.133333,0,0,0,0,0,"AL",0.038
"9530",465,"198801.287.1360.2","NMFS",1988,4,13,104,30,43.633333,-67.383333,0,0,0,0,0,"AL",0.038
"9531",465,"198801.288.1360.4","NMFS",1988,4,13,104,30,43.55,-67.5,0,0,0,0,0,"AL",0.038
"9532",465,"198801.289.1360.6","NMFS",1988,4,13,104,30,43.616667,-67.55,0,0,0,0,0,"AL",0.038
"9533",512,"198801.290.1360.7","NMFS",1988,4,14,105,30,43.716667,-67.883333,1,1,0,1,0,"AL",0.038
"9534",513,"198801.291.1380.4","NMFS",1988,4,14,105,30,43.4,-69.183333,0,0,0,0,0,"AL",0.038
"9535",513,"198801.292.1370.4","NMFS",1988,4,14,105,30,43,-69.3,0,0,0,0,0,"AL",0.038
"9536",515,"198801.293.1280.6","NMFS",1988,4,14,105,30,42.516667,-69.283333,0,0,0,0,0,"AL",0.038
"9537",515,"198801.294.1280.4","NMFS",1988,4,14,105,30,42.483333,-69.2,0,0,0,0,0,"AL",0.038
"9538",521,"198801.295.1280.1","NMFS",1988,4,14,105,30,42.15,-69.266667,0,0,0,0,0,"AL",0.038
"9539",521,"198801.296.1280.7","NMFS",1988,4,14,105,30,42.083333,-69.483333,0,0,0,0,0,"AL",0.038
"9540",521,"198801.297.1270.1","NMFS",1988,4,14,105,30,42.133333,-69.8,0,0,0,0,0,"AL",0.038
"9541",514,"198801.298.3600.1","NMFS",1988,4,19,110,30,41.9,-70.25,4,1,3,4,0,"AL",0.038
"9542",514,"198801.299.3610.2","NMFS",1988,4,19,110,30,41.966667,-70.4,87,38,49,58,29,"AL",0.038
"9543",514,"198801.300.3590.1","NMFS",1988,4,19,110,30,41.983333,-70.533333,29,14,15,18,11,"AL",0.038
"9544",514,"198801.301.3610.1","NMFS",1988,4,19,110,30,42.066667,-70.466667,60,26,34,51,9,"AL",0.038
"9545",514,"198801.302.3600.2","NMFS",1988,4,19,110,30,42.116667,-70.55,86,38,48,81,5,"AL",0.038
"9546",514,"198801.303.3650.1","NMFS",1988,4,19,110,30,42.2,-70.566667,4,3,1,4,0,"AL",0.038
"9547",514,"198801.304.3640.1","NMFS",1988,4,19,110,30,42.316667,-70.666667,27,12,15,27,0,"AL",0.038
"9548",514,"198801.305.1260.4","NMFS",1988,4,19,110,30,42.233333,-70.316667,1,0,1,1,0,"AL",0.038
"9549",514,"198801.306.1260.1","NMFS",1988,4,19,110,30,42.4,-70.4,0,0,0,0,0,"AL",0.038
"9550",514,"198801.307.3660.2","NMFS",1988,4,19,110,30,42.483333,-70.633333,14,7,7,14,0,"AL",0.038
"9551",514,"198801.308.1260.5","NMFS",1988,4,19,110,30,42.516667,-70.516667,0,0,0,0,0,"AL",0.038
"9552",514,"198801.309.1260.3","NMFS",1988,4,19,110,30,42.766667,-70.35,0,0,0,0,0,"AL",0.038
"9553",514,"198801.310.3660.1","NMFS",1988,4,19,110,30,42.783333,-70.65,1,0,1,1,0,"AL",0.038
"9554",513,"198801.311.1400.1","NMFS",1988,4,20,111,30,42.983333,-70.433333,0,0,0,0,0,"AL",0.038
"9555",513,"198801.312.1270.3","NMFS",1988,4,20,111,30,43.066667,-70.266667,0,0,0,0,0,"AL",0.038
"9556",513,"198801.313.1260.2","NMFS",1988,4,20,111,30,42.9,-70.066667,0,0,0,0,0,"AL",0.038
"9557",513,"198801.314.1270.4","NMFS",1988,4,20,111,30,43.166667,-70.116667,1,0,1,1,0,"AL",0.038
"9558",513,"198801.315.1400.3","NMFS",1988,4,20,111,30,43.233333,-70.25,1,0,1,1,0,"AL",0.038
"9559",513,"198801.316.1400.2","NMFS",1988,4,20,111,30,43.45,-70.066667,0,0,0,0,0,"AL",0.038
"9560",513,"198801.317.1380.3","NMFS",1988,4,20,111,30,43.283333,-69.85,0,0,0,0,0,"AL",0.038
"9561",513,"198801.318.1370.3","NMFS",1988,4,20,111,30,43.15,-69.633333,0,0,0,0,0,"AL",0.038
"9562",514,"198801.319.1280.5","NMFS",1988,4,20,111,30,42.783333,-69.7,0,0,0,0,0,"AL",0.038
"9563",514,"198801.320.1280.3","NMFS",1988,4,20,111,30,42.716667,-69.9,0,0,0,0,0,"AL",0.038
"9564",514,"198801.321.1270.2","NMFS",1988,4,20,111,30,42.566667,-69.983333,0,0,0,0,0,"AL",0.038
"9565",526,"198803.159.1120.1","NMFS",1988,9,29,273,30,39.916667,-69.9,1,1,0,1,0,"AL",0.038
"9566",526,"198803.160.1100.1","NMFS",1988,9,29,273,30,40.133333,-69.866667,1,1,0,1,0,"AL",0.038
"9567",526,"198803.161.1100.3","NMFS",1988,9,29,273,30,40.416667,-69.533333,3,1,2,3,0,"AL",0.038
"9568",526,"198803.162.1090.1","NMFS",1988,9,30,274,30,40.766667,-69.666667,7,1,6,6,1,"AL",0.038
"9569",526,"198803.163.1090.5","NMFS",1988,9,30,274,30,40.833333,-69.633333,0,0,0,0,0,"AL",0.038
"9570",526,"198803.164.3550.5","NMFS",1988,9,30,274,30,40.8,-69.916667,0,0,0,0,0,"AL",0.038
"9571",521,"198803.165.3550.3","NMFS",1988,10,3,277,30,41.5,-69.766667,0,0,0,0,0,"AL",0.038
"9572",521,"198803.167.3550.6","NMFS",1988,10,4,278,30,41.433333,-69.6,10,5,5,10,0,"AL",0.038
"9573",521,"198803.168.1230.5","NMFS",1988,10,4,278,30,41.4,-69.283333,0,0,0,0,0,"AL",0.038
"9574",521,"198803.170.1250.5","NMFS",1988,10,4,278,30,41.25,-69.383333,0,0,0,0,0,"AL",0.038
"9575",521,"198803.171.1250.4","NMFS",1988,10,4,278,30,41.133333,-69.366667,0,0,0,0,0,"AL",0.038
"9576",526,"198803.175.1090.2","NMFS",1988,10,6,280,30,40.733333,-69.5,0,0,0,0,0,"AL",0.038
"9577",526,"198803.176.3550.4","NMFS",1988,10,6,280,30,40.95,-69.583333,1,1,0,1,0,"AL",0.038
"9578",521,"198803.177.1250.6","NMFS",1988,10,6,280,30,41.033333,-69.233333,1,0,1,0,1,"AL",0.038
"9579",521,"198803.178.1250.7","NMFS",1988,10,6,280,30,41.116667,-69.25,0,0,0,0,0,"AL",0.038
"9580",521,"198803.179.1230.1","NMFS",1988,10,6,280,30,41.083333,-69.133333,0,0,0,0,0,"AL",0.038
"9581",526,"198803.180.1090.3","NMFS",1988,10,6,280,30,40.95,-69.25,0,0,0,0,0,"AL",0.038
"9582",526,"198803.181.1100.6","NMFS",1988,10,6,280,30,40.666667,-69.166667,0,0,0,0,0,"AL",0.038
"9583",526,"198803.182.1100.8","NMFS",1988,10,6,280,30,40.6,-69,1,0,1,1,0,"AL",0.038
"9584",526,"198803.183.1100.7","NMFS",1988,10,7,281,30,40.45,-69.233333,0,0,0,0,0,"AL",0.038
"9585",526,"198803.184.1100.2","NMFS",1988,10,7,281,30,40.4,-69.116667,0,0,0,0,0,"AL",0.038
"9586",526,"198803.185.1110.2","NMFS",1988,10,7,281,30,40.033333,-69.2,3,1,2,3,0,"AL",0.038
"9587",525,"198803.186.1140.3","NMFS",1988,10,7,281,30,40.25,-68.716667,2,2,0,2,0,"AL",0.038
"9588",525,"198803.187.1130.7","NMFS",1988,10,7,281,30,40.4,-68.75,1,0,1,0,1,"AL",0.038
"9589",525,"198803.188.1130.9","NMFS",1988,10,7,281,30,40.45,-68.766667,1,1,0,1,0,"AL",0.038
"9590",525,"198803.189.1130.4","NMFS",1988,10,7,281,30,40.383333,-68.55,2,0,2,2,0,"AL",0.038
"9591",525,"198803.190.1130.2","NMFS",1988,10,7,281,30,40.566667,-68.383333,0,0,0,0,0,"AL",0.038
"9592",525,"198803.191.1150.1","NMFS",1988,10,8,282,30,40.35,-67.733333,4,4,0,4,0,"AL",0.038
"9593",525,"198803.192.1140.1","NMFS",1988,10,9,283,30,40.433333,-67.8,1,0,1,1,0,"AL",0.038
"9594",525,"198803.193.1130.3","NMFS",1988,10,9,283,30,40.733333,-67.416667,0,0,0,0,0,"AL",0.038
"9595",525,"198803.194.1140.2","NMFS",1988,10,9,283,30,40.45,-67.566667,0,0,0,0,0,"AL",0.038
"9596",525,"198803.195.1130.6","NMFS",1988,10,9,283,30,40.583333,-67.733333,2,1,1,2,0,"AL",0.038
"9597",525,"198803.196.1190.9","NMFS",1988,10,10,284,30,40.983333,-68.083333,0,0,0,0,0,"AL",0.038
"9598",525,"198803.197.1130.1","NMFS",1988,10,10,284,26,40.883333,-68.116667,3,3,0,3,0,"AL",0.038
"9599",525,"198803.198.1190.6","NMFS",1988,10,10,284,30,41,-68.333333,1,0,1,1,0,"AL",0.038
"9600",525,"198803.199.1190.4","NMFS",1988,10,10,284,30,41.166667,-68.05,0,0,0,0,0,"AL",0.038
"9601",525,"198803.200.1190.5","NMFS",1988,10,10,284,30,41.2,-67.95,14,8,6,14,0,"AL",0.038
"9602",525,"198803.201.1130.8","NMFS",1988,10,10,284,30,40.966667,-67.716667,3,1,2,3,0,"AL",0.038
"9603",525,"198803.202.1130.5","NMFS",1988,10,10,284,30,41.133333,-67.2,1,1,0,1,0,"AL",0.038
"9604",562,"198803.203.1190.8","NMFS",1988,10,10,284,30,41.45,-67.25,2,2,0,2,0,"AL",0.038
"9605",562,"198803.204.1190.1","NMFS",1988,10,10,284,30,41.516667,-67.3,1,1,0,1,0,"AL",0.038
"9606",562,"198803.205.1190.2","NMFS",1988,10,10,284,20,41.583333,-67.6,0,0,0,0,0,"AL",0.038
"9607",562,"198803.206.1190.3","NMFS",1988,10,11,285,30,41.65,-67.15,8,5,3,8,0,"AL",0.038
"9608",562,"198803.207.1160.1","NMFS",1988,10,11,285,30,41.35,-66.733333,1,1,0,1,0,"AL",0.038
"9609",562,"198803.208.1160.9","NMFS",1988,10,11,285,30,41.05,-66.6,0,0,0,0,0,"AL",0.038
"9610",552,"198803.209.1170.1","NMFS",1988,10,11,285,30,41.333333,-66.266667,1,1,0,1,0,"AL",0.038
"9611",552,"198803.210.1160.5","NMFS",1988,10,11,285,30,41.35,-66.3,0,0,0,0,0,"AL",0.038
"9612",552,"198803.211.1170.3","NMFS",1988,10,11,285,21,41.433333,-66.15,0,0,0,0,0,"AL",0.038
"9613",552,"198803.212.1160.6","NMFS",1988,10,11,285,30,41.55,-66.15,0,0,0,0,0,"AL",0.038
"9614",552,"198803.213.1160.7","NMFS",1988,10,11,285,30,41.733333,-66.35,0,0,0,0,0,"AL",0.038
"9615",552,"198803.214.1160.4","NMFS",1988,10,11,285,30,41.733333,-66.116667,0,0,0,0,0,"AL",0.038
"9616",551,"198803.215.1160.8","NMFS",1988,10,11,285,30,41.85,-66.116667,0,0,0,0,0,"AL",0.038
"9617",551,"198803.216.1170.2","NMFS",1988,10,12,286,30,41.85,-65.8,0,0,0,0,0,"AL",0.038
"9618",551,"198803.217.1180.1","NMFS",1988,10,12,286,30,41.883333,-65.766667,0,0,0,0,0,"AL",0.038
"9619",551,"198803.218.1160.3","NMFS",1988,10,12,286,30,42.033333,-66.016667,0,0,0,0,0,"AL",0.038
"9620",551,"198803.219.1220.1","NMFS",1988,10,12,286,30,42.133333,-66.216667,0,0,0,0,0,"AL",0.038
"9621",551,"198803.220.1210.2","NMFS",1988,10,12,286,30,42.116667,-66.316667,0,0,0,0,0,"AL",0.038
"9622",551,"198803.221.1160.10","NMFS",1988,10,12,286,30,41.933333,-66.466667,0,0,0,0,0,"AL",0.038
"9623",551,"198803.222.1160.2","NMFS",1988,10,12,286,30,41.9,-66.75,6,3,3,6,0,"DE",0.038
"9624",551,"198803.223.1210.1","NMFS",1988,10,12,286,30,42.1,-66.833333,0,0,0,0,0,"DE",0.038
"9625",551,"198803.224.1210.3","NMFS",1988,10,12,286,30,42.15,-66.983333,0,0,0,0,0,"DE",0.038
"9626",551,"198803.225.1290.5","NMFS",1988,10,12,286,30,42.283333,-66.783333,0,0,0,0,0,"DE",0.038
"9627",464,"198803.226.1300.3","NMFS",1988,10,13,287,30,42.366667,-66.866667,0,0,0,0,0,"DE",0.038
"9628",551,"198803.227.1300.1","NMFS",1988,10,13,287,30,42.333333,-66.983333,0,0,0,0,0,"DE",0.038
"9629",464,"198803.229.1300.4","NMFS",1988,10,13,287,30,42.35,-67.333333,0,0,0,0,0,"DE",0.038
"9630",561,"198803.230.1220.2","NMFS",1988,10,13,287,30,42.2,-67.233333,0,0,0,0,0,"DE",0.038
"9631",561,"198803.231.1200.3","NMFS",1988,10,13,287,30,42.033333,-67.183333,0,0,0,0,0,"DE",0.038
"9632",561,"198803.232.1190.7","NMFS",1988,10,13,287,30,41.966667,-67.1,3,1,2,3,0,"DE",0.038
"9633",561,"198803.233.1200.2","NMFS",1988,10,13,287,30,41.95,-67.433333,1,0,1,1,0,"DE",0.038
"9634",562,"198803.234.1200.6","NMFS",1988,10,13,287,30,41.833333,-67.45,3,1,2,3,0,"DE",0.038
"9635",561,"198803.235.1200.5","NMFS",1988,10,13,287,30,41.966667,-67.583333,9,6,3,9,0,"DE",0.038
"9636",521,"198803.237.1230.3","NMFS",1988,10,18,292,30,41.766667,-69.766667,0,0,0,0,0,"AL",0.038
"9637",521,"198803.238.1240.6","NMFS",1988,10,18,292,30,41.816667,-69.416667,0,0,0,0,0,"AL",0.038
"9638",521,"198803.239.1240.2","NMFS",1988,10,18,292,30,41.633333,-68.866667,0,0,0,0,0,"AL",0.038
"9639",522,"198803.240.1240.3","NMFS",1988,10,18,292,30,41.55,-68.616667,0,0,0,0,0,"AL",0.038
"9640",522,"198803.241.1230.2","NMFS",1988,10,18,292,30,41.383333,-68.7,0,0,0,0,0,"AL",0.038
"9641",521,"198803.242.1240.4","NMFS",1988,10,18,292,30,41.283333,-68.9,0,0,0,0,0,"AL",0.038
"9642",522,"198803.243.1230.4","NMFS",1988,10,18,292,30,41.083333,-68.8,0,0,0,0,0,"AL",0.038
"9643",522,"198803.244.1200.1","NMFS",1988,10,18,292,30,41.233333,-68.483333,6,0,6,6,0,"AL",0.038
"9644",522,"198803.246.1210.4","NMFS",1988,10,19,293,30,41.75,-68.3,0,0,0,0,0,"AL",0.038
"9645",522,"198803.247.1200.4","NMFS",1988,10,19,293,30,41.783333,-68.033333,0,0,0,0,0,"AL",0.038
"9646",522,"198803.248.1220.5","NMFS",1988,10,19,293,30,42.066667,-67.75,0,0,0,0,0,"AL",0.038
"9647",522,"198803.249.1220.4","NMFS",1988,10,19,293,30,42.1,-67.833333,0,0,0,0,0,"AL",0.038
"9648",522,"198803.250.1290.1","NMFS",1988,10,19,293,30,42.233333,-67.883333,0,0,0,0,0,"AL",0.038
"9649",515,"198803.251.1290.4","NMFS",1988,10,19,293,30,42.433333,-67.7,0,0,0,0,0,"AL",0.038
"9650",515,"198803.252.1290.6","NMFS",1988,10,19,293,30,42.55,-67.966667,0,0,0,0,0,"AL",0.038
"9651",515,"198803.253.1290.3","NMFS",1988,10,19,293,30,42.65,-68.216667,0,0,0,0,0,"AL",0.038
"9652",515,"198803.254.1360.5","NMFS",1988,10,19,293,30,42.9,-67.85,0,0,0,0,0,"AL",0.038
"9653",464,"198803.255.1290.7","NMFS",1988,10,19,293,30,42.683333,-67.533333,0,0,0,0,0,"AL",0.038
"9654",464,"198803.256.1290.8","NMFS",1988,10,20,294,30,42.616667,-67.35,0,0,0,0,0,"AL",0.038
"9655",464,"198803.257.1290.2","NMFS",1988,10,20,294,30,42.7,-67.383333,0,0,0,0,0,"AL",0.038
"9656",464,"198803.258.1360.8","NMFS",1988,10,20,294,30,42.983333,-67.283333,0,0,0,0,0,"AL",0.038
"9657",465,"198803.261.1340.3","NMFS",1988,10,20,294,20,43.05,-66.733333,0,0,0,0,0,"AL",0.038
"9658",465,"198803.262.1340.5","NMFS",1988,10,20,294,30,43.1,-66.9,1,1,0,1,0,"AL",0.038
"9659",465,"198803.263.1330.2","NMFS",1988,10,20,294,30,43.216667,-66.25,1,1,0,1,0,"AL",0.038
"9660",465,"198803.265.1360.7","NMFS",1988,10,21,295,30,43.25,-67.166667,0,0,0,0,0,"AL",0.038
"9661",465,"198803.266.1360.3","NMFS",1988,10,21,295,21,43.466667,-67.383333,0,0,0,0,0,"AL",0.038
"9662",465,"198803.267.1340.1","NMFS",1988,10,21,295,30,43.566667,-66.95,0,0,0,0,0,"AL",0.038
"9663",465,"198803.268.1340.6","NMFS",1988,10,21,295,30,43.7,-66.966667,0,0,0,0,0,"AL",0.038
"9664",465,"198803.269.1340.4","NMFS",1988,10,21,295,30,43.716667,-67.183333,0,0,0,0,0,"AL",0.038
"9665",465,"198803.270.1340.2","NMFS",1988,10,21,295,30,43.733333,-67.066667,0,0,0,0,0,"AL",0.038
"9666",465,"198803.271.1330.3","NMFS",1988,10,21,295,30,43.833333,-66.6,3,1,2,3,0,"AL",0.038
"9667",466,"198803.272.1330.4","NMFS",1988,10,21,295,30,44.066667,-66.65,1,1,0,1,0,"AL",0.038
"9668",466,"198803.274.1351.3","NMFS",1988,10,21,295,30,44.083333,-66.783333,1,1,0,1,0,"AL",0.038
"9669",511,"198803.275.1351.2","NMFS",1988,10,22,296,30,44.233333,-67.183333,0,0,0,0,0,"AL",0.038
"9670",511,"198803.276.1390.2","NMFS",1988,10,22,296,30,44.316667,-67.633333,5,1,4,5,0,"AL",0.038
"9671",511,"198803.277.1390.1","NMFS",1988,10,22,296,30,44.25,-67.7,0,0,0,0,0,"AL",0.038
"9672",512,"198803.278.1390.5","NMFS",1988,10,22,296,30,44.066667,-67.9,3,2,1,3,0,"AL",0.038
"9673",512,"198803.279.1360.1","NMFS",1988,10,22,296,30,43.9,-67.766667,1,1,0,1,0,"AL",0.038
"9674",512,"198803.280.1390.4","NMFS",1988,10,23,297,30,43.816667,-69.1,7,5,2,7,0,"AL",0.038
"9675",512,"198803.281.1390.3","NMFS",1988,10,23,297,30,43.866667,-68.45,0,0,0,0,0,"AL",0.038
"9676",512,"198803.282.1380.1","NMFS",1988,10,23,297,30,43.933333,-68.3,0,0,0,0,0,"AL",0.038
"9677",512,"198803.283.1360.6","NMFS",1988,10,24,298,30,43.666667,-67.733333,0,0,0,0,0,"AL",0.038
"9678",512,"198803.284.1360.4","NMFS",1988,10,24,298,30,43.4,-68.183333,0,0,0,0,0,"AL",0.038
"9679",512,"198803.285.1380.3","NMFS",1988,10,24,298,30,43.566667,-68.483333,0,0,0,0,0,"AL",0.038
"9680",512,"198803.286.1380.2","NMFS",1988,10,24,298,30,43.55,-68.816667,0,0,0,0,0,"AL",0.038
"9681",512,"198803.287.1380.5","NMFS",1988,10,24,298,30,43.383333,-68.966667,0,0,0,0,0,"AL",0.038
"9682",513,"198803.288.1380.4","NMFS",1988,10,24,298,30,43.5,-69.383333,0,0,0,0,0,"AL",0.038
"9683",513,"198803.290.1400.4","NMFS",1988,10,25,299,30,43.6,-69.883333,5,3,2,5,0,"AL",0.038
"9684",513,"198803.291.1400.2","NMFS",1988,10,25,299,30,43.316667,-70.166667,2,2,0,2,0,"AL",0.038
"9685",513,"198803.292.1270.2","NMFS",1988,10,25,299,30,43.25,-70.033333,0,0,0,0,0,"AL",0.038
"9686",513,"198803.293.1270.3","NMFS",1988,10,25,299,30,43.083333,-70.266667,0,0,0,0,0,"AL",0.038
"9687",513,"198803.294.1370.1","NMFS",1988,10,25,299,30,43.05,-69.666667,0,0,0,0,0,"AL",0.038
"9688",513,"198803.295.1370.4","NMFS",1988,10,25,299,30,43.083333,-69.366667,0,0,0,0,0,"AL",0.038
"9689",513,"198803.296.1370.5","NMFS",1988,10,25,299,30,42.983333,-69.416667,0,0,0,0,0,"AL",0.038
"9690",515,"198803.297.1370.2","NMFS",1988,10,25,299,30,42.866667,-69.283333,0,0,0,0,0,"AL",0.038
"9691",515,"198803.298.1370.3","NMFS",1988,10,25,299,30,42.8,-69.1,0,0,0,0,0,"AL",0.038
"9692",515,"198803.299.1280.7","NMFS",1988,10,25,299,30,42.516667,-68.866667,0,0,0,0,0,"AL",0.038
"9693",522,"198803.300.1280.3","NMFS",1988,10,25,299,30,42.316667,-68.8,0,0,0,0,0,"AL",0.038
"9694",522,"198803.301.1240.1","NMFS",1988,10,26,300,30,42.233333,-68.716667,0,0,0,0,0,"AL",0.038
"9695",522,"198803.302.1240.5","NMFS",1988,10,26,300,30,42.183333,-68.833333,0,0,0,0,0,"AL",0.038
"9696",515,"198803.303.1280.4","NMFS",1988,10,26,300,30,42.433333,-69.033333,0,0,0,0,0,"AL",0.038
"9697",515,"198803.304.1280.2","NMFS",1988,10,26,300,30,42.566667,-69.45,0,0,0,0,0,"AL",0.038
"9698",514,"198803.305.1280.1","NMFS",1988,10,26,300,30,42.566667,-69.683333,0,0,0,0,0,"AL",0.038
"9699",514,"198803.306.1280.6","NMFS",1988,10,26,300,30,42.483333,-69.75,1,1,0,1,0,"AL",0.038
"9700",514,"198803.307.1280.5","NMFS",1988,10,26,300,30,42.366667,-69.933333,0,0,0,0,0,"AL",0.038
"9701",514,"198803.308.1270.1","NMFS",1988,10,26,300,30,42.483333,-70.05,0,0,0,0,0,"AL",0.038
"9702",514,"198803.309.1260.5","NMFS",1988,10,26,300,23,42.366667,-70.25,0,0,0,0,0,"AL",0.038
"9703",514,"198803.310.1260.4","NMFS",1988,10,26,300,30,42.466667,-70.25,1,1,0,1,0,"AL",0.038
"9704",514,"198803.311.1260.3","NMFS",1988,10,26,300,30,42.7,-70.216667,0,0,0,0,0,"AL",0.038
"9705",514,"198803.312.1270.4","NMFS",1988,10,27,301,30,42.733333,-70.116667,0,0,0,0,0,"AL",0.038
"9706",514,"198803.313.1400.3","NMFS",1988,10,27,301,30,42.766667,-70.616667,1,0,1,1,0,"AL",0.038
"9707",514,"198803.314.3660.2","NMFS",1988,10,27,301,30,42.683333,-70.433333,0,0,0,0,0,"AL",0.038
"9708",514,"198803.315.1260.1","NMFS",1988,10,27,301,30,42.6,-70.433333,1,0,1,1,0,"AL",0.038
"9709",514,"198803.316.3650.1","NMFS",1988,10,27,301,27,42.433333,-70.766667,183,126,57,175,8,"AL",0.038
"9710",514,"198803.317.1260.2","NMFS",1988,10,27,301,30,42.316667,-70.466667,2,0,2,2,0,"AL",0.038
"9711",514,"198803.318.3660.1","NMFS",1988,10,27,301,30,42.283333,-70.566667,13,6,7,13,0,"AL",0.038
"9712",514,"198803.319.3600.1","NMFS",1988,10,27,301,30,42.116667,-70.516667,77,32,45,65,12,"AL",0.038
"9713",514,"198803.320.3610.2","NMFS",1988,10,27,301,30,42.083333,-70.383333,17,6,11,16,1,"AL",0.038
"9714",514,"198803.322.3560.2","NMFS",1988,10,27,301,30,42.1,-70.133333,3,2,1,3,0,"AL",0.038
"9715",514,"198803.323.3610.1","NMFS",1988,10,27,301,30,42.05,-70.266667,4,1,3,4,0,"AL",0.038
"9716",514,"198803.324.3600.2","NMFS",1988,10,28,302,30,41.95,-70.283333,3,0,3,3,0,"AL",0.038
"9717",514,"198803.325.3590.1","NMFS",1988,10,28,302,30,41.816667,-70.35,7,0,7,3,4,"AL",0.038
"9718",514,"198803.326.3580.1","NMFS",1988,10,28,302,30,41.783333,-70.35,23,11,12,8,15,"AL",0.038
"9719",526,"198901.152.1110.2","NMFS",1989,3,15,74,30,40.083333,-69.95,0,0,0,0,0,"DE",0.038
"9720",526,"198901.153.1100.8","NMFS",1989,3,16,75,30,40.283333,-69.883333,1,0,1,1,0,"DE",0.038
"9721",526,"198901.154.1100.6","NMFS",1989,3,16,75,30,40.383333,-69.383333,1,0,1,1,0,"DE",0.038
"9722",526,"198901.155.1100.3","NMFS",1989,3,16,75,30,40.416667,-69.066667,0,0,0,0,0,"DE",0.038
"9723",526,"198901.156.1100.1","NMFS",1989,3,16,75,30,40.55,-69.366667,0,0,0,0,0,"DE",0.038
"9724",526,"198901.157.1090.3","NMFS",1989,3,16,75,30,40.583333,-69.416667,0,0,0,0,0,"DE",0.038
"9725",526,"198901.158.1090.2","NMFS",1989,3,16,75,30,40.75,-69.366667,0,0,0,0,0,"DE",0.038
"9726",526,"198901.159.1090.5","NMFS",1989,3,16,75,30,40.733333,-69.75,0,0,0,0,0,"DE",0.038
"9727",521,"198901.168.3550.4","NMFS",1989,3,23,82,30,41.283333,-69.7,0,0,0,0,0,"DE",0.038
"9728",526,"198901.169.3550.3","NMFS",1989,3,23,82,30,41.033333,-69.733333,0,0,0,0,0,"DE",0.038
"9729",526,"198901.170.3550.1","NMFS",1989,3,23,82,30,40.933333,-69.533333,0,0,0,0,0,"DE",0.038
"9730",526,"198901.171.3550.2","NMFS",1989,3,23,82,30,40.966667,-69.366667,0,0,0,0,0,"DE",0.038
"9731",521,"198901.172.1250.3","NMFS",1989,3,23,82,30,41.166667,-69.433333,0,0,0,0,0,"DE",0.038
"9732",521,"198901.173.3550.5","NMFS",1989,3,23,82,30,41.2,-69.5,0,0,0,0,0,"DE",0.038
"9733",521,"198901.174.1230.4","NMFS",1989,3,23,82,30,41.283333,-69.25,0,0,0,0,0,"DE",0.038
"9734",521,"198901.176.1250.1","NMFS",1989,3,24,83,30,41.65,-69.75,9,4,5,8,1,"DE",0.038
"9735",521,"198901.178.1240.5","NMFS",1989,3,24,83,30,41.766667,-69.383333,2,2,0,2,0,"DE",0.038
"9736",521,"198901.179.1240.4","NMFS",1989,3,24,83,30,41.583333,-68.916667,0,0,0,0,0,"DE",0.038
"9737",522,"198901.180.1200.6","NMFS",1989,3,24,83,30,41.55,-68.35,0,0,0,0,0,"DE",0.038
"9738",522,"198901.181.1230.5","NMFS",1989,3,24,83,30,41.45,-68.483333,1,0,1,1,0,"DE",0.038
"9739",522,"198901.182.1200.4","NMFS",1989,3,24,83,23.5,41.15,-68.5,0,0,0,0,0,"DE",0.038
"9740",522,"198901.183.1230.2","NMFS",1989,3,24,83,30,41.166667,-68.6,0,0,0,0,0,"DE",0.038
"9741",521,"198901.184.1230.1","NMFS",1989,3,25,84,30,41.033333,-69,0,0,0,0,0,"DE",0.038
"9742",525,"198901.185.1130.7","NMFS",1989,3,25,84,30,40.983333,-68.816667,0,0,0,0,0,"DE",0.038
"9743",525,"198901.186.1130.3","NMFS",1989,3,25,84,30,40.833333,-68.833333,2,0,2,2,0,"DE",0.038
"9744",525,"198901.187.1190.4","NMFS",1989,3,25,84,30,40.933333,-68.65,0,0,0,0,0,"DE",0.038
"9745",525,"198901.188.1190.6","NMFS",1989,3,26,85,30,40.833333,-68.3,1,1,0,1,0,"DE",0.038
"9746",525,"198901.189.1130.5","NMFS",1989,3,26,85,30,40.666667,-68.333333,0,0,0,0,0,"DE",0.038
"9747",525,"198901.190.1130.2","NMFS",1989,3,26,85,30,40.716667,-68.166667,0,0,0,0,0,"DE",0.038
"9748",525,"198901.191.1130.1","NMFS",1989,3,26,85,30,40.583333,-68.05,0,0,0,0,0,"DE",0.038
"9749",525,"198901.192.1130.8","NMFS",1989,3,26,85,30,40.383333,-68.533333,0,0,0,0,0,"DE",0.038
"9750",525,"198901.193.1140.3","NMFS",1989,3,26,85,30,40.333333,-68.016667,0,0,0,0,0,"DE",0.038
"9751",525,"198901.194.1150.1","NMFS",1989,3,26,85,21,40.383333,-67.733333,0,0,0,0,0,"DE",0.038
"9752",525,"198901.195.1140.2","NMFS",1989,3,26,85,30,40.533333,-67.666667,0,0,0,0,0,"DE",0.038
"9753",525,"198901.196.1130.9","NMFS",1989,3,26,85,30,40.9,-67.716667,0,0,0,0,0,"DE",0.038
"9754",525,"198901.197.1130.4","NMFS",1989,3,27,86,30,40.716667,-67.383333,0,0,0,0,0,"DE",0.038
"9755",525,"198901.198.1140.1","NMFS",1989,3,27,86,30,40.716667,-67.016667,0,0,0,0,0,"DE",0.038
"9756",562,"198901.199.1130.6","NMFS",1989,3,27,86,30,40.9,-66.983333,0,0,0,0,0,"DE",0.038
"9757",562,"198901.200.1160.10","NMFS",1989,3,27,86,30,41.116667,-66.7,0,0,0,0,0,"DE",0.038
"9758",562,"198901.201.1170.3","NMFS",1989,3,27,86,30,41.066667,-66.466667,0,0,0,0,0,"DE",0.038
"9759",552,"198901.202.1170.2","NMFS",1989,3,27,86,30,41.466667,-66,0,0,0,0,0,"DE",0.038
"9760",552,"198901.203.1160.4","NMFS",1989,3,27,86,30,41.433333,-66.366667,0,0,0,0,0,"DE",0.038
"9761",552,"198901.204.1160.3","NMFS",1989,3,27,86,30,41.616667,-66.633333,0,0,0,0,0,"DE",0.038
"9762",562,"198901.205.1160.9","NMFS",1989,3,27,86,30,41.7,-66.866667,0,0,0,0,0,"DE",0.038
"9763",552,"198901.206.1160.6","NMFS",1989,3,27,86,30,41.816667,-66.833333,1,0,1,1,0,"DE",0.038
"9764",551,"198901.207.1160.5","NMFS",1989,3,28,87,30,42.033333,-66.933333,0,0,0,0,0,"DE",0.038
"9765",551,"198901.208.1210.4","NMFS",1989,3,28,87,30,42.15,-66.966667,0,0,0,0,0,"DE",0.038
"9766",551,"198901.209.1290.5","NMFS",1989,3,28,87,30,42.25,-66.933333,0,0,0,0,0,"DE",0.038
"9767",551,"198901.210.1210.1","NMFS",1989,3,28,87,30,42.1,-66.75,1,0,1,1,0,"DE",0.038
"9768",551,"198901.211.1160.1","NMFS",1989,3,28,87,30,41.966667,-66.683333,0,0,0,0,0,"DE",0.038
"9769",551,"198901.212.1160.8","NMFS",1989,3,28,87,30,41.883333,-66.466667,0,0,0,0,0,"DE",0.038
"9770",552,"198901.213.1160.7","NMFS",1989,3,28,87,30,41.816667,-66.216667,0,0,0,0,0,"DE",0.038
"9771",552,"198901.214.1160.2","NMFS",1989,3,28,87,30,41.783333,-65.95,0,0,0,0,0,"DE",0.038
"9772",552,"198901.215.1170.1","NMFS",1989,3,28,87,30,41.816667,-65.783333,0,0,0,0,0,"DE",0.038
"9773",551,"198901.217.1180.2","NMFS",1989,3,28,87,30,42.033333,-65.9,0,0,0,0,0,"DE",0.038
"9774",464,"198901.218.1290.1","NMFS",1989,3,28,87,30,42.166667,-65.933333,0,0,0,0,0,"DE",0.038
"9775",551,"198901.219.1220.4","NMFS",1989,3,28,87,30,42.15,-66.2,1,0,1,1,0,"DE",0.038
"9776",464,"198901.220.1290.2","NMFS",1989,3,29,88,30,42.366667,-66.066667,1,1,0,1,0,"DE",0.038
"9777",464,"198901.221.1290.6","NMFS",1989,3,29,88,30,42.516667,-66.35,0,0,0,0,0,"DE",0.038
"9778",464,"198901.222.1300.1","NMFS",1989,3,29,88,30,42.483333,-66.666667,0,0,0,0,0,"DE",0.038
"9779",561,"198901.223.1290.3","NMFS",1989,3,29,88,30,42.283333,-67.383333,1,0,1,1,0,"DE",0.038
"9780",561,"198901.224.1290.7","NMFS",1989,3,29,88,30,42.183333,-67.616667,0,0,0,0,0,"DE",0.038
"9781",561,"198901.225.1210.2","NMFS",1989,3,29,88,30,42.05,-67.566667,0,0,0,0,0,"DE",0.038
"9782",522,"198901.227.1200.7","NMFS",1989,3,29,88,30,41.966667,-67.666667,0,0,0,0,0,"DE",0.038
"9783",561,"198901.228.1200.2","NMFS",1989,3,29,88,30,42.016667,-67.466667,0,0,0,0,0,"DE",0.038
"9784",561,"198901.229.1200.1","NMFS",1989,3,30,89,30,42,-67.316667,0,0,0,0,0,"DE",0.038
"9785",562,"198901.230.1190.1","NMFS",1989,3,30,89,30,41.816667,-67.233333,0,0,0,0,0,"DE",0.038
"9786",562,"198901.231.1190.8","NMFS",1989,3,30,89,30,41.7,-67.283333,0,0,0,0,0,"DE",0.038
"9787",562,"198901.232.1190.7","NMFS",1989,3,30,89,30,41.466667,-67.183333,0,0,0,0,0,"DE",0.038
"9788",562,"198901.233.1190.3","NMFS",1989,3,30,89,30,41.383333,-67.366667,0,0,0,0,0,"DE",0.038
"9789",525,"198901.234.1190.9","NMFS",1989,3,30,89,30,41.233333,-67.733333,0,0,0,0,0,"DE",0.038
"9790",525,"198901.235.1190.5","NMFS",1989,3,30,89,30,41.283333,-67.833333,0,0,0,0,0,"DE",0.038
"9791",522,"198901.236.1190.2","NMFS",1989,3,30,89,30,41.583333,-67.716667,0,0,0,0,0,"DE",0.038
"9792",521,"198901.238.1240.1","NMFS",1989,4,5,95,30,42,-69.8,0,0,0,0,0,"DE",0.038
"9793",521,"198901.239.1280.3","NMFS",1989,4,5,95,30,42.033333,-69.666667,0,0,0,0,0,"DE",0.038
"9794",521,"198901.240.1280.2","NMFS",1989,4,5,95,30,41.883333,-69.416667,0,0,0,0,0,"DE",0.038
"9795",522,"198901.241.1240.6","NMFS",1989,4,5,95,30,42.066667,-68.816667,0,0,0,0,0,"DE",0.038
"9796",522,"198901.242.1240.3","NMFS",1989,4,5,95,30,42.316667,-68.666667,0,0,0,0,0,"DE",0.038
"9797",522,"198901.243.1240.2","NMFS",1989,4,5,95,30,42.2,-68.5,1,1,0,1,0,"DE",0.038
"9798",522,"198901.244.1220.2","NMFS",1989,4,5,95,30,41.816667,-68.3,0,0,0,0,0,"DE",0.038
"9799",522,"198901.245.1220.3","NMFS",1989,4,5,95,30,41.9,-68.15,0,0,0,0,0,"DE",0.038
"9800",522,"198901.246.1200.3","NMFS",1989,4,6,96,30,41.8,-67.95,0,0,0,0,0,"DE",0.038
"9801",522,"198901.247.1210.3","NMFS",1989,4,6,96,30,41.883333,-67.933333,0,0,0,0,0,"DE",0.038
"9802",522,"198901.248.1220.1","NMFS",1989,4,6,96,30,42.05,-67.883333,0,0,0,0,0,"DE",0.038
"9803",464,"198901.249.1300.2","NMFS",1989,4,6,96,30,42.466667,-67.516667,0,0,0,0,0,"DE",0.038
"9804",464,"198901.250.1290.8","NMFS",1989,4,6,96,30,42.616667,-67.566667,1,1,0,1,0,"DE",0.038
"9805",464,"198901.251.1290.4","NMFS",1989,4,6,96,30,42.683333,-67.283333,0,0,0,0,0,"DE",0.038
"9806",464,"198901.252.1360.3","NMFS",1989,4,6,96,30,42.883333,-66.983333,0,0,0,0,0,"DE",0.038
"9807",464,"198901.253.1360.1","NMFS",1989,4,6,96,30,42.983333,-67.05,0,0,0,0,0,"DE",0.038
"9808",465,"198901.254.1340.5","NMFS",1989,4,6,96,30,43.116667,-66.75,0,0,0,0,0,"DE",0.038
"9809",465,"198901.255.1340.1","NMFS",1989,4,6,96,30,43.583333,-66.883333,0,0,0,0,0,"DE",0.038
"9810",511,"198901.256.1340.4","NMFS",1989,4,6,96,30,43.883333,-66.966667,0,0,0,0,0,"DE",0.038
"9811",466,"198901.257.1351.1","NMFS",1989,4,7,97,30,44.183333,-66.8,0,0,0,0,0,"DE",0.038
"9812",511,"198901.258.1351.2","NMFS",1989,4,7,97,30,44.183333,-66.883333,0,0,0,0,0,"DE",0.038
"9813",511,"198901.259.1340.3","NMFS",1989,4,7,97,30,44.116667,-67.05,0,0,0,0,0,"DE",0.038
"9814",511,"198901.260.1340.6","NMFS",1989,4,7,97,30,44.116667,-67.266667,0,0,0,0,0,"DE",0.038
"9815",512,"198901.261.1390.3","NMFS",1989,4,7,97,25,43.666667,-69.05,0,0,0,0,0,"DE",0.038
"9816",512,"198901.262.1390.2","NMFS",1989,4,9,99,30,43.866667,-68.583333,0,0,0,0,0,"DE",0.038
"9817",512,"198901.263.1390.5","NMFS",1989,4,9,99,26,43.916667,-68.416667,0,0,0,0,0,"DE",0.038
"9818",512,"198901.264.1380.5","NMFS",1989,4,9,99,30,44,-68.066667,3,2,1,3,0,"DE",0.038
"9819",511,"198901.265.1390.1","NMFS",1989,4,9,99,30,44.25,-67.816667,0,0,0,0,0,"DE",0.038
"9820",511,"198901.266.1390.4","NMFS",1989,4,9,99,30,44.316667,-67.666667,0,0,0,0,0,"DE",0.038
"9821",511,"198901.267.1340.2","NMFS",1989,4,10,100,30,43.983333,-67.433333,1,1,0,1,0,"DE",0.038
"9822",512,"198901.268.1360.8","NMFS",1989,4,10,100,30,43.866667,-67.666667,0,0,0,0,0,"DE",0.038
"9823",512,"198901.269.1380.4","NMFS",1989,4,10,100,30,43.65,-68.25,0,0,0,0,0,"DE",0.038
"9824",512,"198901.270.1380.2","NMFS",1989,4,10,100,30,43.433333,-68.25,0,0,0,0,0,"DE",0.038
"9825",512,"198901.271.1360.2","NMFS",1989,4,10,100,30,43.483333,-67.883333,0,0,0,0,0,"DE",0.038
"9826",465,"198901.272.1360.6","NMFS",1989,4,10,100,30,43.483333,-67.616667,0,0,0,0,0,"DE",0.038
"9827",515,"198901.273.1360.4","NMFS",1989,4,10,100,30,43.166667,-68.05,3,3,0,3,0,"DE",0.038
"9828",515,"198901.274.1360.7","NMFS",1989,4,10,100,30,43.033333,-67.95,0,0,0,0,0,"DE",0.038
"9829",515,"198901.275.1360.5","NMFS",1989,4,10,100,30,42.833333,-67.833333,0,0,0,0,0,"DE",0.038
"9830",514,"198901.276.1280.5","NMFS",1989,4,11,101,30,42.383333,-69.8,0,0,0,0,0,"DE",0.038
"9831",514,"198901.277.1280.1","NMFS",1989,4,11,101,30,42.483333,-69.816667,0,0,0,0,0,"DE",0.038
"9832",514,"198901.278.1280.4","NMFS",1989,4,11,101,30,42.55,-69.683333,1,1,0,1,0,"DE",0.038
"9833",514,"198901.279.1280.7","NMFS",1989,4,11,101,30,42.65,-69.666667,0,0,0,0,0,"DE",0.038
"9834",515,"198901.280.1370.3","NMFS",1989,4,11,101,30,42.716667,-69,0,0,0,0,0,"DE",0.038
"9835",513,"198901.281.1370.1","NMFS",1989,4,11,101,30,43.033333,-69.35,0,0,0,0,0,"DE",0.038
"9836",513,"198901.283.1370.5","NMFS",1989,4,11,101,30,43.166667,-69.766667,0,0,0,0,0,"DE",0.038
"9837",513,"198901.284.1370.2","NMFS",1989,4,12,102,30,43.233333,-69.6,0,0,0,0,0,"DE",0.038
"9838",513,"198901.285.1380.1","NMFS",1989,4,12,102,30,43.383333,-69.366667,0,0,0,0,0,"DE",0.038
"9839",513,"198901.286.1380.3","NMFS",1989,4,12,102,30,43.533333,-69.533333,0,0,0,0,0,"DE",0.038
"9840",513,"198901.287.1400.3","NMFS",1989,4,12,102,30,43.566667,-69.75,1,1,0,1,0,"DE",0.038
"9841",513,"198901.288.1400.2","NMFS",1989,4,12,102,25,43.3,-70.25,2,2,0,2,0,"DE",0.038
"9842",513,"198901.289.1400.1","NMFS",1989,4,12,102,30,43.066667,-70.366667,2,1,1,2,0,"DE",0.038
"9843",513,"198901.290.1270.1","NMFS",1989,4,12,102,30,42.95,-70.366667,0,0,0,0,0,"DE",0.038
"9844",513,"198901.291.1270.3","NMFS",1989,4,12,102,30,42.916667,-69.983333,2,2,0,2,0,"DE",0.038
"9845",513,"198901.292.1280.6","NMFS",1989,4,12,102,30,42.866667,-69.75,0,0,0,0,0,"DE",0.038
"9846",514,"198901.293.1270.2","NMFS",1989,4,12,102,30,42.75,-70.083333,0,0,0,0,0,"DE",0.038
"9847",514,"198901.294.1260.2","NMFS",1989,4,13,103,30,42.683333,-70.166667,0,0,0,0,0,"DE",0.038
"9848",514,"198901.295.1270.4","NMFS",1989,4,13,103,30,42.616667,-70.05,0,0,0,0,0,"DE",0.038
"9849",514,"198901.296.1260.4","NMFS",1989,4,13,103,30,42.383333,-70.116667,0,0,0,0,0,"DE",0.038
"9850",514,"198901.297.1260.3","NMFS",1989,4,13,103,30,42.283333,-70.25,0,0,0,0,0,"DE",0.038
"9851",514,"198901.298.1260.1","NMFS",1989,4,13,103,30,42.166667,-70.183333,0,0,0,0,0,"DE",0.038
"9852",514,"198901.299.1260.5","NMFS",1989,4,13,103,30,42.15,-70.283333,0,0,0,0,0,"DE",0.038
"9853",526,"198904.176.1100.8","NMFS",1989,10,6,279,30,40.416667,-69.8,0,0,0,0,0,"DE",0.038
"9854",526,"198904.177.1100.6","NMFS",1989,10,6,279,30,40.25,-69.75,2,1,1,2,0,"DE",0.038
"9855",526,"198904.178.1110.1","NMFS",1989,10,6,279,30,40,-69.75,0,0,0,0,0,"DE",0.038
"9856",526,"198904.179.1110.2","NMFS",1989,10,6,279,30,39.966667,-69.4,1,1,0,1,0,"DE",0.038
"9857",526,"198904.180.1100.1","NMFS",1989,10,6,279,30,40.366667,-69.05,0,0,0,0,0,"DE",0.038
"9858",526,"198904.181.1100.3","NMFS",1989,10,6,279,30,40.666667,-69,0,0,0,0,0,"DE",0.038
"9859",526,"198904.182.1090.5","NMFS",1989,10,7,280,30,40.616667,-69.533333,5,2,3,4,1,"DE",0.038
"9860",526,"198904.183.1090.2","NMFS",1989,10,7,280,30,40.65,-69.666667,8,1,7,8,0,"DE",0.038
"9861",526,"198904.184.1090.3","NMFS",1989,10,7,280,30,40.716667,-69.816667,4,1,3,4,0,"DE",0.038
"9862",526,"198904.185.3550.1","NMFS",1989,10,7,280,30,40.983333,-69.75,0,0,0,0,0,"DE",0.038
"9863",526,"198904.186.3550.4","NMFS",1989,10,7,280,30,40.9,-69.4,0,0,0,0,0,"DE",0.038
"9864",526,"198904.187.1100.7","NMFS",1989,10,7,280,30,40.966667,-69.15,1,0,1,1,0,"DE",0.038
"9865",521,"198904.188.1250.1","NMFS",1989,10,7,280,30,41.033333,-69.366667,0,0,0,0,0,"DE",0.038
"9866",521,"198904.190.3550.3","NMFS",1989,10,7,280,24.5,41.166667,-69.516667,6,4,2,6,0,"DE",0.038
"9867",521,"198904.191.1250.3","NMFS",1989,10,8,281,30,41.2,-69.333333,0,0,0,0,0,"DE",0.038
"9868",521,"198904.192.1230.5","NMFS",1989,10,8,281,30,41.283333,-69.2,0,0,0,0,0,"DE",0.038
"9869",521,"198904.193.3550.2","NMFS",1989,10,8,281,30,41.333333,-69.5,1,0,1,1,0,"DE",0.038
"9870",521,"198904.196.1240.1","NMFS",1989,10,8,281,30,41.75,-69.233333,0,0,0,0,0,"DE",0.038
"9871",522,"198904.197.1240.3","NMFS",1989,10,8,281,30,41.6,-68.7,0,0,0,0,0,"DE",0.038
"9872",522,"198904.202.1230.3","NMFS",1989,10,8,281,30,41.483333,-68.583333,0,0,0,0,0,"DE",0.038
"9873",522,"198904.203.1230.2","NMFS",1989,10,9,282,30,41.3,-68.766667,0,0,0,0,0,"DE",0.038
"9874",522,"198904.204.1230.4","NMFS",1989,10,9,282,30,41.283333,-68.683333,0,0,0,0,0,"DE",0.038
"9875",522,"198904.205.1230.1","NMFS",1989,10,9,282,30,41.216667,-68.633333,0,0,0,0,0,"DE",0.038
"9876",522,"198904.206.1200.1","NMFS",1989,10,9,282,30,41.3,-68.466667,4,1,3,4,0,"DE",0.038
"9877",522,"198904.207.1190.7","NMFS",1989,10,9,282,30,41.2,-68.35,1,0,1,1,0,"DE",0.038
"9878",525,"198904.208.1190.3","NMFS",1989,10,9,282,30,41.1,-68.316667,2,2,0,2,0,"DE",0.038
"9879",525,"198904.209.1190.9","NMFS",1989,10,9,282,30,41.066667,-67.933333,0,0,0,0,0,"DE",0.038
"9880",525,"198904.210.1190.8","NMFS",1989,10,9,282,30,40.933333,-68.1,1,1,0,1,0,"DE",0.038
"9881",525,"198904.213.1190.6","NMFS",1989,10,9,282,30,40.783333,-68.4,6,2,4,6,0,"DE",0.038
"9882",525,"198904.214.1130.6","NMFS",1989,10,9,282,30,40.716667,-68.383333,0,0,0,0,0,"DE",0.038
"9883",525,"198904.222.1130.7","NMFS",1989,10,10,283,30,40.533333,-68.45,0,0,0,0,0,"DE",0.038
"9884",525,"198904.223.1130.2","NMFS",1989,10,10,283,30,40.383333,-68.683333,0,0,0,0,0,"DE",0.038
"9885",525,"198904.224.1140.3","NMFS",1989,10,10,283,30,40.266667,-68.516667,0,0,0,0,0,"DE",0.038
"9886",525,"198904.225.1140.1","NMFS",1989,10,10,283,30,40.466667,-67.883333,0,0,0,0,0,"DE",0.038
"9887",525,"198904.227.1150.2","NMFS",1989,10,10,283,30,40.35,-67.733333,2,2,0,2,0,"DE",0.038
"9888",525,"198904.228.1140.2","NMFS",1989,10,10,283,30,40.5,-67.616667,0,0,0,0,0,"DE",0.038
"9889",525,"198904.229.1130.9","NMFS",1989,10,10,283,30,40.583333,-67.683333,1,1,0,1,0,"DE",0.038
"9890",525,"198904.230.1130.1","NMFS",1989,10,10,283,30,40.616667,-67.366667,0,0,0,0,0,"DE",0.038
"9891",525,"198904.231.1130.3","NMFS",1989,10,11,284,30,40.866667,-67.566667,0,0,0,0,0,"DE",0.038
"9892",525,"198904.232.1130.5","NMFS",1989,10,11,284,30,41.066667,-67.366667,1,1,0,1,0,"DE",0.038
"9893",562,"198904.233.1160.9","NMFS",1989,10,11,284,30,41.2,-67.1,1,0,1,1,0,"DE",0.038
"9894",562,"198904.234.1160.2","NMFS",1989,10,11,284,30,41.083333,-67.033333,0,0,0,0,0,"DE",0.038
"9895",562,"198904.235.1130.4","NMFS",1989,10,11,284,30,41,-67.116667,0,0,0,0,0,"DE",0.038
"9896",562,"198904.236.1130.8","NMFS",1989,10,11,284,30,40.85,-66.983333,0,0,0,0,0,"DE",0.038
"9897",562,"198904.237.1180.1","NMFS",1989,10,11,284,30,40.966667,-66.466667,0,0,0,0,0,"DE",0.038
"9898",552,"198904.238.1170.3","NMFS",1989,10,11,284,20,41.3,-66.266667,0,0,0,0,0,"DE",0.038
"9899",552,"198904.239.1160.3","NMFS",1989,10,11,284,30,41.4,-66.316667,1,1,0,1,0,"DE",0.038
"9900",552,"198904.240.1170.1","NMFS",1989,10,11,284,30,41.433333,-66.1,1,1,0,1,0,"DE",0.038
"9901",552,"198904.241.1170.2","NMFS",1989,10,12,285,30,41.8,-65.866667,0,0,0,0,0,"DE",0.038
"9902",562,"198904.242.1190.2","NMFS",1989,10,12,285,30,41.666667,-67.216667,7,5,2,6,1,"DE",0.038
"9903",562,"198904.243.1190.4","NMFS",1989,10,12,285,30,41.5,-67.583333,0,0,0,0,0,"DE",0.038
"9904",562,"198904.244.1190.1","NMFS",1989,10,12,285,30,41.483333,-67.633333,0,0,0,0,0,"DE",0.038
"9905",525,"198904.245.1190.5","NMFS",1989,10,12,285,30,41.333333,-67.7,0,0,0,0,0,"DE",0.038
"9906",522,"198904.246.1200.6","NMFS",1989,10,12,285,30,41.65,-67.966667,1,1,0,1,0,"DE",0.038
"9907",522,"198904.247.1200.3","NMFS",1989,10,12,285,30,41.783333,-68,7,5,2,7,0,"DE",0.038
"9908",522,"198904.248.1240.2","NMFS",1989,10,13,286,30,41.833333,-68.516667,1,0,1,1,0,"DE",0.038
"9909",521,"198904.249.1250.5","NMFS",1989,10,13,286,30,41.483333,-69.55,7,3,4,6,1,"DE",0.038
"9910",521,"198904.250.1240.6","NMFS",1989,10,17,290,30,42.033333,-69.716667,0,0,0,0,0,"DE",0.038
"9911",521,"198904.251.1280.4","NMFS",1989,10,18,291,30,42.283333,-69.133333,0,0,0,0,0,"DE",0.038
"9912",522,"198904.252.1240.4","NMFS",1989,10,18,291,30,42.15,-68.75,0,0,0,0,0,"DE",0.038
"9913",514,"198904.254.3590.1","NMFS",1989,10,21,294,30,41.85,-70.4,136,65,71,109,27,"DE",0.038
"9914",514,"198904.255.3600.2","NMFS",1989,10,21,294,30,41.916667,-70.416667,77,38,39,62,15,"DE",0.038
"9915",514,"198904.256.3600.1","NMFS",1989,10,21,294,30,41.95,-70.483333,122,66,56,93,29,"DE",0.038
"9916",514,"198904.257.3610.2","NMFS",1989,10,21,294,30,42.1,-70.45,109,44,65,101,8,"DE",0.038
"9917",514,"198904.258.3610.1","NMFS",1989,10,21,294,30,42.116667,-70.183333,4,2,2,4,0,"DE",0.038
"9918",514,"198904.259.1270.2","NMFS",1989,10,21,294,30,42.2,-70,1,0,1,1,0,"DE",0.038
"9919",514,"198904.260.1260.4","NMFS",1989,10,22,295,30,42.366667,-70.55,1,0,1,1,0,"DE",0.038
"9920",514,"198904.261.1260.5","NMFS",1989,10,22,295,30,42.366667,-70.35,0,0,0,0,0,"DE",0.038
"9921",514,"198904.262.1260.2","NMFS",1989,10,22,295,30,42.4,-70.216667,0,0,0,0,0,"DE",0.038
"9922",514,"198904.263.1260.3","NMFS",1989,10,22,295,30,42.383333,-70.1,0,0,0,0,0,"DE",0.038
"9923",514,"198904.264.1270.1","NMFS",1989,10,22,295,30,42.4,-69.966667,0,0,0,0,0,"DE",0.038
"9924",514,"198904.265.1280.5","NMFS",1989,10,22,295,30,42.516667,-69.883333,0,0,0,0,0,"DE",0.038
"9925",514,"198904.266.1280.7","NMFS",1989,10,22,295,30,42.6,-69.683333,0,0,0,0,0,"DE",0.038
"9926",514,"198904.267.1280.6","NMFS",1989,10,22,295,30,42.683333,-69.716667,0,0,0,0,0,"DE",0.038
"9927",515,"198904.268.1370.4","NMFS",1989,10,22,295,30,42.7,-69.066667,0,0,0,0,0,"DE",0.038
"9928",515,"198904.269.1280.1","NMFS",1989,10,22,295,30,42.666667,-68.616667,0,0,0,0,0,"DE",0.038
"9929",515,"198904.270.1280.3","NMFS",1989,10,23,296,30,42.516667,-68.633333,0,0,0,0,0,"DE",0.038
"9930",515,"198904.271.1280.2","NMFS",1989,10,23,296,30,42.383333,-68.8,0,0,0,0,0,"DE",0.038
"9931",522,"198904.272.1290.6","NMFS",1989,10,23,296,30,42.25,-68.016667,0,0,0,0,0,"DE",0.038
"9932",522,"198904.273.1290.4","NMFS",1989,10,23,296,30,42.166667,-68.133333,0,0,0,0,0,"DE",0.038
"9933",522,"198904.274.1240.5","NMFS",1989,10,23,296,30,41.933333,-68.333333,0,0,0,0,0,"DE",0.038
"9934",522,"198904.275.1290.8","NMFS",1989,10,23,296,30,41.966667,-68.266667,0,0,0,0,0,"DE",0.038
"9935",522,"198904.276.1220.1","NMFS",1989,10,23,296,30,42.05,-68.016667,0,0,0,0,0,"DE",0.038
"9936",522,"198904.277.1200.2","NMFS",1989,10,23,296,30,41.833333,-67.683333,1,1,0,1,0,"DE",0.038
"9937",522,"198904.278.1210.4","NMFS",1989,10,23,296,30,42.033333,-67.7,0,0,0,0,0,"DE",0.038
"9938",561,"198904.279.1220.4","NMFS",1989,10,23,296,30,42.1,-67.616667,0,0,0,0,0,"DE",0.038
"9939",561,"198904.280.1200.4","NMFS",1989,10,23,296,30,42.066667,-67.483333,0,0,0,0,0,"DE",0.038
"9940",561,"198904.281.1210.1","NMFS",1989,10,23,296,30,42.116667,-67.366667,0,0,0,0,0,"DE",0.038
"9941",561,"198904.282.1290.7","NMFS",1989,10,24,297,30,42.3,-67.533333,1,1,0,1,0,"DE",0.038
"9942",515,"198904.283.1290.3","NMFS",1989,10,24,297,30,42.583333,-67.833333,0,0,0,0,0,"DE",0.038
"9943",464,"198904.284.1290.2","NMFS",1989,10,24,297,30,42.683333,-67.25,0,0,0,0,0,"DE",0.038
"9944",464,"198904.285.1300.1","NMFS",1989,10,24,297,30,42.583333,-67.15,1,0,1,1,0,"DE",0.038
"9945",464,"198904.286.1300.3","NMFS",1989,10,24,297,30,42.45,-67.183333,0,0,0,0,0,"DE",0.038
"9946",464,"198904.287.1300.2","NMFS",1989,10,24,297,30,42.35,-67.316667,1,1,0,1,0,"DE",0.038
"9947",561,"198904.288.1220.3","NMFS",1989,10,24,297,30,42.183333,-67.283333,0,0,0,0,0,"DE",0.038
"9948",561,"198904.289.1200.5","NMFS",1989,10,24,297,30,42.066667,-67.166667,0,0,0,0,0,"DE",0.038
"9949",551,"198904.290.1160.8","NMFS",1989,10,24,297,30,41.866667,-66.9,2,2,0,2,0,"DE",0.038
"9950",562,"198904.291.1160.4","NMFS",1989,10,24,297,30,41.8,-66.9,21,14,7,21,0,"DE",0.038
"9951",552,"198904.292.1160.10","NMFS",1989,10,24,297,30,41.633333,-66.55,0,0,0,0,0,"DE",0.038
"9952",551,"198904.293.1160.5","NMFS",1989,10,24,297,30,41.883333,-66.55,3,1,2,3,0,"DE",0.038
"9953",551,"198904.294.1160.7","NMFS",1989,10,25,298,30,41.916667,-66.416667,0,0,0,0,0,"DE",0.038
"9954",552,"198904.295.1160.1","NMFS",1989,10,25,298,30,41.833333,-65.916667,1,1,0,1,0,"DE",0.038
"9955",464,"198904.296.1290.1","NMFS",1989,10,25,298,30,42.016667,-65.75,0,0,0,0,0,"DE",0.038
"9956",551,"198904.297.1160.6","NMFS",1989,10,25,298,30,42.083333,-66.216667,0,0,0,0,0,"DE",0.038
"9957",551,"198904.298.1220.2","NMFS",1989,10,25,298,30,42.183333,-66.416667,0,0,0,0,0,"DE",0.038
"9958",551,"198904.299.1210.3","NMFS",1989,10,25,298,30,42.1,-66.466667,0,0,0,0,0,"DE",0.038
"9959",551,"198904.300.1210.2","NMFS",1989,10,25,298,30,42.133333,-66.566667,0,0,0,0,0,"DE",0.038
"9960",551,"198904.301.1290.5","NMFS",1989,10,25,298,30,42.316667,-66.433333,0,0,0,0,0,"DE",0.038
"9961",464,"198904.302.1360.1","NMFS",1989,10,25,298,30,42.866667,-67.016667,0,0,0,0,0,"DE",0.038
"9962",465,"198904.303.1340.3","NMFS",1989,10,25,298,20,43.083333,-66.55,2,1,1,2,0,"DE",0.038
"9963",465,"198904.304.1330.1","NMFS",1989,10,26,299,30,43.316667,-66.516667,2,2,0,2,0,"DE",0.038
"9964",465,"198904.305.1330.2","NMFS",1989,10,26,299,30,43.483333,-66.366667,2,2,0,2,0,"DE",0.038
"9965",465,"198904.306.1340.5","NMFS",1989,10,26,299,30,43.816667,-66.733333,2,1,1,2,0,"DE",0.038
"9966",465,"198904.307.1340.6","NMFS",1989,10,26,299,30,43.783333,-66.95,0,0,0,0,0,"DE",0.038
"9967",511,"198904.308.1340.1","NMFS",1989,10,26,299,30,43.95,-66.966667,1,1,0,1,0,"DE",0.038
"9968",466,"198904.309.1330.3","NMFS",1989,10,26,299,30,44.033333,-66.666667,2,2,0,2,0,"DE",0.038
"9969",466,"198904.310.1330.4","NMFS",1989,10,26,299,30,44.2,-66.516667,1,0,1,1,0,"DE",0.038
"9970",467,"198904.311.1351.1","NMFS",1989,10,26,299,30,44.366667,-66.983333,1,1,0,1,0,"DE",0.038
"9971",511,"198904.312.1390.2","NMFS",1989,10,26,299,30,44.3,-67.633333,2,1,1,2,0,"DE",0.038
"9972",511,"198904.313.1351.2","NMFS",1989,10,27,300,30,44.183333,-67.2,0,0,0,0,0,"DE",0.038
"9973",511,"198904.314.1340.4","NMFS",1989,10,27,300,30,44.1,-67.216667,0,0,0,0,0,"DE",0.038
"9974",511,"198904.315.1340.2","NMFS",1989,10,27,300,30,44.033333,-67.2,1,1,0,1,0,"DE",0.038
"9975",512,"198904.316.1360.5","NMFS",1989,10,27,300,30,43.883333,-67.866667,0,0,0,0,0,"DE",0.038
"9976",465,"198904.317.1360.8","NMFS",1989,10,27,300,30,43.8,-67.6,0,0,0,0,0,"DE",0.038
"9977",465,"198904.318.1360.4","NMFS",1989,10,27,300,30,43.683333,-67.416667,0,0,0,0,0,"DE",0.038
"9978",465,"198904.319.1360.3","NMFS",1989,10,27,300,30,43.066667,-67.35,0,0,0,0,0,"DE",0.038
"9979",514,"198904.320.1270.3","NMFS",1989,10,31,304,30,42.7,-70.116667,0,0,0,0,0,"DE",0.038
"9980",514,"198904.321.1260.1","NMFS",1989,10,31,304,22.5,42.716667,-70.316667,0,0,0,0,0,"DE",0.038
"9981",513,"198904.322.1270.4","NMFS",1989,10,31,304,30,43.05,-70.166667,0,0,0,0,0,"DE",0.038
"9982",513,"198904.323.1380.3","NMFS",1989,10,31,304,30,43.283333,-69.7,0,0,0,0,0,"DE",0.038
"9983",513,"198904.325.1370.6","NMFS",1989,10,31,304,30,43.116667,-69.566667,0,0,0,0,0,"DE",0.038
"9984",513,"198904.326.1370.3","NMFS",1989,10,31,304,30,43.05,-69.466667,0,0,0,0,0,"DE",0.038
"9985",513,"198904.327.1370.5","NMFS",1989,10,31,304,30,43.1,-69.183333,1,0,1,1,0,"DE",0.038
"9986",515,"198904.328.1370.2","NMFS",1989,10,31,304,30,43.266667,-68.95,0,0,0,0,0,"DE",0.038
"9987",515,"198904.329.1380.2","NMFS",1989,10,31,304,30,43.2,-68.4,0,0,0,0,0,"DE",0.038
"9988",515,"198904.330.1360.7","NMFS",1989,11,1,305,30,43.033333,-68.433333,0,0,0,0,0,"DE",0.038
"9989",515,"198904.331.1360.2","NMFS",1989,11,1,305,30,43.083333,-67.883333,0,0,0,0,0,"DE",0.038
"9990",512,"198904.332.1360.6","NMFS",1989,11,1,305,30,43.45,-67.666667,1,1,0,1,0,"DE",0.038
"9991",512,"198904.333.1380.1","NMFS",1989,11,1,305,30,43.716667,-68.233333,0,0,0,0,0,"DE",0.038
"9992",512,"198904.334.1390.3","NMFS",1989,11,1,305,30,43.966667,-68.616667,12,5,7,12,0,"DE",0.038
"9993",512,"198904.335.1390.1","NMFS",1989,11,1,305,30,43.916667,-68.75,26,9,17,25,1,"DE",0.038
"9994",513,"198904.338.1380.4","NMFS",1989,11,2,306,30,43.45,-69.416667,0,0,0,0,0,"DE",0.038
"9995",513,"198904.339.1380.6","NMFS",1989,11,2,306,30,43.533333,-69.516667,0,0,0,0,0,"DE",0.038
"9996",513,"198904.340.1400.2","NMFS",1989,11,2,306,22.5,43.55,-69.8,1,1,0,1,0,"DE",0.038
"9997",513,"198904.341.1400.1","NMFS",1989,11,2,306,30,43.316667,-70.166667,1,1,0,1,0,"DE",0.038
"9998",513,"198904.342.1400.3","NMFS",1989,11,2,306,30,43.116667,-70.35,2,0,2,2,0,"DE",0.038
"9999",526,"199002.163.1100.3","NMFS",1990,3,22,81,20,40.233333,-69.65,3,1,2,2,1,"DE",0.038
"10000",526,"199002.164.1110.1","NMFS",1990,3,22,81,30,39.966667,-69.5,21,6,15,15,6,"DE",0.038
"10001",526,"199002.165.1100.4","NMFS",1990,3,22,81,30,40.283333,-69.15,1,0,1,0,1,"DE",0.038
"10002",526,"199002.166.1100.8","NMFS",1990,3,22,81,30,40.533333,-69.35,0,0,0,0,0,"DE",0.038
"10003",526,"199002.167.1090.2","NMFS",1990,3,22,81,30,40.716667,-69.516667,0,0,0,0,0,"DE",0.038
"10004",526,"199002.168.3550.5","NMFS",1990,3,22,81,30,40.95,-69.833333,0,0,0,0,0,"DE",0.038
"10005",526,"199002.169.1100.5","NMFS",1990,3,23,82,30,40.6,-69.85,0,0,0,0,0,"DE",0.038
"10006",521,"199002.170.3550.2","NMFS",1990,3,27,86,30,41.383333,-69.716667,0,0,0,0,0,"DE",0.038
"10007",521,"199002.171.1250.1","NMFS",1990,3,27,86,30,41.55,-69.716667,0,0,0,0,0,"DE",0.038
"10008",521,"199002.172.1230.3","NMFS",1990,3,27,86,30,41.733333,-69.766667,0,0,0,0,0,"DE",0.038
"10009",521,"199002.173.1230.5","NMFS",1990,3,28,87,30,41.633333,-69.55,3,3,0,3,0,"DE",0.038
"10010",521,"199002.174.1250.3","NMFS",1990,3,28,87,30,41.566667,-69.566667,1,0,1,1,0,"DE",0.038
"10011",521,"199002.175.1240.3","NMFS",1990,3,28,87,30,41.433333,-69.15,0,0,0,0,0,"DE",0.038
"10012",521,"199002.176.1250.4","NMFS",1990,3,28,87,30,41.316667,-69.433333,0,0,0,0,0,"DE",0.038
"10013",521,"199002.177.1250.2","NMFS",1990,3,28,87,30,41.166667,-69.4,0,0,0,0,0,"DE",0.038
"10014",521,"199002.178.3550.1","NMFS",1990,3,28,87,30,41.183333,-69.533333,1,0,1,1,0,"DE",0.038
"10015",526,"199002.179.3550.4","NMFS",1990,3,28,87,30,41.033333,-69.516667,0,0,0,0,0,"DE",0.038
"10016",526,"199002.180.3550.3","NMFS",1990,3,28,87,30,40.883333,-69.466667,0,0,0,0,0,"DE",0.038
"10017",526,"199002.181.1090.5","NMFS",1990,3,28,87,30,40.85,-69.416667,0,0,0,0,0,"DE",0.038
"10018",525,"199002.182.1130.2","NMFS",1990,3,28,87,30,40.916667,-68.733333,0,0,0,0,0,"DE",0.038
"10019",522,"199002.183.1230.1","NMFS",1990,3,28,87,30,41.05,-68.666667,0,0,0,0,0,"DE",0.038
"10020",522,"199002.184.1190.3","NMFS",1990,3,28,87,30,41.033333,-68.416667,0,0,0,0,0,"DE",0.038
"10021",525,"199002.185.1130.9","NMFS",1990,3,29,88,30,40.633333,-68.55,0,0,0,0,0,"DE",0.038
"10022",525,"199002.186.1130.3","NMFS",1990,3,29,88,30,40.516667,-68.616667,0,0,0,0,0,"DE",0.038
"10023",526,"199002.187.1100.6","NMFS",1990,3,29,88,30,40.416667,-68.916667,0,0,0,0,0,"DE",0.038
"10024",525,"199002.188.1130.6","NMFS",1990,3,29,88,30,40.416667,-68.7,0,0,0,0,0,"DE",0.038
"10025",525,"199002.189.1140.2","NMFS",1990,3,29,88,30,40.3,-68.35,0,0,0,0,0,"DE",0.038
"10026",525,"199002.190.1140.1","NMFS",1990,3,29,88,30,40.5,-67.85,0,0,0,0,0,"DE",0.038
"10027",525,"199002.191.1150.1","NMFS",1990,3,29,88,30,40.5,-67.15,2,1,1,2,0,"DE",0.038
"10028",525,"199002.192.1140.3","NMFS",1990,3,29,88,30,40.533333,-67.183333,0,0,0,0,0,"DE",0.038
"10029",525,"199002.193.1130.5","NMFS",1990,3,30,89,30,40.666667,-67.45,0,0,0,0,0,"DE",0.038
"10030",525,"199002.194.1130.4","NMFS",1990,3,30,89,30,40.883333,-67.55,0,0,0,0,0,"DE",0.038
"10031",525,"199002.195.1130.7","NMFS",1990,3,30,89,30,40.75,-67.783333,0,0,0,0,0,"DE",0.038
"10032",525,"199002.198.1130.8","NMFS",1990,3,30,89,30,40.833333,-68.066667,0,0,0,0,0,"DE",0.038
"10033",525,"199002.199.1190.2","NMFS",1990,3,30,89,30,41.216667,-68.15,0,0,0,0,0,"DE",0.038
"10034",525,"199002.200.1190.6","NMFS",1990,3,30,89,30,41.083333,-67.85,0,0,0,0,0,"DE",0.038
"10035",525,"199002.201.1190.9","NMFS",1990,3,30,89,30,41.116667,-67.633333,0,0,0,0,0,"DE",0.038
"10036",525,"199002.202.1190.1","NMFS",1990,3,30,89,30,41.3,-67.7,0,0,0,0,0,"DE",0.038
"10037",562,"199002.203.1190.8","NMFS",1990,3,30,89,30,41.5,-67.466667,1,1,0,1,0,"DE",0.038
"10038",522,"199002.205.1200.3","NMFS",1990,3,31,90,30,41.716667,-67.866667,0,0,0,0,0,"DE",0.038
"10039",522,"199002.206.1200.6","NMFS",1990,3,31,90,30,41.75,-67.916667,1,1,0,1,0,"DE",0.038
"10040",522,"199002.207.1200.4","NMFS",1990,3,31,90,30,41.633333,-68.15,0,0,0,0,0,"DE",0.038
"10041",522,"199002.208.1200.5","NMFS",1990,3,31,90,30,41.633333,-68.283333,0,0,0,0,0,"DE",0.038
"10042",522,"199002.209.1200.2","NMFS",1990,3,31,90,30,41.583333,-68.416667,0,0,0,0,0,"DE",0.038
"10043",522,"199002.210.1230.2","NMFS",1990,3,31,90,30,41.433333,-68.383333,0,0,0,0,0,"DE",0.038
"10044",522,"199002.211.1230.4","NMFS",1990,3,31,90,30,41.333333,-68.566667,0,0,0,0,0,"DE",0.038
"10045",521,"199002.212.1240.4","NMFS",1990,3,31,90,30,41.583333,-68.85,0,0,0,0,0,"DE",0.038
"10046",521,"199002.213.1240.2","NMFS",1990,3,31,90,30,41.833333,-69.05,0,0,0,0,0,"DE",0.038
"10047",521,"199002.214.1280.4","NMFS",1990,3,31,90,30,41.866667,-69.216667,1,1,0,1,0,"DE",0.038
"10048",522,"199002.215.1240.1","NMFS",1990,4,1,91,30,42,-68.75,0,0,0,0,0,"DE",0.038
"10049",522,"199002.216.1240.5","NMFS",1990,4,1,91,30,42.05,-68.566667,0,0,0,0,0,"DE",0.038
"10050",515,"199002.217.1290.7","NMFS",1990,4,1,91,30,42.366667,-68.266667,0,0,0,0,0,"DE",0.038
"10051",521,"199002.218.1280.2","NMFS",1990,4,1,91,30,42.3,-68.85,2,2,0,2,0,"DE",0.038
"10052",521,"199002.219.1240.6","NMFS",1990,4,1,91,30,42.266667,-69.1,0,0,0,0,0,"DE",0.038
"10053",515,"199002.220.1370.4","NMFS",1990,4,1,91,30,42.7,-69.183333,1,1,0,1,0,"DE",0.038
"10054",515,"199002.221.1370.3","NMFS",1990,4,1,91,30,42.9,-68.6,0,0,0,0,0,"DE",0.038
"10055",515,"199002.222.1370.2","NMFS",1990,4,1,91,30,43,-68.583333,0,0,0,0,0,"DE",0.038
"10056",515,"199002.223.1360.1","NMFS",1990,4,2,92,30,42.983333,-67.983333,0,0,0,0,0,"DE",0.038
"10057",515,"199002.225.1360.9","NMFS",1990,4,2,92,30,43.266667,-67.966667,1,1,0,1,0,"DE",0.038
"10058",512,"199002.226.1380.2","NMFS",1990,4,2,92,30,43.35,-68.383333,0,0,0,0,0,"DE",0.038
"10059",513,"199002.227.1370.1","NMFS",1990,4,2,92,30,43.166667,-69.35,0,0,0,0,0,"DE",0.038
"10060",513,"199002.228.1370.5","NMFS",1990,4,2,92,30,43.133333,-69.75,0,0,0,0,0,"DE",0.038
"10061",513,"199002.229.1280.5","NMFS",1990,4,2,92,30,43.016667,-69.85,0,0,0,0,0,"DE",0.038
"10062",514,"199002.230.1280.1","NMFS",1990,4,2,92,30,42.683333,-69.75,0,0,0,0,0,"DE",0.038
"10063",514,"199002.231.1280.7","NMFS",1990,4,2,92,30,42.383333,-69.75,0,0,0,0,0,"DE",0.038
"10064",521,"199002.232.1280.3","NMFS",1990,4,3,93,30,42.3,-69.783333,0,0,0,0,0,"DE",0.038
"10065",521,"199002.233.1280.6","NMFS",1990,4,3,93,30,42.1,-69.666667,0,0,0,0,0,"DE",0.038
"10066",521,"199002.234.1270.4","NMFS",1990,4,3,93,30,42.15,-69.916667,4,4,0,4,0,"DE",0.038
"10067",514,"199002.236.1260.2","NMFS",1990,4,3,93,30,42.183333,-70.116667,0,0,0,0,0,"DE",0.038
"10068",514,"199002.237.1260.1","NMFS",1990,4,3,93,30,42.366667,-70.116667,0,0,0,0,0,"DE",0.038
"10069",514,"199002.238.1260.5","NMFS",1990,4,3,93,30,42.4,-70.183333,0,0,0,0,0,"DE",0.038
"10070",514,"199002.239.1260.4","NMFS",1990,4,3,93,30,42.35,-70.366667,9,6,3,9,0,"DE",0.038
"10071",514,"199002.243.3660.2","NMFS",1990,4,3,93,30,42.2,-70.516667,0,0,0,0,0,"DE",0.038
"10072",514,"199002.244.3600.2","NMFS",1990,4,3,93,30,42.083333,-70.566667,3,0,3,3,0,"DE",0.038
"10073",514,"199002.245.3610.2","NMFS",1990,4,4,94,30,42.083333,-70.366667,8,5,3,8,0,"DE",0.038
"10074",514,"199002.246.1260.3","NMFS",1990,4,4,94,30,42.133333,-70.316667,0,0,0,0,0,"DE",0.038
"10075",514,"199002.247.3560.1","NMFS",1990,4,4,94,27,42.1,-70.1,1,0,1,1,0,"DE",0.038
"10076",514,"199002.248.3660.1","NMFS",1990,4,4,94,26.5,42.816667,-70.666667,0,0,0,0,0,"DE",0.038
"10077",514,"199002.249.1270.1","NMFS",1990,4,5,95,30,42.816667,-70.4,0,0,0,0,0,"DE",0.038
"10078",513,"199002.250.1270.2","NMFS",1990,4,5,95,30,43,-70.366667,0,0,0,0,0,"DE",0.038
"10079",513,"199002.251.1400.1","NMFS",1990,4,5,95,30,43.183333,-70.216667,1,1,0,1,0,"DE",0.038
"10080",513,"199002.252.1270.3","NMFS",1990,4,5,95,30,43.333333,-70.05,0,0,0,0,0,"DE",0.038
"10081",513,"199002.254.1400.4","NMFS",1990,4,5,95,30,43.616667,-69.883333,1,0,1,1,0,"DE",0.038
"10082",562,"199002.256.1190.4","NMFS",1990,4,10,100,30,41.383333,-67.15,0,0,0,0,0,"DE",0.038
"10083",562,"199002.257.1190.5","NMFS",1990,4,10,100,30,41.216667,-67.266667,0,0,0,0,0,"DE",0.038
"10084",562,"199002.258.1130.1","NMFS",1990,4,10,100,30,40.866667,-66.916667,0,0,0,0,0,"DE",0.038
"10085",562,"199002.259.1170.3","NMFS",1990,4,10,100,30,40.85,-66.716667,1,1,0,1,0,"DE",0.038
"10086",562,"199002.260.1160.7","NMFS",1990,4,10,100,30,40.983333,-66.816667,0,0,0,0,0,"DE",0.038
"10087",552,"199002.261.1160.1","NMFS",1990,4,10,100,30,41.333333,-66.383333,0,0,0,0,0,"DE",0.038
"10088",552,"199002.262.1160.2","NMFS",1990,4,11,101,30,41.583333,-66.65,0,0,0,0,0,"DE",0.038
"10089",562,"199002.263.1160.4","NMFS",1990,4,11,101,30,41.466667,-66.783333,0,0,0,0,0,"DE",0.038
"10090",562,"199002.264.1160.9","NMFS",1990,4,11,101,30,41.616667,-66.966667,0,0,0,0,0,"DE",0.038
"10091",562,"199002.265.1190.7","NMFS",1990,4,11,101,30,41.716667,-67.05,0,0,0,0,0,"DE",0.038
"10092",561,"199002.266.1200.1","NMFS",1990,4,12,102,30,41.933333,-67.283333,0,0,0,0,0,"DE",0.038
"10093",561,"199002.267.1160.8","NMFS",1990,4,12,102,30,41.916667,-66.966667,0,0,0,0,0,"DE",0.038
"10094",552,"199002.268.1160.5","NMFS",1990,4,12,102,30,41.783333,-66.833333,0,0,0,0,0,"DE",0.038
"10095",552,"199002.269.1160.6","NMFS",1990,4,12,102,30,41.683333,-66.116667,0,0,0,0,0,"DE",0.038
"10096",552,"199002.270.1170.1","NMFS",1990,4,12,102,30,41.633333,-65.866667,0,0,0,0,0,"DE",0.038
"10097",551,"199002.272.1290.3","NMFS",1990,4,12,102,30,41.983333,-65.733333,0,0,0,0,0,"DE",0.038
"10098",551,"199002.273.1170.2","NMFS",1990,4,12,102,30,41.866667,-65.883333,0,0,0,0,0,"DE",0.038
"10099",551,"199002.274.1160.3","NMFS",1990,4,13,103,30,41.983333,-66.25,0,0,0,0,0,"DE",0.038
"10100",551,"199002.275.1210.4","NMFS",1990,4,13,103,30,42.116667,-66.15,1,0,1,1,0,"DE",0.038
"10101",464,"199002.276.1290.1","NMFS",1990,4,13,103,30,42.466667,-66.116667,4,3,1,4,0,"DE",0.038
"10102",551,"199002.277.1290.4","NMFS",1990,4,13,103,30,42.316667,-66.383333,0,0,0,0,0,"DE",0.038
"10103",551,"199002.278.1220.2","NMFS",1990,4,13,103,30,42.15,-66.4,4,3,1,4,0,"DE",0.038
"10104",551,"199002.279.1160.10","NMFS",1990,4,13,103,30,42.05,-66.55,1,1,0,1,0,"DE",0.038
"10105",551,"199002.280.1210.2","NMFS",1990,4,13,103,30,42.1,-66.583333,0,0,0,0,0,"DE",0.038
"10106",551,"199002.281.1210.3","NMFS",1990,4,13,103,30,42.15,-66.783333,0,0,0,0,0,"DE",0.038
"10107",561,"199002.282.1210.1","NMFS",1990,4,13,103,30,42.116667,-67.133333,0,0,0,0,0,"DE",0.038
"10108",551,"199002.283.1220.4","NMFS",1990,4,13,103,30,42.216667,-67.15,0,0,0,0,0,"DE",0.038
"10109",561,"199002.284.1290.5","NMFS",1990,4,13,103,30,42.25,-67.533333,2,1,1,2,0,"DE",0.038
"10110",522,"199002.285.1220.3","NMFS",1990,4,13,103,30,42.2,-67.666667,1,1,0,1,0,"DE",0.038
"10111",522,"199002.286.1220.1","NMFS",1990,4,14,104,30,42.1,-67.866667,0,0,0,0,0,"DE",0.038
"10112",522,"199002.287.1290.2","NMFS",1990,4,14,104,30,42.183333,-67.866667,0,0,0,0,0,"DE",0.038
"10113",464,"199002.288.1290.8","NMFS",1990,4,14,104,30,42.5,-67.533333,0,0,0,0,0,"DE",0.038
"10114",464,"199002.289.1300.3","NMFS",1990,4,14,104,30,42.466667,-67.366667,0,0,0,0,0,"DE",0.038
"10115",464,"199002.290.1300.2","NMFS",1990,4,14,104,30,42.516667,-67.1,0,0,0,0,0,"DE",0.038
"10116",464,"199002.291.1300.1","NMFS",1990,4,14,104,30,42.616667,-67.166667,1,1,0,1,0,"DE",0.038
"10117",464,"199002.292.1290.6","NMFS",1990,4,14,104,30,42.733333,-67.583333,0,0,0,0,0,"DE",0.038
"10118",464,"199002.293.1360.2","NMFS",1990,4,14,104,30,42.85,-67.383333,2,2,0,2,0,"DE",0.038
"10119",465,"199002.294.1360.5","NMFS",1990,4,14,104,30,43.166667,-67.416667,1,1,0,1,0,"DE",0.038
"10120",464,"199002.295.1360.4","NMFS",1990,4,14,104,30,42.9,-67.15,1,1,0,1,0,"DE",0.038
"10121",464,"199002.296.1340.4","NMFS",1990,4,14,104,30,42.95,-66.833333,0,0,0,0,0,"DE",0.038
"10122",465,"199002.297.1330.4","NMFS",1990,4,15,105,30,43.166667,-66.466667,1,1,0,1,0,"DE",0.038
"10123",465,"199002.298.1330.1","NMFS",1990,4,15,105,30,43.5,-66.433333,5,0,5,5,0,"DE",0.038
"10124",465,"199002.299.1330.2","NMFS",1990,4,15,105,30,43.55,-66.45,4,2,2,4,0,"DE",0.038
"10125",465,"199002.300.1340.1","NMFS",1990,4,15,105,30,43.6,-66.566667,1,1,0,1,0,"DE",0.038
"10126",465,"199002.301.1340.2","NMFS",1990,4,15,105,30,43.533333,-66.683333,0,0,0,0,0,"DE",0.038
"10127",465,"199002.302.1340.3","NMFS",1990,4,15,105,30,43.566667,-66.983333,0,0,0,0,0,"DE",0.038
"10128",465,"199002.303.1340.6","NMFS",1990,4,15,105,30,43.816667,-67.066667,0,0,0,0,0,"DE",0.038
"10129",465,"199002.304.1330.3","NMFS",1990,4,15,105,30,43.983333,-66.55,4,3,1,4,0,"DE",0.038
"10130",466,"199002.305.1351.1","NMFS",1990,4,15,105,30,44.266667,-66.7,0,0,0,0,0,"DE",0.038
"10131",466,"199002.306.1351.2","NMFS",1990,4,15,105,30,44.183333,-66.833333,0,0,0,0,0,"DE",0.038
"10132",511,"199002.307.1340.5","NMFS",1990,4,16,106,30,44.1,-67.3,0,0,0,0,0,"DE",0.038
"10133",511,"199002.308.1380.5","NMFS",1990,4,16,106,30,44.3,-67.366667,0,0,0,0,0,"DE",0.038
"10134",511,"199002.309.1390.1","NMFS",1990,4,16,106,30,44.333333,-67.666667,1,0,1,1,0,"DE",0.038
"10135",512,"199002.310.1390.3","NMFS",1990,4,16,106,30,44.233333,-67.9,3,2,1,3,0,"DE",0.038
"10136",512,"199002.311.1390.5","NMFS",1990,4,16,106,30,44.083333,-68,1,0,1,1,0,"DE",0.038
"10137",512,"199002.312.1380.3","NMFS",1990,4,16,106,30,44,-68.033333,1,1,0,1,0,"DE",0.038
"10138",511,"199002.313.1360.7","NMFS",1990,4,16,106,30,43.9,-67.6,0,0,0,0,0,"DE",0.038
"10139",512,"199002.314.1360.8","NMFS",1990,4,16,106,30,43.733333,-67.916667,0,0,0,0,0,"DE",0.038
"10140",512,"199002.315.1360.6","NMFS",1990,4,16,106,30,43.566667,-67.816667,0,0,0,0,0,"DE",0.038
"10141",512,"199002.316.1380.1","NMFS",1990,4,16,106,30,43.583333,-68.333333,5,3,2,5,0,"DE",0.038
"10142",512,"199002.317.1390.2","NMFS",1990,4,17,107,30,43.85,-68.583333,2,2,0,2,0,"DE",0.038
"10143",512,"199002.318.1390.4","NMFS",1990,4,17,107,20,43.7,-68.916667,1,1,0,1,0,"DE",0.038
"10144",513,"199002.319.1380.4","NMFS",1990,4,17,107,30,43.6,-69.083333,2,1,1,2,0,"DE",0.038
"10145",514,"199002.320.3580.1","NMFS",1990,4,17,107,28,41.833333,-70.5,6,3,3,5,1,"DE",0.038
"10146",514,"199002.321.3600.1","NMFS",1990,4,17,107,30,41.9,-70.383333,14,7,7,12,2,"DE",0.038
"10147",514,"199002.322.3590.1","NMFS",1990,4,17,107,30,41.833333,-70.283333,2,2,0,1,1,"DE",0.038
"10148",526,"199004.176.1100.8","NMFS",1990,9,27,270,30,40.366667,-69.883333,3,2,1,3,0,"DE",0.038
"10149",526,"199004.177.1100.4","NMFS",1990,9,27,270,30,40.5,-69.816667,2,1,1,2,0,"DE",0.038
"10150",526,"199004.178.1090.4","NMFS",1990,9,27,270,30,40.683333,-69.833333,11,6,5,11,0,"DE",0.038
"10151",526,"199004.179.1100.3","NMFS",1990,9,27,270,30,40.583333,-69.766667,1,1,0,1,0,"DE",0.038
"10152",526,"199004.180.1090.1","NMFS",1990,9,27,270,30,40.716667,-69.566667,0,0,0,0,0,"DE",0.038
"10153",526,"199004.181.1090.3","NMFS",1990,9,27,270,30,40.783333,-69.316667,4,4,0,4,0,"DE",0.038
"10154",526,"199004.182.3550.4","NMFS",1990,9,28,271,30,40.966667,-69.55,4,3,1,3,1,"DE",0.038
"10155",521,"199004.184.1250.1","NMFS",1990,10,2,275,30,41.533333,-69.483333,0,0,0,0,0,"DE",0.038
"10156",521,"199004.187.1250.3","NMFS",1990,10,2,275,30,41.716667,-69.833333,2,1,1,2,0,"DE",0.038
"10157",521,"199004.188.3560.1","NMFS",1990,10,2,275,30,41.966667,-69.983333,18,9,9,17,1,"DE",0.038
"10158",521,"199004.189.1230.5","NMFS",1990,10,2,275,30,41.816667,-69.816667,1,0,1,1,0,"DE",0.038
"10159",521,"199004.190.1240.5","NMFS",1990,10,2,275,30,41.733333,-69.683333,0,0,0,0,0,"DE",0.038
"10160",521,"199004.191.1230.3","NMFS",1990,10,2,275,30,41.666667,-69.616667,0,0,0,0,0,"DE",0.038
"10161",521,"199004.193.1230.2","NMFS",1990,10,3,276,30,41.6,-69.416667,0,0,0,0,0,"DE",0.038
"10162",521,"199004.194.1230.1","NMFS",1990,10,3,276,30,41.4,-69.333333,0,0,0,0,0,"DE",0.038
"10163",521,"199004.195.1250.2","NMFS",1990,10,3,276,30,41.283333,-69.4,0,0,0,0,0,"DE",0.038
"10164",521,"199004.196.3550.2","NMFS",1990,10,3,276,30,41.35,-69.5,17,16,1,16,1,"DE",0.038
"10165",526,"199004.197.3550.1","NMFS",1990,10,3,276,30,41.083333,-69.6,1,1,0,1,0,"DE",0.038
"10166",526,"199004.198.3550.5","NMFS",1990,10,3,276,30,41.066667,-69.5,4,3,1,3,1,"DE",0.038
"10167",521,"199004.199.3550.3","NMFS",1990,10,3,276,30,41.116667,-69.433333,0,0,0,0,0,"DE",0.038
"10168",521,"199004.201.1250.4","NMFS",1990,10,4,277,30,41.116667,-69.283333,1,1,0,1,0,"DE",0.038
"10169",521,"199004.202.1240.3","NMFS",1990,10,4,277,30,41.366667,-69.033333,0,0,0,0,0,"DE",0.038
"10170",521,"199004.203.1240.6","NMFS",1990,10,5,278,30,41.733333,-69.016667,0,0,0,0,0,"DE",0.038
"10171",522,"199004.204.1240.1","NMFS",1990,10,5,278,30,41.483333,-68.733333,0,0,0,0,0,"DE",0.038
"10172",522,"199004.205.1230.4","NMFS",1990,10,6,279,30,41.35,-68.616667,1,1,0,1,0,"DE",0.038
"10173",525,"199004.206.1190.6","NMFS",1990,10,6,279,30,41.266667,-68.083333,4,4,0,4,0,"DE",0.038
"10174",522,"199004.207.1190.4","NMFS",1990,10,6,279,30,41.4,-67.85,0,0,0,0,0,"DE",0.038
"10175",562,"199004.208.1190.9","NMFS",1990,10,6,279,30,41.266667,-67.616667,0,0,0,0,0,"DE",0.038
"10176",525,"199004.209.1190.1","NMFS",1990,10,6,279,30,41.166667,-67.983333,0,0,0,0,0,"DE",0.038
"10177",525,"199004.210.1190.8","NMFS",1990,10,6,279,30,41.133333,-68.15,0,0,0,0,0,"DE",0.038
"10178",522,"199004.211.1200.3","NMFS",1990,10,6,279,30,41.166667,-68.5,3,1,2,3,0,"DE",0.038
"10179",525,"199004.212.1130.4","NMFS",1990,10,6,279,30,40.95,-68.783333,3,1,2,3,0,"DE",0.038
"10180",526,"199004.213.1100.5","NMFS",1990,10,6,279,30,40.4,-69.216667,0,0,0,0,0,"DE",0.038
"10181",526,"199004.214.1100.6","NMFS",1990,10,7,280,30,40.25,-69.283333,3,2,1,3,0,"DE",0.038
"10182",526,"199004.215.1120.1","NMFS",1990,10,7,280,30,39.916667,-69.5,5,4,1,5,0,"DE",0.038
"10183",526,"199004.216.1110.1","NMFS",1990,10,7,280,30,39.983333,-69.316667,3,1,2,2,1,"DE",0.038
"10184",526,"199004.217.1110.2","NMFS",1990,10,7,280,30,40.183333,-69.116667,1,0,1,1,0,"DE",0.038
"10185",526,"199004.218.1100.2","NMFS",1990,10,7,280,30,40.283333,-69.083333,2,0,2,0,2,"DE",0.038
"10186",525,"199004.219.1130.7","NMFS",1990,10,7,280,30,40.4,-68.816667,1,1,0,1,0,"DE",0.038
"10187",525,"199004.220.1140.3","NMFS",1990,10,7,280,30,40.25,-68.733333,2,2,0,1,1,"DE",0.038
"10188",525,"199004.221.1140.1","NMFS",1990,10,7,280,30,40.233333,-68.583333,0,0,0,0,0,"DE",0.038
"10189",525,"199004.222.1130.1","NMFS",1990,10,7,280,30,40.616667,-68.583333,0,0,0,0,0,"DE",0.038
"10190",525,"199004.223.1190.2","NMFS",1990,10,7,280,30,40.783333,-68.333333,0,0,0,0,0,"DE",0.038
"10191",525,"199004.224.1130.9","NMFS",1990,10,7,280,30,40.783333,-68.133333,0,0,0,0,0,"DE",0.038
"10192",525,"199004.225.1130.3","NMFS",1990,10,8,281,30,40.583333,-68.283333,2,1,1,2,0,"DE",0.038
"10193",525,"199004.226.1130.8","NMFS",1990,10,8,281,30,40.516667,-68.233333,0,0,0,0,0,"DE",0.038
"10194",525,"199004.227.1130.2","NMFS",1990,10,8,281,30,40.516667,-67.966667,0,0,0,0,0,"DE",0.038
"10195",525,"199004.228.1140.2","NMFS",1990,10,8,281,30,40.533333,-67.65,0,0,0,0,0,"DE",0.038
"10196",525,"199004.229.1150.1","NMFS",1990,10,8,281,23,40.516667,-67.116667,0,0,0,0,0,"DE",0.038
"10197",525,"199004.230.1130.6","NMFS",1990,10,8,281,30,40.983333,-67.166667,0,0,0,0,0,"DE",0.038
"10198",562,"199004.231.1130.5","NMFS",1990,10,8,281,30,41.033333,-67.133333,0,0,0,0,0,"DE",0.038
"10199",562,"199004.232.1160.1","NMFS",1990,10,8,281,30,41.016667,-66.95,0,0,0,0,0,"DE",0.038
"10200",562,"199004.233.1160.10","NMFS",1990,10,8,281,30,41.1,-67.033333,1,1,0,1,0,"DE",0.038
"10201",562,"199004.234.1160.7","NMFS",1990,10,8,281,30,41.233333,-66.9,1,1,0,1,0,"DE",0.038
"10202",562,"199004.235.1160.4","NMFS",1990,10,8,281,30,41.15,-66.75,1,1,0,1,0,"DE",0.038
"10203",562,"199004.236.1160.2","NMFS",1990,10,8,281,30,41.083333,-66.483333,1,0,1,1,0,"DE",0.038
"10204",562,"199004.237.1170.2","NMFS",1990,10,9,282,30,41.133333,-66.4,0,0,0,0,0,"DE",0.038
"10205",552,"199004.238.1170.1","NMFS",1990,10,9,282,30,41.233333,-66.3,1,1,0,1,0,"DE",0.038
"10206",562,"199004.239.1160.3","NMFS",1990,10,9,282,30,41.45,-66.633333,1,1,0,1,0,"DE",0.038
"10207",562,"199004.240.1160.5","NMFS",1990,10,9,282,30,41.583333,-66.733333,2,1,1,2,0,"DE",0.038
"10208",562,"199004.241.1160.15","NMFS",1990,10,9,282,30,41.633333,-66.883333,0,0,0,0,0,"DE",0.038
"10209",552,"199004.242.1160.9","NMFS",1990,10,9,282,30,41.683333,-66.566667,0,0,0,0,0,"DE",0.038
"10210",552,"199004.243.1160.14","NMFS",1990,10,9,282,30,41.75,-66.466667,0,0,0,0,0,"DE",0.038
"10211",552,"199004.244.1160.16","NMFS",1990,10,9,282,30,41.783333,-66.216667,0,0,0,0,0,"DE",0.038
"10212",552,"199004.245.1160.11","NMFS",1990,10,9,282,30,41.75,-66.033333,0,0,0,0,0,"DE",0.038
"10213",552,"199004.246.1180.1","NMFS",1990,10,9,282,30,41.683333,-65.8,0,0,0,0,0,"DE",0.038
"10214",551,"199004.247.1170.3","NMFS",1990,10,9,282,30,41.9,-65.85,0,0,0,0,0,"DE",0.038
"10215",464,"199004.249.1290.7","NMFS",1990,10,10,283,30,42.366667,-66.383333,0,0,0,0,0,"DE",0.038
"10216",464,"199004.250.1290.8","NMFS",1990,10,10,283,30,42.383333,-66.433333,0,0,0,0,0,"DE",0.038
"10217",551,"199004.251.1220.3","NMFS",1990,10,10,283,28,42.15,-66.416667,4,1,3,4,0,"DE",0.038
"10218",551,"199004.252.1210.4","NMFS",1990,10,10,283,30,42.1,-66.416667,0,0,0,0,0,"DE",0.038
"10219",551,"199004.253.1160.13","NMFS",1990,10,10,283,30,42,-66.583333,0,0,0,0,0,"DE",0.038
"10220",551,"199004.254.1160.12","NMFS",1990,10,10,283,30,41.866667,-66.583333,0,0,0,0,0,"DE",0.038
"10221",551,"199004.255.1160.6","NMFS",1990,10,10,283,30,41.95,-66.816667,0,0,0,0,0,"DE",0.038
"10222",551,"199004.256.1160.8","NMFS",1990,10,10,283,24,41.95,-66.933333,2,0,2,1,1,"DE",0.038
"10223",562,"199004.257.1190.3","NMFS",1990,10,10,283,30,41.833333,-67.083333,2,1,1,1,1,"DE",0.038
"10224",561,"199004.258.1190.7","NMFS",1990,10,10,283,30,42,-67.05,0,0,0,0,0,"DE",0.038
"10225",551,"199004.259.1210.1","NMFS",1990,10,10,283,30,42.116667,-66.9,0,0,0,0,0,"DE",0.038
"10226",551,"199004.260.1210.2","NMFS",1990,10,10,283,30,42.15,-66.9,0,0,0,0,0,"DE",0.038
"10227",551,"199004.261.1220.4","NMFS",1990,10,10,283,30,42.183333,-66.833333,0,0,0,0,0,"DE",0.038
"10228",551,"199004.262.1220.2","NMFS",1990,10,11,284,30,42.166667,-66.916667,1,0,1,1,0,"DE",0.038
"10229",464,"199004.263.1300.3","NMFS",1990,10,11,284,30,42.516667,-66.95,0,0,0,0,0,"DE",0.038
"10230",464,"199004.264.1300.1","NMFS",1990,10,11,284,30,42.5,-67.016667,1,0,1,1,0,"DE",0.038
"10231",464,"199004.265.1300.2","NMFS",1990,10,11,284,30,42.416667,-67.066667,0,0,0,0,0,"DE",0.038
"10232",551,"199004.266.1290.5","NMFS",1990,10,11,284,30,42.283333,-67.216667,0,0,0,0,0,"DE",0.038
"10233",561,"199004.267.1290.3","NMFS",1990,10,11,284,30,42.216667,-67.55,0,0,0,0,0,"DE",0.038
"10234",561,"199004.268.1200.6","NMFS",1990,10,11,284,30,41.916667,-67.316667,4,2,2,4,0,"DE",0.038
"10235",562,"199004.269.1190.5","NMFS",1990,10,11,284,30,41.716667,-67.283333,9,5,4,9,0,"DE",0.038
"10236",522,"199004.270.1200.2","NMFS",1990,10,11,284,30,41.683333,-67.666667,1,1,0,1,0,"DE",0.038
"10237",514,"199004.271.3610.1","NMFS",1990,10,16,289,30,42.133333,-70.116667,11,7,4,10,1,"DE",0.038
"10238",521,"199004.272.1270.3","NMFS",1990,10,16,289,30,42.15,-69.966667,1,1,0,1,0,"DE",0.038
"10239",514,"199004.273.1280.4","NMFS",1990,10,16,289,30,42.416667,-69.7,0,0,0,0,0,"DE",0.038
"10240",515,"199004.274.1280.3","NMFS",1990,10,16,289,30,42.7,-69.616667,1,0,1,1,0,"DE",0.038
"10241",515,"199004.275.1280.6","NMFS",1990,10,16,289,30,42.4,-69.45,0,0,0,0,0,"DE",0.038
"10242",521,"199004.276.1280.5","NMFS",1990,10,16,289,30,42.266667,-69.333333,0,0,0,0,0,"DE",0.038
"10243",521,"199004.277.1280.2","NMFS",1990,10,16,289,30,42.216667,-69.45,0,0,0,0,0,"DE",0.038
"10244",521,"199004.278.1280.1","NMFS",1990,10,16,289,30,42.166667,-69.483333,0,0,0,0,0,"DE",0.038
"10245",521,"199004.279.1280.7","NMFS",1990,10,16,289,30,42.033333,-69.333333,0,0,0,0,0,"DE",0.038
"10246",521,"199004.280.1240.2","NMFS",1990,10,16,289,30,42.233333,-68.966667,0,0,0,0,0,"DE",0.038
"10247",521,"199004.281.1240.4","NMFS",1990,10,16,289,30,42.2,-68.85,0,0,0,0,0,"DE",0.038
"10248",522,"199004.282.1210.3","NMFS",1990,10,17,290,30,41.783333,-68.2,0,0,0,0,0,"DE",0.038
"10249",522,"199004.283.1200.5","NMFS",1990,10,17,290,30,41.75,-68.116667,2,1,1,1,1,"DE",0.038
"10250",522,"199004.284.1200.4","NMFS",1990,10,17,290,30,41.633333,-67.95,0,0,0,0,0,"DE",0.038
"10251",522,"199004.285.1200.1","NMFS",1990,10,17,290,30,41.616667,-67.833333,0,0,0,0,0,"DE",0.038
"10252",522,"199004.286.1220.1","NMFS",1990,10,17,290,30,41.933333,-68.066667,0,0,0,0,0,"DE",0.038
"10253",522,"199004.287.1290.2","NMFS",1990,10,17,290,30,42.3,-68.4,0,0,0,0,0,"DE",0.038
"10254",522,"199004.288.1290.6","NMFS",1990,10,17,290,30,42.333333,-68.183333,0,0,0,0,0,"DE",0.038
"10255",522,"199004.289.1290.1","NMFS",1990,10,17,290,30,42.333333,-68.033333,0,0,0,0,0,"DE",0.038
"10256",515,"199004.290.1290.4","NMFS",1990,10,17,290,30,42.583333,-68.216667,0,0,0,0,0,"DE",0.038
"10257",515,"199004.291.1360.8","NMFS",1990,10,17,290,30,42.8,-68.333333,0,0,0,0,0,"DE",0.038
"10258",515,"199004.292.1360.1","NMFS",1990,10,17,290,30,42.983333,-67.833333,0,0,0,0,0,"DE",0.038
"10259",464,"199004.293.1360.2","NMFS",1990,10,18,291,30,42.933333,-67.033333,1,1,0,1,0,"DE",0.038
"10260",465,"199004.294.1330.1","NMFS",1990,10,18,291,30,43.333333,-66.55,0,0,0,0,0,"DE",0.038
"10261",465,"199004.295.1330.2","NMFS",1990,10,18,291,30,43.4,-66.55,1,0,1,1,0,"DE",0.038
"10262",465,"199004.296.1330.4","NMFS",1990,10,18,291,30,43.616667,-66.45,1,0,1,1,0,"DE",0.038
"10263",465,"199004.297.1340.5","NMFS",1990,10,18,291,30,43.666667,-66.733333,0,0,0,0,0,"DE",0.038
"10264",465,"199004.298.1340.1","NMFS",1990,10,18,291,30,43.566667,-66.85,0,0,0,0,0,"DE",0.038
"10265",465,"199004.299.1340.3","NMFS",1990,10,18,291,30,43.716667,-66.95,0,0,0,0,0,"DE",0.038
"10266",465,"199004.300.1340.6","NMFS",1990,10,19,292,30,43.716667,-67.3,0,0,0,0,0,"DE",0.038
"10267",465,"199004.301.1340.4","NMFS",1990,10,19,292,30,43.766667,-67.1,0,0,0,0,0,"DE",0.038
"10268",466,"199004.302.1330.3","NMFS",1990,10,20,293,30,44.15,-66.533333,0,0,0,0,0,"DE",0.038
"10269",466,"199004.304.1351.3","NMFS",1990,10,21,294,30,44.266667,-66.683333,0,0,0,0,0,"DE",0.038
"10270",466,"199004.305.1351.2","NMFS",1990,10,21,294,30,44.183333,-66.816667,1,1,0,1,0,"DE",0.038
"10271",511,"199004.306.1340.2","NMFS",1990,10,21,294,30,44.05,-67.183333,0,0,0,0,0,"DE",0.038
"10272",511,"199004.307.1360.7","NMFS",1990,10,21,294,30,44.216667,-67.5,0,0,0,0,0,"DE",0.038
"10273",511,"199004.308.1390.1","NMFS",1990,10,21,294,30,44.35,-67.716667,6,3,3,6,0,"DE",0.038
"10274",511,"199004.309.1390.2","NMFS",1990,10,21,294,30,44.316667,-67.75,13,7,6,7,6,"DE",0.038
"10275",511,"199004.310.1390.5","NMFS",1990,10,21,294,30,44.233333,-67.733333,0,0,0,0,0,"DE",0.038
"10276",511,"199004.311.1380.3","NMFS",1990,10,21,294,30,44.2,-67.766667,0,0,0,0,0,"DE",0.038
"10277",512,"199004.312.1390.4","NMFS",1990,10,21,294,24.5,44.183333,-68.016667,2,1,1,2,0,"DE",0.038
"10278",512,"199004.313.1360.6","NMFS",1990,10,21,294,30,43.916667,-67.833333,0,0,0,0,0,"DE",0.038
"10279",511,"199004.314.1360.4","NMFS",1990,10,21,294,30,43.883333,-67.583333,0,0,0,0,0,"DE",0.038
"10280",465,"199004.315.1360.5","NMFS",1990,10,21,294,30,43.6,-67.65,0,0,0,0,0,"DE",0.038
"10281",512,"199004.316.1360.3","NMFS",1990,10,21,294,30,43.683333,-67.883333,0,0,0,0,0,"DE",0.038
"10282",512,"199004.317.1380.4","NMFS",1990,10,22,295,30,43.7,-68.066667,0,0,0,0,0,"DE",0.038
"10283",512,"199004.318.1380.2","NMFS",1990,10,22,295,30,43.616667,-68.366667,0,0,0,0,0,"DE",0.038
"10284",512,"199004.319.1390.3","NMFS",1990,10,22,295,30,43.8,-68.666667,1,0,1,1,0,"DE",0.038
"10285",513,"199004.320.1380.1","NMFS",1990,10,22,295,30,43.55,-69.166667,0,0,0,0,0,"DE",0.038
"10286",515,"199004.321.1370.2","NMFS",1990,10,22,295,30,43.233333,-68.633333,0,0,0,0,0,"DE",0.038
"10287",515,"199004.322.1370.1","NMFS",1990,10,22,295,30,43.1,-68.7,0,0,0,0,0,"DE",0.038
"10288",515,"199004.323.1370.5","NMFS",1990,10,22,295,30,42.933333,-69.05,0,0,0,0,0,"DE",0.038
"10289",513,"199004.324.1370.4","NMFS",1990,10,22,295,30,43.183333,-69.366667,0,0,0,0,0,"DE",0.038
"10290",513,"199004.325.1380.5","NMFS",1990,10,23,296,30,43.45,-69.916667,0,0,0,0,0,"DE",0.038
"10291",513,"199004.326.1270.1","NMFS",1990,10,23,296,30,43.35,-70.1,0,0,0,0,0,"DE",0.038
"10292",513,"199004.327.1400.1","NMFS",1990,10,23,296,30,43.183333,-70.316667,3,2,1,3,0,"DE",0.038
"10293",513,"199004.328.1270.2","NMFS",1990,10,23,296,30,43.066667,-70.016667,0,0,0,0,0,"DE",0.038
"10294",513,"199004.329.1370.3","NMFS",1990,10,23,296,30,43.033333,-69.8,0,0,0,0,0,"DE",0.038
"10295",513,"199004.330.1260.7","NMFS",1990,10,23,296,30,42.983333,-70.033333,0,0,0,0,0,"DE",0.038
"10296",513,"199004.332.1270.4","NMFS",1990,10,23,296,30,42.95,-70.366667,1,1,0,1,0,"DE",0.038
"10297",514,"199004.333.3650.1","NMFS",1990,10,23,296,30,42.766667,-70.683333,48,22,26,45,3,"DE",0.038
"10298",514,"199004.334.1400.2","NMFS",1990,10,23,296,30,42.783333,-70.6,7,3,4,7,0,"DE",0.038
"10299",514,"199004.335.1260.3","NMFS",1990,10,24,297,30,42.633333,-70.333333,0,0,0,0,0,"DE",0.038
"10300",514,"199004.336.1260.4","NMFS",1990,10,24,297,30,42.433333,-70.233333,0,0,0,0,0,"DE",0.038
"10301",514,"199004.338.1260.2","NMFS",1990,10,24,297,30,42.333333,-70.566667,40,13,27,40,0,"DE",0.038
"10302",514,"199004.339.3660.1","NMFS",1990,10,24,297,20,42.5,-70.7,64,30,34,55,9,"DE",0.038
"10303",514,"199004.340.3660.2","NMFS",1990,10,24,297,20,42.45,-70.65,41,18,23,41,0,"DE",0.038
"10304",514,"199004.342.3590.1","NMFS",1990,10,24,297,30,41.783333,-70.35,28,12,16,28,0,"DE",0.038
"10305",514,"199004.343.3600.1","NMFS",1990,10,24,297,30,41.916667,-70.25,11,1,10,10,1,"DE",0.038
"10306",514,"199004.344.3610.2","NMFS",1990,10,25,298,30,42.05,-70.3,24,9,15,23,1,"DE",0.038
"10307",514,"199004.345.1260.6","NMFS",1990,10,25,298,30,42.116667,-70.416667,52,19,33,50,2,"DE",0.038
"10308",526,"199102.179.1100.5","NMFS",1991,3,28,87,30,40.5,-69.9,0,0,0,0,0,"DE",0.038
"10309",526,"199102.180.1100.1","NMFS",1991,3,28,87,30,40.616667,-69.783333,0,0,0,0,0,"DE",0.038
"10310",526,"199102.181.1090.1","NMFS",1991,3,28,87,30,40.666667,-69.716667,1,1,0,1,0,"DE",0.038
"10311",526,"199102.182.1090.2","NMFS",1991,3,28,87,30,40.866667,-69.433333,0,0,0,0,0,"DE",0.038
"10312",526,"199102.183.3550.2","NMFS",1991,3,28,87,30,40.933333,-69.55,0,0,0,0,0,"DE",0.038
"10313",526,"199102.184.3550.3","NMFS",1991,3,28,87,30,41.016667,-69.733333,0,0,0,0,0,"DE",0.038
"10314",521,"199102.185.3550.4","NMFS",1991,3,28,87,30,41.25,-69.666667,0,0,0,0,0,"DE",0.038
"10315",521,"199102.186.3550.1","NMFS",1991,3,28,87,30,41.4,-69.716667,1,1,0,0,1,"DE",0.038
"10316",521,"199102.187.1250.3","NMFS",1991,3,28,87,30,41.416667,-69.416667,0,0,0,0,0,"DE",0.038
"10317",521,"199102.188.1250.2","NMFS",1991,3,28,87,30,41.383333,-69.366667,0,0,0,0,0,"DE",0.038
"10318",521,"199102.190.3550.5","NMFS",1991,3,28,87,30,41.1,-69.4,1,0,1,1,0,"DE",0.038
"10319",521,"199102.191.1250.1","NMFS",1991,3,29,88,30,41.033333,-69.2,0,0,0,0,0,"DE",0.038
"10320",521,"199102.192.1230.1","NMFS",1991,3,29,88,30,41.083333,-69.033333,0,0,0,0,0,"DE",0.038
"10321",522,"199102.193.1230.2","NMFS",1991,3,29,88,30,41.333333,-68.583333,1,1,0,1,0,"DE",0.038
"10322",522,"199102.194.1230.4","NMFS",1991,3,29,88,30,41.066667,-68.666667,0,0,0,0,0,"DE",0.038
"10323",522,"199102.195.1200.5","NMFS",1991,3,29,88,30,41.083333,-68.6,0,0,0,0,0,"DE",0.038
"10324",522,"199102.196.1190.3","NMFS",1991,3,29,88,30,41.083333,-68.55,0,0,0,0,0,"DE",0.038
"10325",525,"199102.197.1190.8","NMFS",1991,3,29,88,30,40.916667,-68.483333,0,0,0,0,0,"DE",0.038
"10326",525,"199102.198.1130.7","NMFS",1991,3,29,88,30,40.7,-68.216667,0,0,0,0,0,"DE",0.038
"10327",525,"199102.199.1130.5","NMFS",1991,3,29,88,30,40.666667,-68.366667,0,0,0,0,0,"DE",0.038
"10328",525,"199102.200.1130.1","NMFS",1991,3,29,88,30,40.7,-68.466667,0,0,0,0,0,"DE",0.038
"10329",525,"199102.201.1130.3","NMFS",1991,3,29,88,30,40.666667,-68.75,0,0,0,0,0,"DE",0.038
"10330",526,"199102.202.1100.7","NMFS",1991,3,29,88,30,40.783333,-68.983333,5,4,1,5,0,"DE",0.038
"10331",526,"199102.203.1100.3","NMFS",1991,3,30,89,30,40.55,-69.016667,0,0,0,0,0,"DE",0.038
"10332",526,"199102.204.1100.8","NMFS",1991,3,30,89,30,40.5,-69.116667,1,0,1,1,0,"DE",0.038
"10333",526,"199102.205.1100.6","NMFS",1991,3,30,89,30,40.166667,-69.233333,0,0,0,0,0,"DE",0.038
"10334",526,"199102.206.1110.1","NMFS",1991,3,30,89,30,40.2,-68.85,0,0,0,0,0,"DE",0.038
"10335",525,"199102.207.1140.3","NMFS",1991,3,30,89,30,40.283333,-68.433333,0,0,0,0,0,"DE",0.038
"10336",525,"199102.208.1150.1","NMFS",1991,3,30,89,30,40.266667,-68.283333,9,4,5,8,1,"DE",0.038
"10337",525,"199102.209.1140.2","NMFS",1991,3,30,89,30,40.433333,-68.2,0,0,0,0,0,"DE",0.038
"10338",525,"199102.210.1140.1","NMFS",1991,3,31,90,30,40.466667,-67.966667,0,0,0,0,0,"DE",0.038
"10339",525,"199102.211.1130.8","NMFS",1991,3,31,90,30,40.683333,-67.566667,0,0,0,0,0,"DE",0.038
"10340",525,"199102.212.1130.4","NMFS",1991,3,31,90,30,40.716667,-67.616667,0,0,0,0,0,"DE",0.038
"10341",525,"199102.213.1130.9","NMFS",1991,3,31,90,30,40.666667,-67.65,0,0,0,0,0,"DE",0.038
"10342",525,"199102.214.1130.6","NMFS",1991,3,31,90,30,40.716667,-67.983333,0,0,0,0,0,"DE",0.038
"10343",525,"199102.215.1190.6","NMFS",1991,3,31,90,30,40.966667,-67.916667,0,0,0,0,0,"DE",0.038
"10344",525,"199102.216.1190.7","NMFS",1991,3,31,90,30,41.2,-67.85,0,0,0,0,0,"DE",0.038
"10345",525,"199102.217.1190.2","NMFS",1991,3,31,90,30,41.3,-67.816667,0,0,0,0,0,"DE",0.038
"10346",525,"199102.218.1130.2","NMFS",1991,3,31,90,30,40.983333,-67.166667,0,0,0,0,0,"DE",0.038
"10347",562,"199102.219.1160.3","NMFS",1991,3,31,90,30,40.916667,-66.833333,0,0,0,0,0,"DE",0.038
"10348",562,"199102.220.1160.2","NMFS",1991,4,1,91,30,41.083333,-66.85,0,0,0,0,0,"DE",0.038
"10349",562,"199102.221.1160.10","NMFS",1991,4,1,91,30,41.383333,-66.85,0,0,0,0,0,"DE",0.038
"10350",562,"199102.222.1160.8","NMFS",1991,4,1,91,30,41.6,-66.933333,0,0,0,0,0,"DE",0.038
"10351",552,"199102.223.1160.1","NMFS",1991,4,1,91,30,41.466667,-66.5,0,0,0,0,0,"DE",0.038
"10352",552,"199102.224.1160.5","NMFS",1991,4,1,91,30,41.416667,-66.35,0,0,0,0,0,"DE",0.038
"10353",552,"199102.225.1160.9","NMFS",1991,4,1,91,30,41.583333,-66.183333,0,0,0,0,0,"DE",0.038
"10354",552,"199102.226.1170.3","NMFS",1991,4,1,91,30,41.516667,-65.966667,0,0,0,0,0,"DE",0.038
"10355",552,"199102.227.1170.1","NMFS",1991,4,1,91,30,41.566667,-65.983333,1,1,0,1,0,"DE",0.038
"10356",552,"199102.228.1180.1","NMFS",1991,4,1,91,30,41.716667,-65.766667,2,2,0,2,0,"DE",0.038
"10357",551,"199102.229.1170.2","NMFS",1991,4,2,92,30,41.866667,-65.8,0,0,0,0,0,"DE",0.038
"10358",464,"199102.230.1290.1","NMFS",1991,4,2,92,30,42.05,-65.666667,0,0,0,0,0,"DE",0.038
"10359",464,"199102.231.1290.7","NMFS",1991,4,2,92,30,42.383333,-66.1,0,0,0,0,0,"DE",0.038
"10360",551,"199102.232.1290.8","NMFS",1991,4,2,92,30,42.266667,-66.316667,0,0,0,0,0,"DE",0.038
"10361",551,"199102.233.1220.4","NMFS",1991,4,2,92,30,42.166667,-66.333333,1,1,0,1,0,"DE",0.038
"10362",551,"199102.234.1210.2","NMFS",1991,4,2,92,30,42.133333,-66.283333,0,0,0,0,0,"DE",0.038
"10363",551,"199102.235.1210.4","NMFS",1991,4,2,92,30,42.116667,-66.133333,0,0,0,0,0,"DE",0.038
"10364",551,"199102.236.1160.4","NMFS",1991,4,2,92,30,41.95,-66.216667,0,0,0,0,0,"DE",0.038
"10365",552,"199102.237.1160.6","NMFS",1991,4,3,93,30,41.833333,-66.583333,0,0,0,0,0,"DE",0.038
"10366",551,"199102.238.1160.7","NMFS",1991,4,3,93,30,41.966667,-66.833333,0,0,0,0,0,"DE",0.038
"10367",551,"199102.239.1290.2","NMFS",1991,4,3,93,30,42.316667,-66.566667,0,0,0,0,0,"DE",0.038
"10368",464,"199102.240.1300.3","NMFS",1991,4,3,93,30,42.466667,-66.716667,0,0,0,0,0,"DE",0.038
"10369",551,"199102.241.1300.2","NMFS",1991,4,3,93,30,42.333333,-66.85,2,1,1,2,0,"DE",0.038
"10370",464,"199102.242.1300.1","NMFS",1991,4,3,93,30,42.366667,-67.05,2,2,0,2,0,"DE",0.038
"10371",551,"199102.243.1290.5","NMFS",1991,4,3,93,30,42.316667,-67.166667,1,1,0,1,0,"DE",0.038
"10372",561,"199102.244.1290.3","NMFS",1991,4,3,93,30,42.25,-67.266667,0,0,0,0,0,"DE",0.038
"10373",551,"199102.245.1220.1","NMFS",1991,4,3,93,30,42.2,-67.183333,0,0,0,0,0,"DE",0.038
"10374",561,"199102.246.1210.1","NMFS",1991,4,3,93,30,42.133333,-67.216667,0,0,0,0,0,"DE",0.038
"10375",561,"199102.247.1190.9","NMFS",1991,4,3,93,30,41.966667,-67.133333,0,0,0,0,0,"DE",0.038
"10376",561,"199102.248.1190.4","NMFS",1991,4,3,93,30,41.933333,-67.166667,3,1,2,2,1,"DE",0.038
"10377",561,"199102.249.1200.3","NMFS",1991,4,3,93,30,41.866667,-67.466667,0,0,0,0,0,"DE",0.038
"10378",562,"199102.250.1190.5","NMFS",1991,4,4,94,30,41.5,-67.466667,0,0,0,0,0,"DE",0.038
"10379",522,"199102.251.1190.1","NMFS",1991,4,4,94,30,41.65,-67.666667,0,0,0,0,0,"DE",0.038
"10380",522,"199102.252.1200.1","NMFS",1991,4,4,94,30,41.716667,-67.716667,0,0,0,0,0,"DE",0.038
"10381",522,"199102.253.1200.2","NMFS",1991,4,4,94,30,41.95,-67.716667,1,1,0,1,0,"DE",0.038
"10382",561,"199102.254.1200.6","NMFS",1991,4,4,94,30,42.016667,-67.566667,0,0,0,0,0,"DE",0.038
"10383",522,"199102.255.1220.2","NMFS",1991,4,4,94,30,42.05,-67.95,2,1,1,2,0,"DE",0.038
"10384",522,"199102.256.1220.3","NMFS",1991,4,4,94,30,41.966667,-68.033333,0,0,0,0,0,"DE",0.038
"10385",522,"199102.257.1210.3","NMFS",1991,4,4,94,30,41.8,-68.15,0,0,0,0,0,"DE",0.038
"10386",522,"199102.258.1200.4","NMFS",1991,4,4,94,30,41.716667,-68.283333,0,0,0,0,0,"DE",0.038
"10387",522,"199102.259.1290.4","NMFS",1991,4,4,94,30,41.916667,-68.3,2,2,0,2,0,"DE",0.038
"10388",522,"199102.260.1240.1","NMFS",1991,4,4,94,30,41.883333,-68.633333,0,0,0,0,0,"DE",0.038
"10389",521,"199102.261.1240.4","NMFS",1991,4,4,94,30,41.8,-68.883333,0,0,0,0,0,"DE",0.038
"10390",521,"199102.262.1240.6","NMFS",1991,4,5,95,30,41.783333,-69.083333,0,0,0,0,0,"DE",0.038
"10391",521,"199102.263.1240.3","NMFS",1991,4,5,95,30,41.8,-69.25,1,1,0,1,0,"DE",0.038
"10392",521,"199102.265.1230.3","NMFS",1991,4,5,95,30,41.766667,-69.783333,1,0,1,1,0,"DE",0.038
"10393",521,"199102.266.1230.5","NMFS",1991,4,5,95,30,41.7,-69.7,0,0,0,0,0,"DE",0.038
"10394",514,"199102.267.3600.1","NMFS",1991,4,9,99,30,42,-70.183333,10,3,7,10,0,"DE",0.038
"10395",514,"199102.268.3610.1","NMFS",1991,4,9,99,30,42.133333,-70.2,2,1,1,1,1,"DE",0.038
"10396",514,"199102.269.3610.2","NMFS",1991,4,9,99,30,42.133333,-70.1,6,4,2,6,0,"DE",0.038
"10397",514,"199102.270.1280.7","NMFS",1991,4,9,99,30,42.366667,-69.916667,0,0,0,0,0,"DE",0.038
"10398",514,"199102.271.1260.4","NMFS",1991,4,9,99,30,42.483333,-70.133333,0,0,0,0,0,"DE",0.038
"10399",514,"199102.272.1270.4","NMFS",1991,4,9,99,30,42.5,-69.983333,0,0,0,0,0,"DE",0.038
"10400",514,"199102.273.1280.3","NMFS",1991,4,9,99,30,42.5,-69.666667,0,0,0,0,0,"DE",0.038
"10401",515,"199102.274.1280.5","NMFS",1991,4,9,99,30,42.45,-69.433333,0,0,0,0,0,"DE",0.038
"10402",521,"199102.275.1280.4","NMFS",1991,4,9,99,30,42.183333,-69.266667,0,0,0,0,0,"DE",0.038
"10403",521,"199102.276.1240.5","NMFS",1991,4,10,100,30,42.25,-68.95,0,0,0,0,0,"DE",0.038
"10404",522,"199102.277.1240.2","NMFS",1991,4,10,100,30,42.133333,-68.716667,0,0,0,0,0,"DE",0.038
"10405",515,"199102.278.1280.6","NMFS",1991,4,10,100,30,42.366667,-68.8,0,0,0,0,0,"DE",0.038
"10406",515,"199102.279.1280.1","NMFS",1991,4,10,100,30,42.466667,-68.9,0,0,0,0,0,"DE",0.038
"10407",515,"199102.280.1280.2","NMFS",1991,4,10,100,30,42.55,-68.7,0,0,0,0,0,"DE",0.038
"10408",515,"199102.281.1370.1","NMFS",1991,4,10,100,30,42.85,-68.583333,0,0,0,0,0,"DE",0.038
"10409",515,"199102.282.1370.4","NMFS",1991,4,10,100,30,42.816667,-68.483333,0,0,0,0,0,"DE",0.038
"10410",515,"199102.283.1290.6","NMFS",1991,4,10,100,30,42.516667,-68.116667,0,0,0,0,0,"DE",0.038
"10411",515,"199102.284.1360.4","NMFS",1991,4,10,100,30,42.883333,-67.783333,0,0,0,0,0,"DE",0.038
"10412",515,"199102.285.1360.8","NMFS",1991,4,10,100,30,42.933333,-67.666667,0,0,0,0,0,"DE",0.038
"10413",515,"199102.286.1360.5","NMFS",1991,4,11,101,30,43.183333,-67.833333,2,2,0,2,0,"DE",0.038
"10414",512,"199102.287.1360.6","NMFS",1991,4,11,101,30,43.516667,-67.9,0,0,0,0,0,"DE",0.038
"10415",512,"199102.288.1380.5","NMFS",1991,4,11,101,30,43.766667,-68.1,1,1,0,1,0,"DE",0.038
"10416",512,"199102.289.1380.4","NMFS",1991,4,11,101,30,43.766667,-68.5,0,0,0,0,0,"DE",0.038
"10417",512,"199102.290.1390.2","NMFS",1991,4,11,101,30,43.883333,-68.433333,2,2,0,2,0,"DE",0.038
"10418",512,"199102.291.1380.1","NMFS",1991,4,11,101,30,44.016667,-67.933333,0,0,0,0,0,"DE",0.038
"10419",511,"199102.292.1390.4","NMFS",1991,4,11,101,30,44.3,-67.616667,1,0,1,1,0,"DE",0.038
"10420",511,"199102.293.1390.1","NMFS",1991,4,11,101,30,44.333333,-67.65,5,1,4,5,0,"DE",0.038
"10421",511,"199102.295.1351.1","NMFS",1991,4,12,102,30,44.183333,-66.85,2,0,2,2,0,"DE",0.038
"10422",511,"199102.296.1351.2","NMFS",1991,4,12,102,30,44.15,-66.95,1,1,0,1,0,"DE",0.038
"10423",511,"199102.297.1340.2","NMFS",1991,4,12,102,30,43.866667,-67.2,1,0,1,1,0,"DE",0.038
"10424",465,"199102.298.1360.3","NMFS",1991,4,12,102,30,43.5,-67.133333,1,0,1,1,0,"DE",0.038
"10425",465,"199102.299.1340.4","NMFS",1991,4,12,102,30,43.65,-66.683333,0,0,0,0,0,"DE",0.038
"10426",465,"199102.300.1330.3","NMFS",1991,4,13,103,30,43.766667,-66.55,2,1,1,2,0,"DE",0.038
"10427",465,"199102.301.1340.6","NMFS",1991,4,13,103,30,43.65,-66.583333,0,0,0,0,0,"DE",0.038
"10428",465,"199102.302.1330.2","NMFS",1991,4,13,103,30,43.466667,-66.433333,5,3,2,5,0,"DE",0.038
"10429",465,"199102.303.1330.1","NMFS",1991,4,13,103,30,43.4,-66.566667,0,0,0,0,0,"DE",0.038
"10430",464,"199102.305.1360.7","NMFS",1991,4,13,103,30,42.916667,-66.716667,0,0,0,0,0,"DE",0.038
"10431",465,"199102.306.1340.5","NMFS",1991,4,13,103,30,43,-66.75,0,0,0,0,0,"DE",0.038
"10432",465,"199102.307.1340.3","NMFS",1991,4,13,103,30,43.133333,-66.95,0,0,0,0,0,"DE",0.038
"10433",465,"199102.308.1340.1","NMFS",1991,4,13,103,30,43.183333,-67.033333,0,0,0,0,0,"DE",0.038
"10434",465,"199102.309.1360.2","NMFS",1991,4,13,103,30,43.033333,-67.3,3,1,2,3,0,"DE",0.038
"10435",465,"199102.310.1360.1","NMFS",1991,4,13,103,30,43.1,-67.5,1,1,0,1,0,"DE",0.038
"10436",515,"199102.311.1370.5","NMFS",1991,4,14,104,30,43.1,-68.65,0,0,0,0,0,"DE",0.038
"10437",515,"199102.312.1370.2","NMFS",1991,4,14,104,30,43.183333,-68.916667,0,0,0,0,0,"DE",0.038
"10438",513,"199102.313.1370.3","NMFS",1991,4,14,104,30,43.2,-69.183333,0,0,0,0,0,"DE",0.038
"10439",513,"199102.314.1380.3","NMFS",1991,4,14,104,30,43.283333,-69.383333,0,0,0,0,0,"DE",0.038
"10440",513,"199102.315.1400.3","NMFS",1991,4,14,104,30,43.616667,-69.7,1,0,1,1,0,"DE",0.038
"10441",513,"199102.316.1380.2","NMFS",1991,4,14,104,30,43.266667,-69.95,0,0,0,0,0,"DE",0.038
"10442",513,"199102.317.1270.1","NMFS",1991,4,14,104,30,43.3,-69.983333,0,0,0,0,0,"DE",0.038
"10443",513,"199102.318.1400.2","NMFS",1991,4,15,105,30,43.183333,-70.316667,3,2,1,3,0,"DE",0.038
"10444",513,"199102.319.1270.3","NMFS",1991,4,15,105,30,43.033333,-70.366667,0,0,0,0,0,"DE",0.038
"10445",513,"199102.320.1400.1","NMFS",1991,4,15,105,30,42.883333,-70.45,2,1,1,2,0,"DE",0.038
"10446",513,"199102.321.1270.2","NMFS",1991,4,15,105,30,42.9,-70.25,0,0,0,0,0,"DE",0.038
"10447",514,"199102.323.1260.2","NMFS",1991,4,15,105,30,42.75,-70.4,11,8,3,11,0,"DE",0.038
"10448",514,"199102.324.3660.2","NMFS",1991,4,15,105,30,42.733333,-70.616667,5,2,3,5,0,"DE",0.038
"10449",514,"199102.325.3630.1","NMFS",1991,4,15,105,30,42.716667,-70.733333,2,1,1,2,0,"DE",0.038
"10450",514,"199102.326.1260.5","NMFS",1991,4,15,105,30,42.616667,-70.4,0,0,0,0,0,"DE",0.038
"10451",514,"199102.328.3650.1","NMFS",1991,4,15,105,30,42.533333,-70.716667,1,0,1,1,0,"DE",0.038
"10452",514,"199102.330.1260.1","NMFS",1991,4,16,106,30,42.15,-70.416667,36,17,19,36,0,"DE",0.038
"10453",514,"199102.331.3590.1","NMFS",1991,4,16,106,30,42.05,-70.566667,3,1,2,3,0,"DE",0.038
"10454",514,"199102.332.3600.2","NMFS",1991,4,16,106,30,41.883333,-70.4,13,6,7,12,1,"DE",0.038
"10455",514,"199102.333.3580.1","NMFS",1991,4,16,106,30,41.883333,-70.15,1,0,1,1,0,"DE",0.038
"10456",526,"199105.178.3550.3","NMFS",1991,10,1,274,30,40.883333,-69.866667,0,0,0,0,0,"DE",0.038
"10457",526,"199105.179.1090.5","NMFS",1991,10,1,274,30,40.9,-69.733333,0,0,0,0,0,"DE",0.038
"10458",526,"199105.180.1090.4","NMFS",1991,10,1,274,30,40.75,-69.766667,5,4,1,5,0,"DE",0.038
"10459",526,"199105.181.1090.6","NMFS",1991,10,1,274,30,40.666667,-69.9,5,3,2,5,0,"DE",0.038
"10460",526,"199105.185.1100.7","NMFS",1991,10,1,274,30,40.216667,-69.633333,2,1,1,2,0,"DE",0.038
"10461",521,"199105.186.3550.1","NMFS",1991,10,2,275,30,41.3,-69.683333,15,7,8,13,2,"DE",0.038
"10462",521,"199105.187.3550.4","NMFS",1991,10,2,275,30,41.333333,-69.533333,10,9,1,10,0,"DE",0.038
"10463",521,"199105.189.1250.4","NMFS",1991,10,3,276,30,41.116667,-69.283333,5,3,2,4,1,"DE",0.038
"10464",521,"199105.190.3550.5","NMFS",1991,10,3,276,30,41.016667,-69.383333,0,0,0,0,0,"DE",0.038
"10465",521,"199105.191.1100.4","NMFS",1991,10,3,276,30,41,-69.083333,0,0,0,0,0,"DE",0.038
"10466",521,"199105.192.1240.2","NMFS",1991,10,3,276,30,41.233333,-69.05,0,0,0,0,0,"DE",0.038
"10467",521,"199105.193.1230.2","NMFS",1991,10,3,276,30,41.25,-68.9,0,0,0,0,0,"DE",0.038
"10468",522,"199105.194.1230.3","NMFS",1991,10,3,276,30,41.266667,-68.766667,0,0,0,0,0,"DE",0.038
"10469",522,"199105.195.1240.1","NMFS",1991,10,3,276,30,41.383333,-68.766667,0,0,0,0,0,"DE",0.038
"10470",522,"199105.196.1230.4","NMFS",1991,10,3,276,30,41.3,-68.55,1,1,0,1,0,"DE",0.038
"10471",522,"199105.197.1200.5","NMFS",1991,10,3,276,30,41.216667,-68.516667,1,0,1,1,0,"DE",0.038
"10472",522,"199105.198.1190.9","NMFS",1991,10,3,276,30,41.083333,-68.533333,1,1,0,1,0,"DE",0.038
"10473",522,"199105.199.1230.1","NMFS",1991,10,3,276,30,41.133333,-68.733333,0,0,0,0,0,"DE",0.038
"10474",521,"199105.200.1230.5","NMFS",1991,10,3,276,30,41.133333,-68.85,2,1,1,2,0,"DE",0.038
"10475",525,"199105.201.1130.2","NMFS",1991,10,4,277,30,40.916667,-68.75,2,0,2,2,0,"DE",0.038
"10476",526,"199105.202.1100.8","NMFS",1991,10,4,277,30,40.483333,-69.166667,0,0,0,0,0,"DE",0.038
"10477",526,"199105.203.1100.1","NMFS",1991,10,4,277,30,40.133333,-69.366667,2,0,2,2,0,"DE",0.038
"10478",526,"199105.204.1110.2","NMFS",1991,10,4,277,30,40.116667,-69.2,4,2,2,4,0,"DE",0.038
"10479",526,"199105.205.1120.1","NMFS",1991,10,4,277,30,40.016667,-69.2,3,1,2,2,1,"DE",0.038
"10480",525,"199105.206.1150.1","NMFS",1991,10,4,277,30,40.216667,-68.55,0,0,0,0,0,"DE",0.038
"10481",525,"199105.207.1140.2","NMFS",1991,10,4,277,30,40.283333,-68.583333,0,0,0,0,0,"DE",0.038
"10482",525,"199105.208.1130.3","NMFS",1991,10,4,277,30,40.483333,-68.533333,0,0,0,0,0,"DE",0.038
"10483",525,"199105.209.1140.1","NMFS",1991,10,4,277,30,40.45,-67.866667,0,0,0,0,0,"DE",0.038
"10484",525,"199105.210.1140.3","NMFS",1991,10,5,278,30,40.55,-67.6,0,0,0,0,0,"DE",0.038
"10485",525,"199105.211.1130.9","NMFS",1991,10,5,278,30,40.583333,-67.35,1,1,0,1,0,"DE",0.038
"10486",525,"199105.212.1130.6","NMFS",1991,10,5,278,30,40.783333,-67.083333,3,3,0,3,0,"DE",0.038
"10487",525,"199105.213.1130.4","NMFS",1991,10,5,278,30,40.8,-67.333333,0,0,0,0,0,"DE",0.038
"10488",525,"199105.214.1130.7","NMFS",1991,10,5,278,30,40.8,-67.533333,0,0,0,0,0,"DE",0.038
"10489",525,"199105.215.1130.5","NMFS",1991,10,5,278,30,40.866667,-67.833333,3,3,0,3,0,"DE",0.038
"10490",525,"199105.216.1130.1","NMFS",1991,10,5,278,30,40.916667,-67.883333,0,0,0,0,0,"DE",0.038
"10491",525,"199105.217.1190.1","NMFS",1991,10,5,278,30,40.95,-68.15,2,2,0,2,0,"DE",0.038
"10492",525,"199105.218.1190.3","NMFS",1991,10,5,278,30,40.983333,-68.283333,0,0,0,0,0,"DE",0.038
"10493",525,"199105.219.1190.7","NMFS",1991,10,5,278,30,41.033333,-68.066667,0,0,0,0,0,"DE",0.038
"10494",525,"199105.220.1190.5","NMFS",1991,10,5,278,30,41.05,-67.883333,2,2,0,2,0,"DE",0.038
"10495",525,"199105.221.1190.6","NMFS",1991,10,5,278,30,41.1,-67.616667,0,0,0,0,0,"DE",0.038
"10496",525,"199105.222.1130.8","NMFS",1991,10,6,279,30,41.016667,-67.5,0,0,0,0,0,"DE",0.038
"10497",562,"199105.223.1160.9","NMFS",1991,10,6,279,30,41.166667,-67,1,0,1,1,0,"DE",0.038
"10498",562,"199105.224.1160.2","NMFS",1991,10,6,279,30,41.133333,-66.8,0,0,0,0,0,"DE",0.038
"10499",562,"199105.225.1160.8","NMFS",1991,10,6,279,30,41.2,-66.75,0,0,0,0,0,"DE",0.038
"10500",562,"199105.226.1180.1","NMFS",1991,10,6,279,30,41.05,-66.433333,9,9,0,9,0,"DE",0.038
"10501",562,"199105.227.1160.10","NMFS",1991,10,6,279,30,41.383333,-66.566667,0,0,0,0,0,"DE",0.038
"10502",552,"199105.228.1160.6","NMFS",1991,10,6,279,30,41.366667,-66.466667,0,0,0,0,0,"DE",0.038
"10503",552,"199105.229.1160.4","NMFS",1991,10,6,279,30,41.416667,-66.316667,1,1,0,1,0,"DE",0.038
"10504",552,"199105.230.1170.1","NMFS",1991,10,6,279,30,41.4,-66.083333,2,1,1,2,0,"DE",0.038
"10505",552,"199105.231.1170.2","NMFS",1991,10,6,279,30,41.733333,-65.85,0,0,0,0,0,"DE",0.038
"10506",551,"199105.232.1170.3","NMFS",1991,10,7,280,30,41.85,-65.783333,0,0,0,0,0,"DE",0.038
"10507",551,"199105.233.1290.4","NMFS",1991,10,7,280,30,42.266667,-66.016667,0,0,0,0,0,"DE",0.038
"10508",551,"199105.234.1290.1","NMFS",1991,10,7,280,30,42.216667,-66.133333,0,0,0,0,0,"DE",0.038
"10509",551,"199105.235.1220.2","NMFS",1991,10,7,280,30,42.166667,-66.2,0,0,0,0,0,"DE",0.038
"10510",551,"199105.236.1160.1","NMFS",1991,10,7,280,30,41.983333,-66.566667,1,0,1,1,0,"DE",0.038
"10511",552,"199105.237.1160.7","NMFS",1991,10,7,280,30,41.666667,-66.533333,4,4,0,4,0,"DE",0.038
"10512",552,"199105.238.1160.5","NMFS",1991,10,7,280,30,41.8,-66.833333,7,5,2,7,0,"DE",0.038
"10513",551,"199105.239.1160.3","NMFS",1991,10,7,280,30,41.9,-66.85,3,3,0,3,0,"DE",0.038
"10514",551,"199105.240.1210.2","NMFS",1991,10,7,280,30,42.116667,-66.8,0,0,0,0,0,"DE",0.038
"10515",551,"199105.241.1290.8","NMFS",1991,10,7,280,30,42.183333,-66.85,0,0,0,0,0,"DE",0.038
"10516",551,"199105.242.1300.1","NMFS",1991,10,8,281,30,42.333333,-66.716667,0,0,0,0,0,"DE",0.038
"10517",551,"199105.243.1290.5","NMFS",1991,10,8,281,30,42.266667,-66.933333,0,0,0,0,0,"DE",0.038
"10518",551,"199105.244.1210.3","NMFS",1991,10,8,281,30,42.166667,-67.016667,0,0,0,0,0,"DE",0.038
"10519",561,"199105.245.1220.4","NMFS",1991,10,8,281,30,42.2,-67.283333,0,0,0,0,0,"DE",0.038
"10520",561,"199105.246.1300.2","NMFS",1991,10,8,281,30,42.316667,-67.45,0,0,0,0,0,"DE",0.038
"10521",464,"199105.247.1300.3","NMFS",1991,10,8,281,30,42.466667,-67.466667,1,0,1,1,0,"DE",0.038
"10522",515,"199105.248.1290.2","NMFS",1991,10,8,281,30,42.633333,-68,0,0,0,0,0,"DE",0.038
"10523",515,"199105.249.1290.6","NMFS",1991,10,8,281,30,42.433333,-67.883333,0,0,0,0,0,"DE",0.038
"10524",515,"199105.250.1290.7","NMFS",1991,10,8,281,30,42.366667,-67.816667,0,0,0,0,0,"DE",0.038
"10525",522,"199105.251.1220.3","NMFS",1991,10,9,282,30,42.15,-67.683333,0,0,0,0,0,"DE",0.038
"10526",561,"199105.252.1210.4","NMFS",1991,10,9,282,30,42.05,-67.583333,0,0,0,0,0,"DE",0.038
"10527",561,"199105.253.1200.3","NMFS",1991,10,9,282,30,41.983333,-67.566667,4,1,3,1,3,"DE",0.038
"10528",561,"199105.254.1200.1","NMFS",1991,10,9,282,30,41.9,-67.433333,2,2,0,2,0,"DE",0.038
"10529",522,"199105.255.1190.2","NMFS",1991,10,9,282,30,41.416667,-67.666667,0,0,0,0,0,"DE",0.038
"10530",522,"199105.256.1190.8","NMFS",1991,10,9,282,30,41.416667,-67.766667,0,0,0,0,0,"DE",0.038
"10531",522,"199105.257.1190.4","NMFS",1991,10,9,282,30,41.433333,-67.983333,4,2,2,4,0,"DE",0.038
"10532",522,"199105.259.1200.2","NMFS",1991,10,9,282,29,41.7,-68.016667,5,1,4,5,0,"DE",0.038
"10533",522,"199105.260.1200.4","NMFS",1991,10,9,282,30,41.7,-68.3,1,1,0,1,0,"DE",0.038
"10534",522,"199105.261.1210.1","NMFS",1991,10,9,282,30,41.766667,-68.233333,1,0,1,1,0,"DE",0.038
"10535",522,"199105.262.1220.1","NMFS",1991,10,10,283,30,41.933333,-68.133333,0,0,0,0,0,"DE",0.038
"10536",515,"199105.263.1290.3","NMFS",1991,10,10,283,30,42.35,-68.3,0,0,0,0,0,"DE",0.038
"10537",515,"199105.264.1280.5","NMFS",1991,10,10,283,30,42.366667,-68.75,0,0,0,0,0,"DE",0.038
"10538",522,"199105.265.1240.5","NMFS",1991,10,10,283,30,42.083333,-68.683333,0,0,0,0,0,"DE",0.038
"10539",522,"199105.266.1240.4","NMFS",1991,10,10,283,30,42,-68.833333,0,0,0,0,0,"DE",0.038
"10540",521,"199105.267.1280.3","NMFS",1991,10,10,283,30,41.966667,-69.483333,0,0,0,0,0,"DE",0.038
"10541",521,"199105.268.1240.3","NMFS",1991,10,10,283,30,41.566667,-69.183333,0,0,0,0,0,"DE",0.038
"10542",521,"199105.269.1240.6","NMFS",1991,10,10,283,30,41.433333,-69.233333,0,0,0,0,0,"DE",0.038
"10543",521,"199105.270.1250.1","NMFS",1991,10,10,283,30,41.483333,-69.433333,2,0,2,2,0,"DE",0.038
"10544",521,"199105.271.3550.2","NMFS",1991,10,11,284,30,41.533333,-69.783333,4,4,0,4,0,"DE",0.038
"10545",514,"199105.272.3580.1","NMFS",1991,10,16,289,30,41.766667,-70.416667,4,2,2,2,2,"DE",0.038
"10546",514,"199105.273.3590.1","NMFS",1991,10,16,289,30,41.866667,-70.45,60,27,33,41,19,"DE",0.038
"10547",514,"199105.274.3600.2","NMFS",1991,10,16,289,30,41.933333,-70.3,21,4,17,17,4,"DE",0.038
"10548",514,"199105.275.3600.1","NMFS",1991,10,16,289,30,41.983333,-70.166667,5,2,3,5,0,"DE",0.038
"10549",514,"199105.276.3610.1","NMFS",1991,10,16,289,30,42.083333,-70.4,50,18,32,50,0,"DE",0.038
"10550",521,"199105.277.1270.1","NMFS",1991,10,16,289,30,42.15,-69.983333,1,0,1,1,0,"DE",0.038
"10551",521,"199105.278.1270.4","NMFS",1991,10,16,289,30,42.1,-69.933333,0,0,0,0,0,"DE",0.038
"10552",514,"199105.279.3610.2","NMFS",1991,10,16,289,30,42.083333,-70,0,0,0,0,0,"DE",0.038
"10553",514,"199105.280.3560.1","NMFS",1991,10,16,289,30,42.05,-70.05,3,2,1,3,0,"DE",0.038
"10554",521,"199105.281.1250.2","NMFS",1991,10,16,289,20.7,41.9,-69.85,0,0,0,0,0,"DE",0.038
"10555",521,"199105.282.1270.3","NMFS",1991,10,17,290,30,42.1,-69.766667,0,0,0,0,0,"DE",0.038
"10556",521,"199105.283.1280.6","NMFS",1991,10,17,290,30,42.166667,-69.616667,0,0,0,0,0,"DE",0.038
"10557",521,"199105.284.1280.7","NMFS",1991,10,17,290,30,42.183333,-69.483333,0,0,0,0,0,"DE",0.038
"10558",514,"199105.285.1280.4","NMFS",1991,10,17,290,30,42.366667,-69.75,2,1,1,2,0,"DE",0.038
"10559",515,"199105.286.1280.1","NMFS",1991,10,17,290,30,42.583333,-69.183333,0,0,0,0,0,"DE",0.038
"10560",515,"199105.287.1370.5","NMFS",1991,10,17,290,30,43.033333,-69.016667,0,0,0,0,0,"DE",0.038
"10561",515,"199105.288.1370.2","NMFS",1991,10,17,290,30,43.233333,-68.866667,0,0,0,0,0,"DE",0.038
"10562",515,"199105.289.1370.4","NMFS",1991,10,17,290,30,43.283333,-68.983333,0,0,0,0,0,"DE",0.038
"10563",512,"199105.290.1380.3","NMFS",1991,10,17,290,30,43.35,-68.883333,0,0,0,0,0,"DE",0.038
"10564",512,"199105.291.1380.2","NMFS",1991,10,18,291,30,43.35,-68.6,0,0,0,0,0,"DE",0.038
"10565",515,"199105.292.1360.5","NMFS",1991,10,18,291,30,43.183333,-68.333333,0,0,0,0,0,"DE",0.038
"10566",515,"199105.293.1370.3","NMFS",1991,10,18,291,30,43.033333,-68.666667,0,0,0,0,0,"DE",0.038
"10567",515,"199105.294.1370.1","NMFS",1991,10,18,291,30,43.066667,-68.55,0,0,0,0,0,"DE",0.038
"10568",515,"199105.295.1360.3","NMFS",1991,10,18,291,30,42.9,-68.316667,0,0,0,0,0,"DE",0.038
"10569",464,"199105.296.1360.7","NMFS",1991,10,18,291,30,42.983333,-67.65,0,0,0,0,0,"DE",0.038
"10570",465,"199105.297.1360.1","NMFS",1991,10,18,291,30,43.35,-67.433333,0,0,0,0,0,"DE",0.038
"10571",465,"199105.298.1360.2","NMFS",1991,10,18,291,30,43.383333,-67.3,0,0,0,0,0,"DE",0.038
"10572",465,"199105.299.1360.6","NMFS",1991,10,18,291,30,43.183333,-67.2,0,0,0,0,0,"DE",0.038
"10573",465,"199105.300.1340.1","NMFS",1991,10,19,292,30,43.05,-66.783333,1,0,1,1,0,"DE",0.038
"10574",465,"199105.301.1330.3","NMFS",1991,10,19,292,20,43.133333,-66.433333,0,0,0,0,0,"DE",0.038
"10575",465,"199105.302.1330.4","NMFS",1991,10,19,292,25,43.3,-66.333333,0,0,0,0,0,"DE",0.038
"10576",465,"199105.303.1330.1","NMFS",1991,10,19,292,30,43.3,-66.583333,0,0,0,0,0,"DE",0.038
"10577",465,"199105.304.1340.3","NMFS",1991,10,19,292,30,43.366667,-66.683333,0,0,0,0,0,"DE",0.038
"10578",465,"199105.305.1330.2","NMFS",1991,10,19,292,30,43.55,-66.45,4,2,2,4,0,"DE",0.038
"10579",465,"199105.306.1340.4","NMFS",1991,10,19,292,30,43.666667,-66.633333,0,0,0,0,0,"DE",0.038
"10580",465,"199105.307.1340.2","NMFS",1991,10,19,292,30,43.683333,-66.733333,0,0,0,0,0,"DE",0.038
"10581",465,"199105.308.1340.6","NMFS",1991,10,20,293,30,43.65,-67.016667,0,0,0,0,0,"DE",0.038
"10582",465,"199105.309.1340.5","NMFS",1991,10,20,293,30,43.583333,-67.083333,0,0,0,0,0,"DE",0.038
"10583",465,"199105.310.1360.4","NMFS",1991,10,20,293,30,43.783333,-67.45,0,0,0,0,0,"DE",0.038
"10584",511,"199105.311.1360.8","NMFS",1991,10,20,293,30,43.9,-67.483333,0,0,0,0,0,"DE",0.038
"10585",511,"199105.312.1351.1","NMFS",1991,10,20,293,30,44.216667,-66.9,0,0,0,0,0,"DE",0.038
"10586",511,"199105.313.1351.2","NMFS",1991,10,20,293,30,44.316667,-67.133333,0,0,0,0,0,"DE",0.038
"10587",511,"199105.318.1390.1","NMFS",1991,10,21,294,30,44.416667,-67.5,6,6,0,6,0,"DE",0.038
"10588",512,"199105.325.1390.5","NMFS",1991,10,21,294,28.5,43.916667,-68.516667,2,1,1,2,0,"DE",0.038
"10589",512,"199105.326.1390.2","NMFS",1991,10,21,294,30,43.95,-68.333333,1,1,0,1,0,"DE",0.038
"10590",512,"199105.327.1380.5","NMFS",1991,10,22,295,30,43.716667,-68.333333,0,0,0,0,0,"DE",0.038
"10591",512,"199105.328.1380.4","NMFS",1991,10,22,295,30,43.716667,-68.666667,0,0,0,0,0,"DE",0.038
"10592",512,"199105.329.1390.4","NMFS",1991,10,22,295,30,43.816667,-68.633333,0,0,0,0,0,"DE",0.038
"10593",512,"199105.330.1390.3","NMFS",1991,10,22,295,30,43.75,-69.083333,9,5,4,9,0,"DE",0.038
"10594",512,"199105.333.1400.3","NMFS",1991,10,22,295,30,43.733333,-69.2,4,3,1,4,0,"DE",0.038
"10595",513,"199105.338.1380.1","NMFS",1991,10,23,296,30,43.416667,-69.95,1,0,1,1,0,"DE",0.038
"10596",513,"199105.342.1400.2","NMFS",1991,10,23,296,30,43.083333,-70.366667,7,5,2,7,0,"DE",0.038
"10597",513,"199105.343.1270.2","NMFS",1991,10,23,296,30,43.25,-70.05,0,0,0,0,0,"DE",0.038
"10598",513,"199105.344.1260.3","NMFS",1991,10,23,296,30,43.15,-70.033333,0,0,0,0,0,"DE",0.038
"10599",513,"199105.345.1280.2","NMFS",1991,10,24,297,30,42.9,-69.766667,0,0,0,0,0,"DE",0.038
"10600",514,"199105.346.1260.1","NMFS",1991,10,24,297,30,42.683333,-70.283333,1,0,1,1,0,"DE",0.038
"10601",514,"199105.347.1260.5","NMFS",1991,10,24,297,30,42.816667,-70.35,0,0,0,0,0,"DE",0.038
"10602",514,"199105.348.1260.2","NMFS",1991,10,24,297,30,42.75,-70.416667,2,0,2,2,0,"DE",0.038
"10603",514,"199105.349.1400.1","NMFS",1991,10,24,297,30,42.8,-70.45,0,0,0,0,0,"DE",0.038
"10604",514,"199105.350.3660.2","NMFS",1991,10,24,297,30,42.8,-70.666667,10,7,3,8,2,"DE",0.038
"10605",514,"199105.351.3640.1","NMFS",1991,10,24,297,30,42.75,-70.733333,29,11,18,25,4,"DE",0.038
"10606",514,"199105.352.3650.1","NMFS",1991,10,24,297,30,42.783333,-70.716667,24,14,10,23,1,"DE",0.038
"10607",514,"199105.354.1260.4","NMFS",1991,10,24,297,30,42.416667,-70.616667,117,53,64,117,0,"DE",0.038
"10608",526,"199202.161.1090.5","NMFS",1992,3,24,84,30,40.75,-69.933333,0,0,0,0,0,"AL",0.038
"10609",526,"199202.178.1110.2","NMFS",1992,3,26,86,30,40,-69.766667,0,0,0,0,0,"AL",0.038
"10610",526,"199202.179.1100.4","NMFS",1992,3,26,86,30,40.216667,-69.733333,0,0,0,0,0,"AL",0.038
"10611",526,"199202.180.1100.1","NMFS",1992,3,26,86,30,40.383333,-69.283333,3,1,2,3,0,"AL",0.038
"10612",525,"199202.181.1140.3","NMFS",1992,3,26,86,30,40.166667,-68.733333,3,1,2,3,0,"AL",0.038
"10613",525,"199202.182.1150.1","NMFS",1992,3,26,86,30,40.166667,-68.433333,2,0,2,1,1,"AL",0.038
"10614",525,"199202.183.1140.1","NMFS",1992,3,26,86,30,40.233333,-68.383333,0,0,0,0,0,"AL",0.038
"10615",514,"199202.185.3590.1","NMFS",1992,3,27,87,30,41.866667,-70.466667,19,8,11,10,9,"AL",0.038
"10616",514,"199202.186.3580.1","NMFS",1992,3,29,89,30,41.833333,-70.2,1,1,0,0,1,"AL",0.038
"10617",514,"199202.187.3600.1","NMFS",1992,3,29,89,30,41.933333,-70.25,1,1,0,1,0,"AL",0.038
"10618",514,"199202.188.3610.2","NMFS",1992,3,29,89,30,42.05,-70.5,35,21,14,35,0,"AL",0.038
"10619",514,"199202.189.3600.2","NMFS",1992,3,29,89,29,42.1,-70.533333,3,1,2,3,0,"AL",0.038
"10620",514,"199202.190.1260.3","NMFS",1992,3,29,89,30,42.183333,-70.283333,0,0,0,0,0,"AL",0.038
"10621",514,"199202.191.1260.5","NMFS",1992,3,29,89,30,42.183333,-70.083333,0,0,0,0,0,"AL",0.038
"10622",521,"199202.192.1270.2","NMFS",1992,3,29,89,30,42.233333,-69.95,0,0,0,0,0,"AL",0.038
"10623",521,"199202.194.3560.1","NMFS",1992,3,29,89,30,41.75,-69.883333,0,0,0,0,0,"AL",0.038
"10624",521,"199202.195.1240.6","NMFS",1992,3,30,90,30,41.733333,-69.583333,1,1,0,1,0,"AL",0.038
"10625",521,"199202.196.1230.4","NMFS",1992,3,30,90,30,41.65,-69.533333,8,7,1,8,0,"AL",0.038
"10626",521,"199202.197.1230.1","NMFS",1992,3,30,90,30,41.433333,-69.333333,0,0,0,0,0,"AL",0.038
"10627",521,"199202.198.1250.4","NMFS",1992,3,30,90,30,41.45,-69.466667,3,0,3,3,0,"AL",0.038
"10628",521,"199202.199.3550.1","NMFS",1992,3,30,90,30,41.4,-69.566667,5,3,2,2,3,"AL",0.038
"10629",521,"199202.200.1250.2","NMFS",1992,3,30,90,30,41.25,-69.383333,0,0,0,0,0,"AL",0.038
"10630",521,"199202.201.1250.1","NMFS",1992,3,30,90,30,41.166667,-69.266667,0,0,0,0,0,"AL",0.038
"10631",521,"199202.202.1250.3","NMFS",1992,3,30,90,30,41.1,-69.316667,0,0,0,0,0,"AL",0.038
"10632",526,"199202.203.1100.6","NMFS",1992,3,30,90,30,40.95,-68.983333,0,0,0,0,0,"AL",0.038
"10633",525,"199202.206.1130.10","NMFS",1992,3,30,90,22,40.933333,-68.816667,0,0,0,0,0,"AL",0.038
"10634",522,"199202.208.1230.6","NMFS",1992,3,31,91,30,41.15,-68.7,0,0,0,0,0,"AL",0.038
"10635",522,"199202.209.1200.5","NMFS",1992,3,31,91,30,41.266667,-68.383333,1,0,1,1,0,"AL",0.038
"10636",525,"199202.210.1190.4","NMFS",1992,3,31,91,30,41.083333,-68.25,0,0,0,0,0,"AL",0.038
"10637",525,"199202.211.1190.3","NMFS",1992,3,31,91,30,41.05,-68.25,0,0,0,0,0,"AL",0.038
"10638",525,"199202.212.1190.8","NMFS",1992,3,31,91,30,40.983333,-68.35,0,0,0,0,0,"AL",0.038
"10639",525,"199202.213.1130.7","NMFS",1992,3,31,91,30,40.65,-68.616667,0,0,0,0,0,"AL",0.038
"10640",525,"199202.214.1130.3","NMFS",1992,3,31,91,30,40.55,-68.75,1,0,1,1,0,"AL",0.038
"10641",525,"199202.215.1140.4","NMFS",1992,3,31,91,30,40.366667,-68.25,0,0,0,0,0,"AL",0.038
"10642",525,"199202.216.1130.9","NMFS",1992,3,31,91,30,40.7,-67.933333,0,0,0,0,0,"AL",0.038
"10643",525,"199202.217.1130.1","NMFS",1992,4,1,92,30,40.883333,-67.883333,1,1,0,1,0,"AL",0.038
"10644",525,"199202.218.1130.5","NMFS",1992,4,1,92,30,40.9,-67.816667,0,0,0,0,0,"AL",0.038
"10645",525,"199202.219.1190.1","NMFS",1992,4,1,92,30,41.083333,-67.65,0,0,0,0,0,"AL",0.038
"10646",562,"199202.220.1190.6","NMFS",1992,4,1,92,30,41.283333,-67.483333,0,0,0,0,0,"AL",0.038
"10647",525,"199202.221.1130.4","NMFS",1992,4,1,92,30,41.116667,-67.283333,1,1,0,1,0,"AL",0.038
"10648",562,"199202.222.1160.5","NMFS",1992,4,1,92,30,41.15,-66.983333,1,0,1,1,0,"AL",0.038
"10649",562,"199202.223.1130.8","NMFS",1992,4,1,92,30,41.016667,-67.116667,0,0,0,0,0,"AL",0.038
"10650",562,"199202.224.1160.3","NMFS",1992,4,1,92,30,40.966667,-66.983333,0,0,0,0,0,"AL",0.038
"10651",562,"199202.225.1130.6","NMFS",1992,4,1,92,30,40.916667,-66.966667,0,0,0,0,0,"AL",0.038
"10652",562,"199202.226.1160.4","NMFS",1992,4,1,92,30,40.9,-66.866667,0,0,0,0,0,"AL",0.038
"10653",562,"199202.227.1160.2","NMFS",1992,4,2,93,30,41.016667,-66.716667,0,0,0,0,0,"AL",0.038
"10654",552,"199202.228.1170.3","NMFS",1992,4,2,93,30,41.333333,-66.283333,1,0,1,1,0,"AL",0.038
"10655",552,"199202.229.1170.2","NMFS",1992,4,2,93,30,41.483333,-65.966667,2,1,1,2,0,"AL",0.038
"10656",552,"199202.230.1170.1","NMFS",1992,4,2,93,30,41.816667,-65.8,0,0,0,0,0,"AL",0.038
"10657",551,"199202.231.1180.1","NMFS",1992,4,2,93,30,41.966667,-65.783333,0,0,0,0,0,"AL",0.038
"10658",551,"199202.232.1160.7","NMFS",1992,4,2,93,30,41.933333,-65.966667,0,0,0,0,0,"AL",0.038
"10659",552,"199202.233.1160.1","NMFS",1992,4,2,93,30,41.533333,-66.616667,0,0,0,0,0,"AL",0.038
"10660",562,"199202.234.1160.10","NMFS",1992,4,2,93,30,41.55,-66.666667,0,0,0,0,0,"AL",0.038
"10661",562,"199202.235.1190.2","NMFS",1992,4,3,94,30,41.483333,-67.183333,0,0,0,0,0,"AL",0.038
"10662",521,"199202.236.1240.5","NMFS",1992,4,7,98,30,41.85,-69.433333,1,1,0,1,0,"AL",0.038
"10663",521,"199202.237.1240.4","NMFS",1992,4,7,98,30,41.783333,-69.166667,1,1,0,1,0,"AL",0.038
"10664",522,"199202.238.1230.3","NMFS",1992,4,7,98,30,41.55,-68.45,0,0,0,0,0,"AL",0.038
"10665",522,"199202.239.1240.2","NMFS",1992,4,7,98,30,41.716667,-68.55,0,0,0,0,0,"AL",0.038
"10666",522,"199202.240.1220.4","NMFS",1992,4,7,98,30,41.766667,-68.35,0,0,0,0,0,"AL",0.038
"10667",522,"199202.241.1240.1","NMFS",1992,4,7,98,30,42.1,-68.383333,0,0,0,0,0,"AL",0.038
"10668",515,"199202.242.1240.3","NMFS",1992,4,7,98,30,42.366667,-68.566667,1,1,0,1,0,"AL",0.038
"10669",515,"199202.243.1290.2","NMFS",1992,4,7,98,30,42.466667,-68.45,0,0,0,0,0,"AL",0.038
"10670",515,"199202.244.1290.5","NMFS",1992,4,8,99,30,42.383333,-68.183333,0,0,0,0,0,"AL",0.038
"10671",522,"199202.245.1290.6","NMFS",1992,4,8,99,30,42.333333,-68.116667,0,0,0,0,0,"AL",0.038
"10672",522,"199202.246.1220.1","NMFS",1992,4,8,99,30,41.95,-67.983333,0,0,0,0,0,"AL",0.038
"10673",522,"199202.247.1210.1","NMFS",1992,4,8,99,30,41.866667,-68,0,0,0,0,0,"AL",0.038
"10674",522,"199202.248.1200.2","NMFS",1992,4,8,99,30,41.85,-67.866667,0,0,0,0,0,"AL",0.038
"10675",522,"199202.249.1200.3","NMFS",1992,4,8,99,30,41.783333,-67.766667,0,0,0,0,0,"AL",0.038
"10676",561,"199202.250.1200.4","NMFS",1992,4,8,99,30,41.9,-67.633333,0,0,0,0,0,"AL",0.038
"10677",561,"199202.251.1200.1","NMFS",1992,4,8,99,30,42,-67.633333,0,0,0,0,0,"AL",0.038
"10678",561,"199202.252.1200.6","NMFS",1992,4,8,99,30,42.05,-67.5,0,0,0,0,0,"AL",0.038
"10679",561,"199202.253.1290.1","NMFS",1992,4,8,99,30,42.283333,-67.5,1,1,0,1,0,"AL",0.038
"10680",561,"199202.254.1300.3","NMFS",1992,4,8,99,30,42.316667,-67.466667,4,3,1,4,0,"AL",0.038
"10681",551,"199202.255.1220.3","NMFS",1992,4,8,99,30,42.2,-67.05,2,1,1,2,0,"AL",0.038
"10682",551,"199202.256.1290.7","NMFS",1992,4,9,100,30,42.233333,-66.966667,0,0,0,0,0,"AL",0.038
"10683",551,"199202.257.1210.3","NMFS",1992,4,9,100,30,42.166667,-67.033333,0,0,0,0,0,"AL",0.038
"10684",551,"199202.258.1210.4","NMFS",1992,4,9,100,30,42.133333,-66.816667,0,0,0,0,0,"AL",0.038
"10685",551,"199202.259.1160.6","NMFS",1992,4,9,100,30,42.05,-66.966667,0,0,0,0,0,"AL",0.038
"10686",561,"199202.260.1190.5","NMFS",1992,4,9,100,30,41.95,-67.066667,0,0,0,0,0,"AL",0.038
"10687",562,"199202.261.1190.7","NMFS",1992,4,9,100,30,41.816667,-67.2,0,0,0,0,0,"AL",0.038
"10688",562,"199202.262.1190.9","NMFS",1992,4,9,100,30,41.75,-67.05,0,0,0,0,0,"AL",0.038
"10689",562,"199202.263.1160.9","NMFS",1992,4,9,100,30,41.7,-66.8,0,0,0,0,0,"AL",0.038
"10690",552,"199202.264.1160.8","NMFS",1992,4,9,100,30,41.8,-66.616667,0,0,0,0,0,"AL",0.038
"10691",551,"199202.266.1210.2","NMFS",1992,4,9,100,30,42.083333,-66.633333,0,0,0,0,0,"AL",0.038
"10692",551,"199202.267.1220.2","NMFS",1992,4,9,100,30,42.166667,-66.5,2,1,1,2,0,"AL",0.038
"10693",551,"199202.268.1290.4","NMFS",1992,4,10,101,30,42.233333,-66.283333,1,1,0,1,0,"AL",0.038
"10694",551,"199202.269.1290.3","NMFS",1992,4,10,101,30,42.266667,-66.616667,0,0,0,0,0,"AL",0.038
"10695",464,"199202.270.1300.2","NMFS",1992,4,10,101,30,42.5,-67.15,0,0,0,0,0,"AL",0.038
"10696",464,"199202.271.1300.1","NMFS",1992,4,10,101,30,42.566667,-67.283333,0,0,0,0,0,"AL",0.038
"10697",515,"199202.272.1290.8","NMFS",1992,4,10,101,30,42.733333,-67.716667,1,1,0,1,0,"AL",0.038
"10698",464,"199202.273.1360.3","NMFS",1992,4,10,101,30,42.866667,-67.016667,1,1,0,1,0,"AL",0.038
"10699",465,"199202.274.1360.1","NMFS",1992,4,10,101,30,43.05,-67.283333,0,0,0,0,0,"AL",0.038
"10700",465,"199202.275.1360.8","NMFS",1992,4,10,101,30,43.316667,-67.216667,0,0,0,0,0,"AL",0.038
"10701",465,"199202.276.1360.7","NMFS",1992,4,11,102,30,43.416667,-67,0,0,0,0,0,"AL",0.038
"10702",465,"199202.277.1340.1","NMFS",1992,4,11,102,30,43.766667,-67.033333,1,1,0,1,0,"AL",0.038
"10703",511,"199202.278.1340.2","NMFS",1992,4,11,102,30,43.916667,-67.35,0,0,0,0,0,"AL",0.038
"10704",511,"199202.279.1340.3","NMFS",1992,4,11,102,30,44.083333,-67.233333,1,1,0,1,0,"AL",0.038
"10705",511,"199202.280.1390.3","NMFS",1992,4,11,102,30,44.35,-67.666667,0,0,0,0,0,"AL",0.038
"10706",512,"199202.281.1390.1","NMFS",1992,4,11,102,30,44.133333,-67.916667,1,1,0,1,0,"AL",0.038
"10707",512,"199202.282.1360.6","NMFS",1992,4,11,102,30,43.766667,-67.766667,1,1,0,1,0,"AL",0.038
"10708",512,"199202.283.1360.2","NMFS",1992,4,11,102,30,43.816667,-67.933333,0,0,0,0,0,"AL",0.038
"10709",512,"199202.284.1380.2","NMFS",1992,4,11,102,30,43.8,-68.133333,0,0,0,0,0,"AL",0.038
"10710",512,"199202.285.1390.4","NMFS",1992,4,12,103,30,43.85,-68.6,0,0,0,0,0,"AL",0.038
"10711",512,"199202.287.1390.2","NMFS",1992,4,12,103,15,43.816667,-68.75,1,0,1,1,0,"AL",0.038
"10712",512,"199202.289.1400.2","NMFS",1992,4,12,103,23,43.716667,-69.166667,1,0,1,1,0,"AL",0.038
"10713",512,"199202.290.1380.5","NMFS",1992,4,12,103,30,43.433333,-68.616667,0,0,0,0,0,"AL",0.038
"10714",512,"199202.291.1380.1","NMFS",1992,4,12,103,30,43.466667,-68.25,0,0,0,0,0,"AL",0.038
"10715",512,"199202.292.1360.4","NMFS",1992,4,12,103,30,43.35,-67.95,0,0,0,0,0,"AL",0.038
"10716",515,"199202.293.1360.5","NMFS",1992,4,13,104,30,43.033333,-68.383333,0,0,0,0,0,"AL",0.038
"10717",515,"199202.294.1370.2","NMFS",1992,4,13,104,30,42.783333,-68.566667,0,0,0,0,0,"AL",0.038
"10718",515,"199202.295.1370.4","NMFS",1992,4,13,104,30,42.683333,-68.616667,0,0,0,0,0,"AL",0.038
"10719",515,"199202.296.1280.6","NMFS",1992,4,13,104,30,42.516667,-68.983333,0,0,0,0,0,"AL",0.038
"10720",521,"199202.297.1280.2","NMFS",1992,4,13,104,30,42.233333,-69.216667,0,0,0,0,0,"AL",0.038
"10721",515,"199202.298.1280.1","NMFS",1992,4,13,104,30,42.433333,-69.283333,0,0,0,0,0,"AL",0.038
"10722",515,"199202.299.1280.3","NMFS",1992,4,13,104,30,42.383333,-69.55,0,0,0,0,0,"AL",0.038
"10723",515,"199202.300.1280.5","NMFS",1992,4,13,104,30,42.5,-69.616667,2,2,0,2,0,"AL",0.038
"10724",514,"199202.301.1280.4","NMFS",1992,4,14,105,30,42.466667,-69.816667,0,0,0,0,0,"AL",0.038
"10725",514,"199202.303.3660.3","NMFS",1992,4,14,105,30,42.233333,-70.516667,18,10,8,18,0,"AL",0.038
"10726",514,"199202.304.1260.2","NMFS",1992,4,14,105,22,42.466667,-70.55,6,4,2,6,0,"AL",0.038
"10727",514,"199202.305.1260.4","NMFS",1992,4,14,105,30,42.533333,-70.35,8,1,7,8,0,"AL",0.038
"10728",514,"199202.307.3660.1","NMFS",1992,4,14,105,30,42.716667,-70.6,4,4,0,4,0,"AL",0.038
"10729",514,"199202.308.3630.1","NMFS",1992,4,14,105,30,42.7,-70.716667,0,0,0,0,0,"AL",0.038
"10730",514,"199202.309.1260.1","NMFS",1992,4,14,105,30,42.733333,-70.5,14,8,6,14,0,"AL",0.038
"10731",514,"199202.310.1270.4","NMFS",1992,4,14,105,30,42.7,-70.133333,0,0,0,0,0,"AL",0.038
"10732",513,"199202.311.1270.3","NMFS",1992,4,15,106,30,42.866667,-70.116667,0,0,0,0,0,"AL",0.038
"10733",513,"199202.312.1400.3","NMFS",1992,4,15,106,30,42.983333,-70.4,4,1,3,4,0,"AL",0.038
"10734",513,"199202.313.1270.1","NMFS",1992,4,15,106,30,43.066667,-70,0,0,0,0,0,"AL",0.038
"10735",513,"199202.314.1280.7","NMFS",1992,4,15,106,30,42.966667,-69.8,0,0,0,0,0,"AL",0.038
"10736",513,"199202.315.1370.3","NMFS",1992,4,15,106,30,42.916667,-69.616667,1,1,0,1,0,"AL",0.038
"10737",513,"199202.316.1370.5","NMFS",1992,4,15,106,30,42.95,-69.566667,0,0,0,0,0,"AL",0.038
"10738",513,"199202.317.1370.1","NMFS",1992,4,15,106,30,43.216667,-69.05,1,1,0,1,0,"AL",0.038
"10739",513,"199202.318.1380.3","NMFS",1992,4,15,106,30,43.3,-69.083333,0,0,0,0,0,"AL",0.038
"10740",513,"199202.319.1380.4","NMFS",1992,4,15,106,30,43.4,-69.3,0,0,0,0,0,"AL",0.038
"10741",513,"199202.321.1400.1","NMFS",1992,4,16,107,30,43.6,-69.85,2,2,0,2,0,"AL",0.038
"10742",526,"199206.181.1120.1","NMFS",1992,10,6,280,30,39.916667,-69.816667,2,1,1,2,0,"AL",0.038
"10743",526,"199206.182.1110.2","NMFS",1992,10,6,280,30,40.1,-69.883333,1,1,0,1,0,"AL",0.038
"10744",526,"199206.183.1100.3","NMFS",1992,10,6,280,30,40.3,-69.916667,3,3,0,3,0,"AL",0.038
"10745",526,"199206.185.1090.4","NMFS",1992,10,7,281,30,40.883333,-69.8,1,0,1,1,0,"AL",0.038
"10746",526,"199206.186.3550.2","NMFS",1992,10,7,281,30,40.95,-69.766667,3,0,3,2,1,"AL",0.038
"10747",526,"199206.187.3550.1","NMFS",1992,10,7,281,30,41,-69.6,0,0,0,0,0,"AL",0.038
"10748",526,"199206.188.3550.3","NMFS",1992,10,7,281,30,41.066667,-69.616667,0,0,0,0,0,"AL",0.038
"10749",526,"199206.189.3550.4","NMFS",1992,10,7,281,30,41.116667,-69.6,0,0,0,0,0,"AL",0.038
"10750",526,"199206.190.3550.5","NMFS",1992,10,7,281,30,41.066667,-69.5,3,3,0,2,1,"AL",0.038
"10751",526,"199206.193.1100.5","NMFS",1992,10,7,281,30,40.616667,-69.083333,2,2,0,2,0,"AL",0.038
"10752",526,"199206.196.1100.1","NMFS",1992,10,8,282,30,40.45,-68.9,0,0,0,0,0,"AL",0.038
"10753",526,"199206.197.1100.7","NMFS",1992,10,8,282,30,40.35,-68.866667,4,3,1,3,1,"AL",0.038
"10754",525,"199206.198.1150.1","NMFS",1992,10,8,282,30,40.216667,-68.5,1,1,0,1,0,"AL",0.038
"10755",525,"199206.199.1140.2","NMFS",1992,10,8,282,30,40.433333,-68.033333,1,0,1,1,0,"AL",0.038
"10756",525,"199206.200.1140.1","NMFS",1992,10,8,282,30,40.483333,-67.833333,0,0,0,0,0,"AL",0.038
"10757",525,"199206.201.1130.9","NMFS",1992,10,8,282,30,40.683333,-68.083333,0,0,0,0,0,"AL",0.038
"10758",525,"199206.202.1130.1","NMFS",1992,10,8,282,30,40.7,-68.25,0,0,0,0,0,"AL",0.038
"10759",525,"199206.203.1130.5","NMFS",1992,10,8,282,30,40.616667,-68.633333,1,1,0,1,0,"AL",0.038
"10760",525,"199206.204.1130.8","NMFS",1992,10,8,282,30,40.6,-68.666667,0,0,0,0,0,"AL",0.038
"10761",525,"199206.205.1130.7","NMFS",1992,10,8,282,30,40.783333,-68.833333,2,1,1,2,0,"AL",0.038
"10762",525,"199206.206.1130.6","NMFS",1992,10,8,282,30,40.933333,-68.816667,2,1,1,2,0,"AL",0.038
"10763",522,"199206.207.1230.2","NMFS",1992,10,9,283,30,41.05,-68.833333,2,0,2,2,0,"AL",0.038
"10764",525,"199206.208.1190.6","NMFS",1992,10,9,283,30,40.95,-68.35,2,0,2,2,0,"AL",0.038
"10765",522,"199206.209.1190.1","NMFS",1992,10,9,283,30,41.183333,-68.283333,0,0,0,0,0,"AL",0.038
"10766",522,"199206.210.1190.8","NMFS",1992,10,9,283,30,41.283333,-68.166667,3,0,3,2,1,"AL",0.038
"10767",525,"199206.211.1190.7","NMFS",1992,10,9,283,30,41.216667,-68.083333,2,2,0,2,0,"AL",0.038
"10768",522,"199206.212.1190.2","NMFS",1992,10,9,283,21,41.35,-68,4,3,1,4,0,"AL",0.038
"10769",562,"199206.213.1190.9","NMFS",1992,10,9,283,30,41.233333,-67.633333,0,0,0,0,0,"AL",0.038
"10770",525,"199206.214.1190.5","NMFS",1992,10,9,283,30,41.016667,-67.75,3,3,0,3,0,"AL",0.038
"10771",525,"199206.215.1130.4","NMFS",1992,10,9,283,30,40.866667,-67.55,0,0,0,0,0,"AL",0.038
"10772",525,"199206.216.1130.3","NMFS",1992,10,9,283,30,40.916667,-67.45,2,2,0,2,0,"AL",0.038
"10773",525,"199206.217.1130.2","NMFS",1992,10,9,283,30,40.783333,-67.383333,0,0,0,0,0,"AL",0.038
"10774",525,"199206.218.1140.3","NMFS",1992,10,10,284,30,40.516667,-67.316667,0,0,0,0,0,"AL",0.038
"10775",562,"199206.219.1160.5","NMFS",1992,10,10,284,30,40.833333,-66.783333,1,1,0,1,0,"AL",0.038
"10776",562,"199206.220.1170.2","NMFS",1992,10,10,284,30,41.15,-66.366667,0,0,0,0,0,"AL",0.038
"10777",552,"199206.221.1170.3","NMFS",1992,10,10,284,30,41.3,-66.283333,0,0,0,0,0,"AL",0.038
"10778",562,"199206.222.1160.8","NMFS",1992,10,10,284,30,41.416667,-66.7,0,0,0,0,0,"AL",0.038
"10779",562,"199206.223.1160.4","NMFS",1992,10,10,284,30,41.383333,-66.916667,0,0,0,0,0,"AL",0.038
"10780",562,"199206.224.1160.2","NMFS",1992,10,10,284,30,41.466667,-67.033333,5,5,0,5,0,"AL",0.038
"10781",562,"199206.225.1190.3","NMFS",1992,10,10,284,30,41.55,-67.316667,1,0,1,1,0,"AL",0.038
"10782",562,"199206.226.1190.4","NMFS",1992,10,10,284,30,41.716667,-67.216667,17,12,5,17,0,"AL",0.038
"10783",562,"199206.228.1160.3","NMFS",1992,10,11,285,30,41.683333,-66.833333,1,1,0,1,0,"AL",0.038
"10784",552,"199206.229.1160.1","NMFS",1992,10,11,285,30,41.833333,-66.783333,0,0,0,0,0,"AL",0.038
"10785",551,"199206.230.1160.10","NMFS",1992,10,11,285,30,42,-66.766667,1,0,1,1,0,"AL",0.038
"10786",551,"199206.231.1160.7","NMFS",1992,10,11,285,30,42.016667,-66.533333,0,0,0,0,0,"AL",0.038
"10787",552,"199206.233.1160.9","NMFS",1992,10,11,285,30,41.533333,-66.283333,0,0,0,0,0,"AL",0.038
"10788",552,"199206.234.1180.1","NMFS",1992,10,11,285,30,41.65,-65.833333,0,0,0,0,0,"AL",0.038
"10789",551,"199206.236.1170.1","NMFS",1992,10,12,286,30,42,-65.916667,0,0,0,0,0,"AL",0.038
"10790",551,"199206.237.1160.6","NMFS",1992,10,12,286,30,42.016667,-66.15,0,0,0,0,0,"AL",0.038
"10791",551,"199206.238.1290.3","NMFS",1992,10,12,286,30,42.283333,-66.216667,0,0,0,0,0,"AL",0.038
"10792",464,"199206.239.1290.5","NMFS",1992,10,12,286,30,42.366667,-66.066667,0,0,0,0,0,"AL",0.038
"10793",464,"199206.240.1290.2","NMFS",1992,10,12,286,30,42.416667,-66.266667,0,0,0,0,0,"AL",0.038
"10794",464,"199206.241.1290.7","NMFS",1992,10,12,286,30,42.383333,-66.5,0,0,0,0,0,"AL",0.038
"10795",464,"199206.242.1300.3","NMFS",1992,10,12,286,30,42.366667,-66.65,0,0,0,0,0,"AL",0.038
"10796",551,"199206.244.1290.6","NMFS",1992,10,12,286,30,42.283333,-66.733333,0,0,0,0,0,"AL",0.038
"10797",551,"199206.245.1290.8","NMFS",1992,10,12,286,30,42.25,-66.85,0,0,0,0,0,"AL",0.038
"10798",551,"199206.246.1220.2","NMFS",1992,10,12,286,30,42.183333,-66.9,0,0,0,0,0,"AL",0.038
"10799",551,"199206.247.1210.4","NMFS",1992,10,13,287,30,42.1,-66.983333,0,0,0,0,0,"AL",0.038
"10800",551,"199206.248.1220.3","NMFS",1992,10,13,287,30,42.216667,-67.066667,0,0,0,0,0,"AL",0.038
"10801",551,"199206.249.1300.2","NMFS",1992,10,13,287,30,42.316667,-67.116667,0,0,0,0,0,"AL",0.038
"10802",561,"199206.250.1300.1","NMFS",1992,10,13,287,30,42.333333,-67.316667,0,0,0,0,0,"AL",0.038
"10803",561,"199206.251.1290.1","NMFS",1992,10,13,287,30,42.25,-67.4,0,0,0,0,0,"AL",0.038
"10804",561,"199206.252.1210.3","NMFS",1992,10,13,287,30,42.1,-67.5,0,0,0,0,0,"AL",0.038
"10805",561,"199206.253.1200.2","NMFS",1992,10,13,287,30,42.083333,-67.366667,0,0,0,0,0,"AL",0.038
"10806",561,"199206.254.1200.3","NMFS",1992,10,13,287,30,42,-67.316667,0,0,0,0,0,"AL",0.038
"10807",562,"199206.255.1200.6","NMFS",1992,10,13,287,30,41.783333,-67.5,4,2,2,3,1,"AL",0.038
"10808",522,"199206.256.1200.5","NMFS",1992,10,13,287,30,41.683333,-67.666667,1,1,0,1,0,"AL",0.038
"10809",522,"199206.258.1200.4","NMFS",1992,10,13,287,30,41.9,-67.8,5,3,2,5,0,"AL",0.038
"10810",522,"199206.259.1210.2","NMFS",1992,10,14,288,30,41.966667,-67.866667,0,0,0,0,0,"AL",0.038
"10811",522,"199206.260.1220.4","NMFS",1992,10,14,288,30,41.966667,-68.066667,0,0,0,0,0,"AL",0.038
"10812",522,"199206.261.1290.4","NMFS",1992,10,14,288,30,42.3,-68.4,0,0,0,0,0,"AL",0.038
"10813",522,"199206.262.1240.6","NMFS",1992,10,14,288,30,42.166667,-68.7,0,0,0,0,0,"AL",0.038
"10814",522,"199206.263.1240.2","NMFS",1992,10,14,288,30,42.083333,-68.666667,0,0,0,0,0,"AL",0.038
"10815",522,"199206.264.1240.4","NMFS",1992,10,14,288,30,42.033333,-68.833333,0,0,0,0,0,"AL",0.038
"10816",522,"199206.265.1220.1","NMFS",1992,10,14,288,30,41.933333,-68.216667,0,0,0,0,0,"AL",0.038
"10817",522,"199206.266.1210.1","NMFS",1992,10,14,288,30,41.766667,-68.266667,0,0,0,0,0,"AL",0.038
"10818",522,"199206.267.1230.4","NMFS",1992,10,14,288,30,41.366667,-68.533333,1,0,1,1,0,"AL",0.038
"10819",521,"199206.268.1230.3","NMFS",1992,10,15,289,30,41.233333,-68.866667,1,1,0,1,0,"AL",0.038
"10820",521,"199206.269.1240.3","NMFS",1992,10,15,289,30,41.333333,-69.083333,0,0,0,0,0,"AL",0.038
"10821",521,"199206.271.1250.3","NMFS",1992,10,15,289,30,41.366667,-69.35,1,1,0,1,0,"AL",0.038
"10822",521,"199206.272.1240.5","NMFS",1992,10,15,289,30,41.65,-69.383333,1,1,0,1,0,"AL",0.038
"10823",521,"199206.273.1230.5","NMFS",1992,10,15,289,30,41.616667,-69.483333,0,0,0,0,0,"AL",0.038
"10824",521,"199206.274.1230.1","NMFS",1992,10,15,289,30,41.616667,-69.583333,1,0,1,1,0,"AL",0.038
"10825",521,"199206.275.1250.1","NMFS",1992,10,15,289,30,41.566667,-69.733333,1,0,1,1,0,"AL",0.038
"10826",521,"199206.276.3560.1","NMFS",1992,10,15,289,30,41.733333,-69.883333,21,11,10,20,1,"AL",0.038
"10827",521,"199206.277.1250.2","NMFS",1992,10,15,289,30,41.85,-69.883333,3,2,1,2,1,"AL",0.038
"10828",514,"199206.278.3610.1","NMFS",1992,10,16,290,30,42.133333,-70.133333,0,0,0,0,0,"AL",0.038
"10829",514,"199206.279.3610.2","NMFS",1992,10,16,290,30,42.033333,-70.383333,28,11,17,28,0,"AL",0.038
"10830",514,"199206.280.3600.1","NMFS",1992,10,16,290,30,41.9,-70.333333,31,17,14,29,2,"AL",0.038
"10831",514,"199206.282.3580.1","NMFS",1992,10,20,294,30,41.783333,-70.333333,28,13,15,28,0,"AL",0.038
"10832",514,"199206.283.3590.1","NMFS",1992,10,20,294,30,41.833333,-70.35,81,26,55,74,7,"AL",0.038
"10833",514,"199206.284.3600.2","NMFS",1992,10,20,294,30,41.966667,-70.183333,21,3,18,21,0,"AL",0.038
"10834",514,"199206.286.1260.3","NMFS",1992,10,20,294,30,42.5,-70.233333,1,1,0,1,0,"AL",0.038
"10835",521,"199206.287.1270.1","NMFS",1992,10,20,294,30,42.266667,-69.966667,0,0,0,0,0,"AL",0.038
"10836",521,"199206.288.1280.4","NMFS",1992,10,20,294,30,42.116667,-69.45,0,0,0,0,0,"AL",0.038
"10837",521,"199206.289.1240.1","NMFS",1992,10,20,294,30,42.066667,-69.2,0,0,0,0,0,"AL",0.038
"10838",521,"199206.290.1280.1","NMFS",1992,10,21,295,30,42.233333,-69.333333,2,1,1,2,0,"AL",0.038
"10839",521,"199206.291.1280.2","NMFS",1992,10,21,295,30,42.283333,-69.466667,0,0,0,0,0,"AL",0.038
"10840",521,"199206.292.1280.6","NMFS",1992,10,21,295,30,42.3,-69.3,0,0,0,0,0,"AL",0.038
"10841",515,"199206.293.1280.7","NMFS",1992,10,21,295,30,42.516667,-69.316667,1,1,0,1,0,"AL",0.038
"10842",515,"199206.294.1280.5","NMFS",1992,10,21,295,30,42.7,-69.65,1,1,0,1,0,"AL",0.038
"10843",513,"199206.295.1370.3","NMFS",1992,10,21,295,30,42.883333,-69.483333,0,0,0,0,0,"AL",0.038
"10844",515,"199206.296.1370.1","NMFS",1992,10,21,295,30,42.883333,-69.283333,0,0,0,0,0,"AL",0.038
"10845",515,"199206.297.1370.5","NMFS",1992,10,21,295,30,42.95,-69.233333,0,0,0,0,0,"AL",0.038
"10846",515,"199206.298.1280.3","NMFS",1992,10,21,295,30,42.683333,-68.6,0,0,0,0,0,"AL",0.038
"10847",515,"199206.299.1370.4","NMFS",1992,10,21,295,30,42.816667,-68.483333,0,0,0,0,0,"AL",0.038
"10848",515,"199206.300.1370.2","NMFS",1992,10,22,296,30,43,-68.566667,0,0,0,0,0,"AL",0.038
"10849",512,"199206.301.1380.3","NMFS",1992,10,22,296,30,43.366667,-68.366667,0,0,0,0,0,"AL",0.038
"10850",512,"199206.302.1360.7","NMFS",1992,10,22,296,30,43.516667,-68.033333,0,0,0,0,0,"AL",0.038
"10851",515,"199206.303.1360.5","NMFS",1992,10,22,296,30,43.233333,-67.833333,0,0,0,0,0,"AL",0.038
"10852",515,"199206.304.1360.8","NMFS",1992,10,22,296,30,43.283333,-67.716667,0,0,0,0,0,"AL",0.038
"10853",465,"199206.305.1360.2","NMFS",1992,10,22,296,25,43.316667,-67.516667,0,0,0,0,0,"AL",0.038
"10854",465,"199206.306.1360.1","NMFS",1992,10,22,296,30,43.566667,-67.533333,0,0,0,0,0,"AL",0.038
"10855",465,"199206.307.1360.4","NMFS",1992,10,22,296,30,43.45,-67.4,0,0,0,0,0,"AL",0.038
"10856",465,"199206.308.1360.6","NMFS",1992,10,22,296,30,43.4,-67.383333,0,0,0,0,0,"AL",0.038
"10857",465,"199206.309.1360.3","NMFS",1992,10,22,296,30,43.366667,-67.133333,0,0,0,0,0,"AL",0.038
"10858",465,"199206.310.1340.4","NMFS",1992,10,23,297,30,43.066667,-66.866667,0,0,0,0,0,"AL",0.038
"10859",465,"199206.312.1330.2","NMFS",1992,10,23,297,30,43.266667,-66.333333,6,4,2,6,0,"AL",0.038
"10860",465,"199206.314.1340.5","NMFS",1992,10,23,297,30,43.566667,-66.9,2,2,0,2,0,"AL",0.038
"10861",465,"199206.315.1340.6","NMFS",1992,10,23,297,30,43.5,-66.633333,0,0,0,0,0,"AL",0.038
"10862",465,"199206.316.1330.3","NMFS",1992,10,23,297,30,43.616667,-66.5,0,0,0,0,0,"AL",0.038
"10863",465,"199206.317.1330.1","NMFS",1992,10,23,297,30,43.95,-66.466667,11,6,5,11,0,"AL",0.038
"10864",511,"199206.318.1340.1","NMFS",1992,10,23,297,30,43.966667,-67,0,0,0,0,0,"AL",0.038
"10865",511,"199206.319.1351.1","NMFS",1992,10,24,298,30,44.116667,-66.95,0,0,0,0,0,"AL",0.038
"10866",511,"199206.320.1351.2","NMFS",1992,10,24,298,30,44.183333,-66.95,0,0,0,0,0,"AL",0.038
"10867",511,"199206.321.1340.3","NMFS",1992,10,24,298,30,44.133333,-67.283333,0,0,0,0,0,"AL",0.038
"10868",511,"199206.323.1340.2","NMFS",1992,10,24,298,30,44.083333,-67.383333,0,0,0,0,0,"AL",0.038
"10869",512,"199206.324.1390.2","NMFS",1992,10,24,298,30,44.1,-67.933333,0,0,0,0,0,"AL",0.038
"10870",512,"199206.325.1390.4","NMFS",1992,10,24,298,30,43.966667,-68.333333,2,1,1,2,0,"AL",0.038
"10871",512,"199206.326.1380.4","NMFS",1992,10,24,298,30,43.85,-68.2,0,0,0,0,0,"AL",0.038
"10872",512,"199206.327.1380.1","NMFS",1992,10,24,298,30,43.683333,-68.2,0,0,0,0,0,"AL",0.038
"10873",512,"199206.328.1380.2","NMFS",1992,10,24,298,30,43.666667,-68.55,0,0,0,0,0,"AL",0.038
"10874",512,"199206.329.1390.3","NMFS",1992,10,25,299,30,43.75,-68.916667,39,18,21,30,9,"AL",0.038
"10875",512,"199206.331.1390.5","NMFS",1992,10,25,299,30,43.683333,-69,1,0,1,1,0,"AL",0.038
"10876",513,"199206.336.1380.5","NMFS",1992,10,26,300,30,43.283333,-69.85,0,0,0,0,0,"AL",0.038
"10877",513,"199206.337.1270.2","NMFS",1992,10,26,300,30,43.316667,-70.016667,0,0,0,0,0,"AL",0.038
"10878",513,"199206.341.1270.3","NMFS",1992,10,26,300,30,43.183333,-70.216667,0,0,0,0,0,"AL",0.038
"10879",513,"199206.342.1400.2","NMFS",1992,10,26,300,30,43.016667,-70.383333,0,0,0,0,0,"AL",0.038
"10880",513,"199206.343.1270.4","NMFS",1992,10,27,301,30,43,-70.316667,0,0,0,0,0,"AL",0.038
"10881",513,"199206.344.1260.4","NMFS",1992,10,27,301,30,42.883333,-70.166667,0,0,0,0,0,"AL",0.038
"10882",514,"199206.345.1270.5","NMFS",1992,10,27,301,30,42.75,-70.15,0,0,0,0,0,"AL",0.038
"10883",514,"199206.346.1400.3","NMFS",1992,10,27,301,30,42.833333,-70.616667,0,0,0,0,0,"AL",0.038
"10884",514,"199206.347.3630.1","NMFS",1992,10,27,301,30,42.75,-70.783333,2,0,2,2,0,"AL",0.038
"10885",514,"199206.348.3660.2","NMFS",1992,10,27,301,30,42.716667,-70.6,0,0,0,0,0,"AL",0.038
"10886",514,"199206.349.1260.1","NMFS",1992,10,27,301,30,42.733333,-70.516667,0,0,0,0,0,"AL",0.038
"10887",514,"199206.350.3650.1","NMFS",1992,10,27,301,25,42.583333,-70.583333,17,7,10,16,1,"AL",0.038
"10888",514,"199206.351.3660.1","NMFS",1992,10,27,301,30,42.366667,-70.7,24,12,12,24,0,"AL",0.038
"10889",514,"199206.352.1260.2","NMFS",1992,10,27,301,30,42.466667,-70.55,1,1,0,1,0,"AL",0.038
"10890",514,"199206.353.3640.1","NMFS",1992,10,28,302,30,42.266667,-70.666667,107,71,36,98,9,"AL",0.038
"10891",521,"199302.176.1250.2","NMFS",1993,4,6,96,30,41.45,-69.583333,1,0,1,0,1,"AL",0.038
"10892",521,"199302.177.1250.1","NMFS",1993,4,6,96,30,41.366667,-69.466667,0,0,0,0,0,"AL",0.038
"10893",521,"199302.178.1240.1","NMFS",1993,4,6,96,30,41.633333,-69.216667,4,3,1,4,0,"AL",0.038
"10894",521,"199302.179.1240.2","NMFS",1993,4,6,96,30,41.8,-68.883333,0,0,0,0,0,"AL",0.038
"10895",522,"199302.180.1240.5","NMFS",1993,4,6,96,30,41.75,-68.633333,0,0,0,0,0,"AL",0.038
"10896",522,"199302.181.1220.2","NMFS",1993,4,6,96,30,41.8,-68.35,0,0,0,0,0,"AL",0.038
"10897",522,"199302.182.1210.2","NMFS",1993,4,6,96,30,41.75,-68.283333,0,0,0,0,0,"AL",0.038
"10898",522,"199302.183.1220.4","NMFS",1993,4,6,96,30,41.916667,-68.15,0,0,0,0,0,"AL",0.038
"10899",522,"199302.184.1200.3","NMFS",1993,4,6,96,30,41.633333,-68.133333,1,0,1,1,0,"AL",0.038
"10900",522,"199302.185.1200.2","NMFS",1993,4,6,96,20,41.55,-68.016667,0,0,0,0,0,"AL",0.038
"10901",522,"199302.186.1200.5","NMFS",1993,4,7,97,30,41.466667,-68.016667,0,0,0,0,0,"AL",0.038
"10902",522,"199302.187.1190.3","NMFS",1993,4,7,97,28,41.4,-68.05,0,0,0,0,0,"AL",0.038
"10903",522,"199302.188.1190.7","NMFS",1993,4,7,97,30,41.516667,-67.716667,0,0,0,0,0,"AL",0.038
"10904",525,"199302.189.1190.6","NMFS",1993,4,7,97,30,41.2,-68.033333,0,0,0,0,0,"AL",0.038
"10905",522,"199302.190.1190.5","NMFS",1993,4,7,97,30,41.2,-68.2,0,0,0,0,0,"AL",0.038
"10906",522,"199302.191.1200.1","NMFS",1993,4,7,97,30,41.3,-68.333333,0,0,0,0,0,"AL",0.038
"10907",522,"199302.192.1230.4","NMFS",1993,4,7,97,30,41.316667,-68.55,0,0,0,0,0,"AL",0.038
"10908",522,"199302.193.1230.1","NMFS",1993,4,7,97,30,41.45,-68.583333,0,0,0,0,0,"AL",0.038
"10909",521,"199302.194.1240.3","NMFS",1993,4,7,97,30,41.333333,-68.95,0,0,0,0,0,"AL",0.038
"10910",522,"199302.195.1230.2","NMFS",1993,4,7,97,30,41.15,-68.6,0,0,0,0,0,"AL",0.038
"10911",522,"199302.196.1230.3","NMFS",1993,4,7,97,30,41.166667,-68.8,0,0,0,0,0,"AL",0.038
"10912",521,"199302.197.1230.5","NMFS",1993,4,8,98,30,41.116667,-69,0,0,0,0,0,"AL",0.038
"10913",521,"199302.198.1230.6","NMFS",1993,4,8,98,30,41.116667,-69.166667,0,0,0,0,0,"AL",0.038
"10914",521,"199302.199.1250.3","NMFS",1993,4,8,98,30,41.016667,-69.25,0,0,0,0,0,"AL",0.038
"10915",521,"199302.200.3550.3","NMFS",1993,4,8,98,30,41.033333,-69.4,1,0,1,1,0,"AL",0.038
"10916",526,"199302.201.3550.1","NMFS",1993,4,8,98,30,41.033333,-69.533333,0,0,0,0,0,"AL",0.038
"10917",526,"199302.202.3550.5","NMFS",1993,4,8,98,29.2,41.133333,-69.6,0,0,0,0,0,"AL",0.038
"10918",526,"199302.203.3550.2","NMFS",1993,4,8,98,30,41,-69.716667,0,0,0,0,0,"AL",0.038
"10919",526,"199302.204.1090.4","NMFS",1993,4,8,98,30,40.566667,-69.4,0,0,0,0,0,"AL",0.038
"10920",526,"199302.205.1100.7","NMFS",1993,4,9,99,30,40.483333,-69.133333,0,0,0,0,0,"AL",0.038
"10921",526,"199302.206.1100.3","NMFS",1993,4,9,99,30,40.383333,-69,0,0,0,0,0,"AL",0.038
"10922",526,"199302.207.1100.4","NMFS",1993,4,9,99,30,40.433333,-69.4,4,1,3,4,0,"AL",0.038
"10923",526,"199302.208.1100.6","NMFS",1993,4,9,99,30,40.483333,-69.666667,20,7,13,19,1,"AL",0.038
"10924",526,"199302.209.1100.1","NMFS",1993,4,9,99,30,40.283333,-69.416667,2,0,2,2,0,"AL",0.038
"10925",526,"199302.210.1100.5","NMFS",1993,4,9,99,30,40.083333,-69.4,0,0,0,0,0,"AL",0.038
"10926",525,"199302.212.1140.3","NMFS",1993,4,9,99,30,40.2,-68.733333,0,0,0,0,0,"AL",0.038
"10927",525,"199302.213.1140.2","NMFS",1993,4,9,99,30,40.333333,-68.283333,0,0,0,0,0,"AL",0.038
"10928",525,"199302.214.1130.1","NMFS",1993,4,10,100,30,40.516667,-68.383333,0,0,0,0,0,"AL",0.038
"10929",525,"199302.215.1190.1","NMFS",1993,4,10,100,30,40.766667,-68.583333,4,1,3,4,0,"AL",0.038
"10930",525,"199302.216.1190.9","NMFS",1993,4,10,100,30,40.766667,-68.433333,0,0,0,0,0,"AL",0.038
"10931",525,"199302.217.1190.4","NMFS",1993,4,10,100,30,40.95,-68.35,0,0,0,0,0,"AL",0.038
"10932",525,"199302.218.1130.7","NMFS",1993,4,10,100,30,40.85,-68.066667,0,0,0,0,0,"AL",0.038
"10933",525,"199302.219.1130.2","NMFS",1993,4,10,100,30,40.616667,-67.833333,0,0,0,0,0,"AL",0.038
"10934",525,"199302.220.1140.1","NMFS",1993,4,10,100,30,40.483333,-67.5,0,0,0,0,0,"AL",0.038
"10935",525,"199302.221.1130.5","NMFS",1993,4,10,100,30,40.766667,-67.4,0,0,0,0,0,"AL",0.038
"10936",525,"199302.222.1130.3","NMFS",1993,4,10,100,30,40.966667,-67.666667,0,0,0,0,0,"AL",0.038
"10937",525,"199302.223.1130.8","NMFS",1993,4,10,100,30,40.983333,-67.433333,0,0,0,0,0,"AL",0.038
"10938",525,"199302.224.1130.9","NMFS",1993,4,11,101,30,41.083333,-67.433333,0,0,0,0,0,"AL",0.038
"10939",562,"199302.225.1160.9","NMFS",1993,4,11,101,30,41.166667,-67.133333,0,0,0,0,0,"AL",0.038
"10940",562,"199302.226.1160.3","NMFS",1993,4,11,101,30,41.15,-67.033333,0,0,0,0,0,"AL",0.038
"10941",562,"199302.227.1130.6","NMFS",1993,4,11,101,30,40.883333,-66.95,0,0,0,0,0,"AL",0.038
"10942",562,"199302.228.1160.8","NMFS",1993,4,11,101,30,40.9,-66.866667,0,0,0,0,0,"AL",0.038
"10943",525,"199302.229.1130.4","NMFS",1993,4,11,101,30,40.816667,-66.916667,0,0,0,0,0,"AL",0.038
"10944",562,"199302.230.1150.1","NMFS",1993,4,11,101,30,40.75,-66.766667,3,1,2,3,0,"AL",0.038
"10945",562,"199302.231.1160.5","NMFS",1993,4,12,102,30,41.333333,-66.866667,1,0,1,1,0,"AL",0.038
"10946",562,"199302.232.1190.8","NMFS",1993,4,12,102,30,41.466667,-67.2,1,1,0,1,0,"AL",0.038
"10947",562,"199302.233.1160.4","NMFS",1993,4,12,102,30,41.583333,-66.933333,0,0,0,0,0,"AL",0.038
"10948",562,"199302.234.1160.6","NMFS",1993,4,12,102,30,41.6,-67.083333,0,0,0,0,0,"AL",0.038
"10949",551,"199302.235.1160.2","NMFS",1993,4,12,102,30,41.866667,-66.866667,2,1,1,2,0,"AL",0.038
"10950",464,"199302.236.1300.1","NMFS",1993,4,13,103,30,42.55,-67.283333,1,1,0,1,0,"AL",0.038
"10951",551,"199302.238.1290.6","NMFS",1993,4,13,103,30,42.233333,-67.033333,0,0,0,0,0,"AL",0.038
"10952",551,"199302.239.1210.1","NMFS",1993,4,13,103,30,42.15,-66.75,0,0,0,0,0,"AL",0.038
"10953",551,"199302.240.1220.1","NMFS",1993,4,13,103,30,42.183333,-66.6,2,0,2,2,0,"AL",0.038
"10954",551,"199302.241.1210.4","NMFS",1993,4,14,104,30,42.1,-66.433333,1,1,0,1,0,"AL",0.038
"10955",551,"199302.242.1210.3","NMFS",1993,4,14,104,30,42.116667,-66.316667,0,0,0,0,0,"AL",0.038
"10956",551,"199302.243.1220.3","NMFS",1993,4,14,104,30,42.083333,-65.983333,0,0,0,0,0,"AL",0.038
"10957",551,"199302.244.1170.3","NMFS",1993,4,14,104,30,42,-65.933333,0,0,0,0,0,"AL",0.038
"10958",552,"199302.245.1170.1","NMFS",1993,4,14,104,30,41.783333,-65.85,1,1,0,1,0,"AL",0.038
"10959",552,"199302.246.1160.10","NMFS",1993,4,14,104,30,41.716667,-66,0,0,0,0,0,"AL",0.038
"10960",552,"199302.247.1180.1","NMFS",1993,4,14,104,30,41.416667,-66,0,0,0,0,0,"AL",0.038
"10961",552,"199302.248.1170.2","NMFS",1993,4,15,105,30,41.35,-66.25,1,0,1,1,0,"AL",0.038
"10962",552,"199302.249.1160.7","NMFS",1993,4,15,105,30,41.55,-66.583333,0,0,0,0,0,"AL",0.038
"10963",552,"199302.250.1160.1","NMFS",1993,4,15,105,30,41.6,-66.533333,0,0,0,0,0,"AL",0.038
"10964",561,"199302.251.1190.2","NMFS",1993,4,15,105,30,42,-67.116667,0,0,0,0,0,"AL",0.038
"10965",561,"199302.252.1200.4","NMFS",1993,4,15,105,30,41.916667,-67.4,1,0,1,0,1,"AL",0.038
"10966",561,"199302.253.1200.6","NMFS",1993,4,15,105,30,42,-67.616667,0,0,0,0,0,"AL",0.038
"10967",522,"199302.254.1290.8","NMFS",1993,4,15,105,30,42.25,-68,0,0,0,0,0,"AL",0.038
"10968",521,"199302.255.1240.6","NMFS",1993,4,15,105,30,42.25,-68.866667,0,0,0,0,0,"AL",0.038
"10969",521,"199302.256.1240.4","NMFS",1993,4,15,105,30,42.2,-69.05,0,0,0,0,0,"AL",0.038
"10970",514,"199302.257.3580.1","NMFS",1993,4,20,110,30,41.816667,-70.483333,7,6,1,4,3,"AL",0.038
"10971",514,"199302.258.3600.1","NMFS",1993,4,20,110,30,41.9,-70.416667,5,3,2,4,1,"AL",0.038
"10972",514,"199302.259.3590.1","NMFS",1993,4,20,110,30,41.966667,-70.15,1,0,1,1,0,"AL",0.038
"10973",514,"199302.260.3610.2","NMFS",1993,4,20,110,30,42.016667,-70.233333,2,1,1,2,0,"AL",0.038
"10974",514,"199302.261.3600.2","NMFS",1993,4,21,111,30,42.016667,-70.516667,7,2,5,7,0,"AL",0.038
"10975",514,"199302.262.3610.1","NMFS",1993,4,21,111,30,42.15,-70.5,31,14,17,31,0,"AL",0.038
"10976",514,"199302.263.1260.1","NMFS",1993,4,21,111,30,42.166667,-70.366667,5,4,1,5,0,"AL",0.038
"10977",514,"199302.264.1260.3","NMFS",1993,4,21,111,30,42.25,-70.25,0,0,0,0,0,"AL",0.038
"10978",514,"199302.265.1260.4","NMFS",1993,4,21,111,30,42.55,-70.233333,0,0,0,0,0,"AL",0.038
"10979",514,"199302.266.1280.7","NMFS",1993,4,21,111,30,42.533333,-69.883333,0,0,0,0,0,"AL",0.038
"10980",514,"199302.267.1270.4","NMFS",1993,4,21,111,30,42.516667,-69.916667,1,1,0,1,0,"AL",0.038
"10981",514,"199302.268.1270.1","NMFS",1993,4,21,111,30,42.416667,-69.95,1,1,0,1,0,"AL",0.038
"10982",521,"199302.269.3560.1","NMFS",1993,4,21,111,28,41.966667,-69.966667,0,0,0,0,0,"AL",0.038
"10983",521,"199302.270.1280.5","NMFS",1993,4,21,111,30,41.966667,-69.583333,0,0,0,0,0,"AL",0.038
"10984",515,"199302.271.1280.4","NMFS",1993,4,22,112,30,42.4,-69.433333,0,0,0,0,0,"AL",0.038
"10985",515,"199302.272.1280.3","NMFS",1993,4,22,112,30,42.583333,-69.5,0,0,0,0,0,"AL",0.038
"10986",515,"199302.273.1280.2","NMFS",1993,4,22,112,30,42.616667,-69.466667,1,1,0,1,0,"AL",0.038
"10987",515,"199302.274.1280.6","NMFS",1993,4,22,112,30,42.683333,-69.4,0,0,0,0,0,"AL",0.038
"10988",515,"199302.275.1370.4","NMFS",1993,4,22,112,30,42.783333,-69,0,0,0,0,0,"AL",0.038
"10989",515,"199302.276.1370.2","NMFS",1993,4,22,112,30,42.75,-68.616667,0,0,0,0,0,"AL",0.038
"10990",515,"199302.277.1280.1","NMFS",1993,4,22,112,30,42.5,-68.566667,0,0,0,0,0,"AL",0.038
"10991",515,"199302.278.1290.4","NMFS",1993,4,22,112,30,42.583333,-68.25,0,0,0,0,0,"AL",0.038
"10992",515,"199302.279.1290.7","NMFS",1993,4,22,112,30,42.45,-68.1,0,0,0,0,0,"AL",0.038
"10993",515,"199302.280.1290.3","NMFS",1993,4,22,112,30,42.55,-67.85,0,0,0,0,0,"AL",0.038
"10994",464,"199302.281.1290.1","NMFS",1993,4,23,113,30,42.533333,-67.583333,0,0,0,0,0,"AL",0.038
"10995",551,"199302.282.1300.3","NMFS",1993,4,23,113,30,42.316667,-66.683333,1,1,0,1,0,"AL",0.038
"10996",464,"199302.283.1290.2","NMFS",1993,4,23,113,30,42.4,-66.45,1,1,0,1,0,"AL",0.038
"10997",464,"199302.284.1290.5","NMFS",1993,4,23,113,30,42.75,-67.116667,0,0,0,0,0,"AL",0.038
"10998",464,"199302.285.1360.4","NMFS",1993,4,23,113,30,42.883333,-66.816667,0,0,0,0,0,"AL",0.038
"10999",464,"199302.286.1360.3","NMFS",1993,4,23,113,30,42.95,-67,1,1,0,1,0,"AL",0.038
"11000",465,"199302.287.1340.6","NMFS",1993,4,24,114,30,43.4,-66.816667,1,1,0,1,0,"AL",0.038
"11001",465,"199302.288.1340.2","NMFS",1993,4,24,114,30,43.383333,-66.716667,1,0,1,1,0,"AL",0.038
"11002",465,"199302.290.1330.5","NMFS",1993,4,24,114,30,43.4,-66.5,4,2,2,3,1,"AL",0.038
"11003",465,"199302.292.1330.2","NMFS",1993,4,24,114,30,43.466667,-66.3,15,8,7,15,0,"AL",0.038
"11004",465,"199302.293.1330.3","NMFS",1993,4,25,115,30,43.55,-66.466667,9,5,4,8,1,"AL",0.038
"11005",465,"199302.294.1340.4","NMFS",1993,4,25,115,30,43.683333,-66.9,11,10,1,11,0,"AL",0.038
"11006",465,"199302.295.1340.3","NMFS",1993,4,25,115,30,43.683333,-67.066667,0,0,0,0,0,"AL",0.038
"11007",465,"199302.296.1340.5","NMFS",1993,4,25,115,30,43.7,-67.283333,0,0,0,0,0,"AL",0.038
"11008",511,"199302.297.1340.1","NMFS",1993,4,25,115,30,43.9,-67.233333,0,0,0,0,0,"AL",0.038
"11009",511,"199302.298.1351.2","NMFS",1993,4,25,115,30,44.1,-66.95,1,1,0,1,0,"AL",0.038
"11010",466,"199302.299.1351.1","NMFS",1993,4,25,115,30,44.283333,-66.8,0,0,0,0,0,"AL",0.038
"11011",511,"199302.300.1390.2","NMFS",1993,4,25,115,30,44.316667,-67.633333,0,0,0,0,0,"AL",0.038
"11012",512,"199302.301.1390.3","NMFS",1993,4,26,116,30,44.133333,-68.066667,0,0,0,0,0,"AL",0.038
"11013",512,"199302.302.1390.4","NMFS",1993,4,26,116,30,44.1,-68.083333,0,0,0,0,0,"AL",0.038
"11014",512,"199302.303.1380.5","NMFS",1993,4,26,116,30,43.9,-68.216667,1,1,0,1,0,"AL",0.038
"11015",512,"199302.304.1360.1","NMFS",1993,4,26,116,30,43.45,-68.183333,0,0,0,0,0,"AL",0.038
"11016",515,"199302.305.1360.6","NMFS",1993,4,26,116,30,43.283333,-67.733333,0,0,0,0,0,"AL",0.038
"11017",465,"199302.306.1360.2","NMFS",1993,4,26,116,30,43.4,-67.433333,0,0,0,0,0,"AL",0.038
"11018",465,"199302.307.1360.7","NMFS",1993,4,27,117,30,43.033333,-67.383333,0,0,0,0,0,"AL",0.038
"11019",464,"199302.308.1360.5","NMFS",1993,4,27,117,30,42.95,-67.45,2,2,0,2,0,"AL",0.038
"11020",515,"199302.309.1360.8","NMFS",1993,4,27,117,30,43.133333,-68.25,1,0,1,1,0,"AL",0.038
"11021",515,"199302.310.1370.5","NMFS",1993,4,27,117,30,43.016667,-68.533333,0,0,0,0,0,"AL",0.038
"11022",512,"199302.311.1380.2","NMFS",1993,4,27,117,30,43.383333,-68.75,0,0,0,0,0,"AL",0.038
"11023",513,"199302.313.1380.4","NMFS",1993,4,28,118,30,43.616667,-69.05,2,1,1,2,0,"AL",0.038
"11024",513,"199302.314.1370.3","NMFS",1993,4,28,118,30,43.233333,-69.25,0,0,0,0,0,"AL",0.038
"11025",513,"199302.315.1380.3","NMFS",1993,4,28,118,30,43.366667,-69.416667,0,0,0,0,0,"AL",0.038
"11026",513,"199302.316.1380.1","NMFS",1993,4,28,118,30,43.45,-69.516667,0,0,0,0,0,"AL",0.038
"11027",513,"199302.317.1400.3","NMFS",1993,4,28,118,30,43.6,-69.666667,1,1,0,1,0,"AL",0.038
"11028",513,"199302.318.1400.1","NMFS",1993,4,28,118,27,43.483333,-70.083333,0,0,0,0,0,"AL",0.038
"11029",513,"199302.319.1400.2","NMFS",1993,4,28,118,30,43.283333,-70.2,2,1,1,2,0,"AL",0.038
"11030",513,"199302.320.1370.1","NMFS",1993,4,29,119,30,43.05,-69.75,0,0,0,0,0,"AL",0.038
"11031",513,"199302.321.1270.3","NMFS",1993,4,29,119,30,43.05,-69.983333,0,0,0,0,0,"AL",0.038
"11032",513,"199302.322.1260.2","NMFS",1993,4,29,119,25,43,-70.016667,0,0,0,0,0,"AL",0.038
"11033",514,"199302.323.1270.2","NMFS",1993,4,29,119,30,42.816667,-70,0,0,0,0,0,"AL",0.038
"11034",514,"199302.324.3650.1","NMFS",1993,4,29,119,30,42.816667,-70.7,2,1,1,2,0,"AL",0.038
"11035",514,"199302.325.3660.1","NMFS",1993,4,29,119,30,42.716667,-70.583333,11,3,8,11,0,"AL",0.038
"11036",514,"199302.326.3660.2","NMFS",1993,4,29,119,30,42.633333,-70.45,1,0,1,1,0,"AL",0.038
"11037",514,"199302.327.1260.5","NMFS",1993,4,29,119,30,42.566667,-70.416667,2,1,1,2,0,"AL",0.038
"11038",514,"199302.328.3660.3","NMFS",1993,4,29,119,30,42.516667,-70.733333,4,2,2,4,0,"AL",0.038
"11039",514,"199302.330.3630.1","NMFS",1993,4,30,120,22,42.3,-70.816667,35,17,18,25,10,"AL",0.038
"11040",526,"199306.176.1100.3","NMFS",1993,9,27,270,30,40.116667,-69.75,0,0,0,0,0,"DE",0.038
"11041",526,"199306.177.1110.1","NMFS",1993,9,27,270,30,40.033333,-69.783333,0,0,0,0,0,"DE",0.038
"11042",526,"199306.178.1120.1","NMFS",1993,9,27,270,30,39.933333,-69.433333,8,5,3,8,0,"DE",0.038
"11043",526,"199306.179.1110.2","NMFS",1993,9,27,270,30,40.216667,-69.016667,0,0,0,0,0,"DE",0.038
"11044",526,"199306.180.1100.1","NMFS",1993,9,28,271,30,40.3,-69.266667,2,2,0,2,0,"DE",0.038
"11045",526,"199306.181.1100.4","NMFS",1993,9,28,271,30,40.3,-69.333333,1,1,0,1,0,"DE",0.038
"11046",526,"199306.182.1100.5","NMFS",1993,9,28,271,30,40.416667,-69.316667,0,0,0,0,0,"DE",0.038
"11047",526,"199306.183.1100.7","NMFS",1993,9,28,271,30,40.466667,-69.183333,1,1,0,1,0,"DE",0.038
"11048",526,"199306.184.1090.2","NMFS",1993,9,28,271,30,40.65,-69.316667,0,0,0,0,0,"DE",0.038
"11049",526,"199306.185.1090.5","NMFS",1993,9,28,271,30,40.75,-69.533333,2,2,0,2,0,"DE",0.038
"11050",526,"199306.186.1090.1","NMFS",1993,9,28,271,30,40.833333,-69.416667,0,0,0,0,0,"DE",0.038
"11051",526,"199306.187.3550.4","NMFS",1993,9,29,272,30,41.083333,-69.7,2,2,0,2,0,"DE",0.038
"11052",526,"199306.188.3550.1","NMFS",1993,9,29,272,30,41.066667,-69.633333,2,1,1,2,0,"DE",0.038
"11053",526,"199306.189.3550.3","NMFS",1993,9,29,272,30,41.066667,-69.583333,0,0,0,0,0,"DE",0.038
"11054",521,"199306.190.3550.5","NMFS",1993,9,29,272,30,41.033333,-69.383333,0,0,0,0,0,"DE",0.038
"11055",521,"199306.191.3550.2","NMFS",1993,9,29,272,30,41.283333,-69.466667,0,0,0,0,0,"DE",0.038
"11056",521,"199306.192.1230.1","NMFS",1993,9,29,272,30,41.333333,-69.266667,0,0,0,0,0,"DE",0.038
"11057",521,"199306.193.1250.4","NMFS",1993,9,29,272,30,41.166667,-69.266667,0,0,0,0,0,"DE",0.038
"11058",521,"199306.194.1250.1","NMFS",1993,9,29,272,30,41,-69.2,0,0,0,0,0,"DE",0.038
"11059",521,"199306.195.1230.2","NMFS",1993,9,29,272,30,41,-69.016667,0,0,0,0,0,"DE",0.038
"11060",525,"199306.196.1130.9","NMFS",1993,9,29,272,30,40.883333,-68.8,4,2,2,4,0,"DE",0.038
"11061",525,"199306.197.1130.7","NMFS",1993,9,29,272,30,40.916667,-68.733333,4,2,2,4,0,"DE",0.038
"11062",525,"199306.198.1190.6","NMFS",1993,9,29,272,30,40.9,-68.6,1,0,1,1,0,"DE",0.038
"11063",525,"199306.199.1130.6","NMFS",1993,9,30,273,30,40.583333,-68.783333,0,0,0,0,0,"DE",0.038
"11064",525,"199306.200.1140.1","NMFS",1993,9,30,273,30,40.233333,-68.7,0,0,0,0,0,"DE",0.038
"11065",525,"199306.201.1140.3","NMFS",1993,9,30,273,30,40.383333,-68.233333,1,1,0,1,0,"DE",0.038
"11066",525,"199306.202.1140.2","NMFS",1993,9,30,273,30,40.516667,-67.816667,0,0,0,0,0,"DE",0.038
"11067",525,"199306.203.1130.2","NMFS",1993,9,30,273,30,40.583333,-67.983333,1,1,0,1,0,"DE",0.038
"11068",525,"199306.204.1130.3","NMFS",1993,9,30,273,30,40.716667,-67.9,0,0,0,0,0,"DE",0.038
"11069",525,"199306.205.1190.2","NMFS",1993,9,30,273,30,41.033333,-68.033333,0,0,0,0,0,"DE",0.038
"11070",522,"199306.206.1190.9","NMFS",1993,9,30,273,30,41.05,-68.55,2,1,1,2,0,"DE",0.038
"11071",522,"199306.207.1200.6","NMFS",1993,9,30,273,30,41.083333,-68.583333,0,0,0,0,0,"DE",0.038
"11072",522,"199306.208.1230.5","NMFS",1993,10,1,274,30,41.216667,-68.733333,0,0,0,0,0,"DE",0.038
"11073",521,"199306.210.3560.1","NMFS",1993,10,5,278,30,41.8,-69.9,2,1,1,2,0,"DE",0.038
"11074",521,"199306.211.1230.3","NMFS",1993,10,6,279,25,41.55,-69.433333,0,0,0,0,0,"DE",0.038
"11075",521,"199306.212.1240.5","NMFS",1993,10,6,279,30,41.683333,-69.266667,0,0,0,0,0,"DE",0.038
"11076",521,"199306.213.1280.2","NMFS",1993,10,6,279,30,41.8,-69.2,0,0,0,0,0,"DE",0.038
"11077",521,"199306.214.1240.4","NMFS",1993,10,6,279,30,41.883333,-69.15,0,0,0,0,0,"DE",0.038
"11078",521,"199306.215.1280.3","NMFS",1993,10,6,279,30,41.933333,-69.266667,0,0,0,0,0,"DE",0.038
"11079",521,"199306.216.1280.5","NMFS",1993,10,6,279,30,41.966667,-69.283333,0,0,0,0,0,"DE",0.038
"11080",521,"199306.217.1240.6","NMFS",1993,10,6,279,30,42.183333,-68.966667,0,0,0,0,0,"DE",0.038
"11081",521,"199306.218.1240.3","NMFS",1993,10,6,279,30,42.216667,-68.933333,0,0,0,0,0,"DE",0.038
"11082",521,"199306.219.1240.1","NMFS",1993,10,6,279,30,42.15,-68.85,0,0,0,0,0,"DE",0.038
"11083",522,"199306.220.1230.4","NMFS",1993,10,6,279,30,41.483333,-68.566667,0,0,0,0,0,"DE",0.038
"11084",522,"199306.221.1200.5","NMFS",1993,10,7,280,26,41.3,-68.416667,1,1,0,1,0,"DE",0.038
"11085",522,"199306.222.1200.1","NMFS",1993,10,7,280,30,41.633333,-68.233333,1,0,1,1,0,"DE",0.038
"11086",522,"199306.223.1220.1","NMFS",1993,10,7,280,30,41.8,-68.3,1,1,0,1,0,"DE",0.038
"11087",522,"199306.224.1220.3","NMFS",1993,10,7,280,30,41.916667,-68.15,0,0,0,0,0,"DE",0.038
"11088",522,"199306.225.1210.3","NMFS",1993,10,7,280,30,41.833333,-67.966667,1,0,1,1,0,"DE",0.038
"11089",522,"199306.226.1200.4","NMFS",1993,10,7,280,30,41.783333,-68,2,1,1,2,0,"DE",0.038
"11090",522,"199306.227.1200.2","NMFS",1993,10,7,280,30,41.633333,-68.033333,0,0,0,0,0,"DE",0.038
"11091",522,"199306.228.1190.4","NMFS",1993,10,7,280,30,41.583333,-67.75,1,0,1,1,0,"DE",0.038
"11092",522,"199306.229.1190.5","NMFS",1993,10,7,280,30,41.466667,-67.85,6,4,2,6,0,"DE",0.038
"11093",522,"199306.230.1190.1","NMFS",1993,10,7,280,30,41.416667,-67.9,0,0,0,0,0,"DE",0.038
"11094",525,"199306.231.1130.5","NMFS",1993,10,7,280,30,41.083333,-67.5,0,0,0,0,0,"DE",0.038
"11095",525,"199306.232.1130.8","NMFS",1993,10,7,280,30,40.983333,-67.4,1,1,0,1,0,"DE",0.038
"11096",525,"199306.233.1130.1","NMFS",1993,10,8,281,30,40.833333,-67.483333,0,0,0,0,0,"DE",0.038
"11097",525,"199306.234.1130.4","NMFS",1993,10,8,281,30,40.716667,-67.516667,0,0,0,0,0,"DE",0.038
"11098",525,"199306.235.1150.1","NMFS",1993,10,8,281,30,40.683333,-66.883333,2,2,0,2,0,"DE",0.038
"11099",552,"199306.240.1170.2","NMFS",1993,10,8,281,30,41.383333,-66.133333,0,0,0,0,0,"DE",0.038
"11100",552,"199306.241.1180.1","NMFS",1993,10,8,281,30,41.433333,-65.983333,0,0,0,0,0,"DE",0.038
"11101",552,"199306.242.1160.9","NMFS",1993,10,9,282,30,41.65,-66.1,0,0,0,0,0,"DE",0.038
"11102",552,"199306.243.1160.7","NMFS",1993,10,9,282,30,41.7,-65.95,0,0,0,0,0,"DE",0.038
"11103",552,"199306.244.1170.3","NMFS",1993,10,9,282,30,41.783333,-65.783333,0,0,0,0,0,"DE",0.038
"11104",551,"199306.245.1160.8","NMFS",1993,10,9,282,30,41.85,-66.083333,0,0,0,0,0,"DE",0.038
"11105",551,"199306.246.1170.1","NMFS",1993,10,9,282,30,42.05,-65.966667,0,0,0,0,0,"DE",0.038
"11106",551,"199306.247.1220.4","NMFS",1993,10,9,282,30,42.1,-66,0,0,0,0,0,"DE",0.038
"11107",551,"199306.248.1160.4","NMFS",1993,10,9,282,30,42.033333,-66.316667,0,0,0,0,0,"DE",0.038
"11108",551,"199306.249.1210.1","NMFS",1993,10,9,282,30,42.116667,-66.366667,0,0,0,0,0,"DE",0.038
"11109",551,"199306.250.1210.2","NMFS",1993,10,9,282,30,42.116667,-66.516667,0,0,0,0,0,"DE",0.038
"11110",551,"199306.251.1220.5","NMFS",1993,10,9,282,30,42.166667,-66.85,0,0,0,0,0,"DE",0.038
"11111",551,"199306.252.1160.6","NMFS",1993,10,9,282,30,41.9,-66.6,3,3,0,3,0,"DE",0.038
"11112",551,"199306.253.1160.2","NMFS",1993,10,9,282,30,41.85,-66.55,3,0,3,2,1,"DE",0.038
"11113",551,"199306.254.1160.10","NMFS",1993,10,10,283,30,41.866667,-66.816667,0,0,0,0,0,"DE",0.038
"11114",552,"199306.255.1160.1","NMFS",1993,10,10,283,30,41.783333,-66.833333,3,2,1,3,0,"DE",0.038
"11115",562,"199306.256.1160.3","NMFS",1993,10,10,283,30,41.766667,-66.9,7,6,1,7,0,"DE",0.038
"11116",562,"199306.257.1160.5","NMFS",1993,10,10,283,30,41.666667,-66.833333,2,2,0,2,0,"DE",0.038
"11117",562,"199306.258.1190.3","NMFS",1993,10,10,283,30,41.5,-67.166667,0,0,0,0,0,"DE",0.038
"11118",562,"199306.259.1190.7","NMFS",1993,10,10,283,30,41.566667,-67.233333,6,4,2,6,0,"DE",0.038
"11119",562,"199306.260.1190.8","NMFS",1993,10,10,283,30,41.816667,-67.25,0,0,0,0,0,"DE",0.038
"11120",561,"199306.261.1200.3","NMFS",1993,10,10,283,30,41.933333,-67.533333,0,0,0,0,0,"DE",0.038
"11121",522,"199306.262.1220.2","NMFS",1993,10,10,283,30,42.2,-67.666667,0,0,0,0,0,"DE",0.038
"11122",561,"199306.263.1300.1","NMFS",1993,10,10,283,30,42.316667,-67.333333,2,1,1,2,0,"DE",0.038
"11123",464,"199306.264.1300.3","NMFS",1993,10,11,284,30,42.4,-67.083333,0,0,0,0,0,"DE",0.038
"11124",464,"199306.265.1300.2","NMFS",1993,10,11,284,30,42.533333,-67.116667,0,0,0,0,0,"DE",0.038
"11125",464,"199306.266.1290.3","NMFS",1993,10,11,284,30,42.616667,-67.216667,1,1,0,1,0,"DE",0.038
"11126",464,"199306.267.1290.8","NMFS",1993,10,11,284,30,42.683333,-67.266667,0,0,0,0,0,"DE",0.038
"11127",464,"199306.268.1290.6","NMFS",1993,10,11,284,30,42.75,-67.133333,0,0,0,0,0,"DE",0.038
"11128",464,"199306.269.1360.8","NMFS",1993,10,11,284,30,42.966667,-67.233333,1,0,1,1,0,"DE",0.038
"11129",464,"199306.270.1360.4","NMFS",1993,10,11,284,30,42.883333,-67.433333,4,2,2,4,0,"DE",0.038
"11130",515,"199306.271.1360.5","NMFS",1993,10,11,284,30,42.8,-67.716667,0,0,0,0,0,"DE",0.038
"11131",515,"199306.272.1290.4","NMFS",1993,10,11,284,30,42.583333,-67.766667,1,0,1,1,0,"DE",0.038
"11132",515,"199306.273.1290.5","NMFS",1993,10,11,284,30,42.516667,-67.983333,0,0,0,0,0,"DE",0.038
"11133",515,"199306.274.1290.1","NMFS",1993,10,11,284,30,42.416667,-67.966667,0,0,0,0,0,"DE",0.038
"11134",515,"199306.275.1290.2","NMFS",1993,10,12,285,30,42.366667,-67.983333,0,0,0,0,0,"DE",0.038
"11135",522,"199306.276.1290.7","NMFS",1993,10,12,285,30,42.316667,-68.2,0,0,0,0,0,"DE",0.038
"11136",515,"199306.277.1240.2","NMFS",1993,10,12,285,30,42.45,-68.516667,1,1,0,1,0,"DE",0.038
"11137",515,"199306.278.1370.4","NMFS",1993,10,12,285,30,43,-68.633333,0,0,0,0,0,"DE",0.038
"11138",515,"199306.279.1380.1","NMFS",1993,10,12,285,30,43.266667,-68.416667,0,0,0,0,0,"DE",0.038
"11139",515,"199306.280.1370.2","NMFS",1993,10,12,285,30,43.25,-68.65,0,0,0,0,0,"DE",0.038
"11140",515,"199306.281.1380.5","NMFS",1993,10,12,285,30,43.333333,-68.883333,0,0,0,0,0,"DE",0.038
"11141",515,"199306.282.1370.5","NMFS",1993,10,12,285,30,43.016667,-69,1,1,0,1,0,"DE",0.038
"11142",515,"199306.283.1370.3","NMFS",1993,10,12,285,30,42.933333,-69.083333,0,0,0,0,0,"DE",0.038
"11143",515,"199306.284.1280.6","NMFS",1993,10,12,285,30,42.783333,-69.633333,0,0,0,0,0,"DE",0.038
"11144",514,"199306.285.1280.4","NMFS",1993,10,13,286,30,42.783333,-69.666667,0,0,0,0,0,"DE",0.038
"11145",515,"199306.286.1280.1","NMFS",1993,10,13,286,30,42.433333,-69.633333,0,0,0,0,0,"DE",0.038
"11146",521,"199306.287.1280.7","NMFS",1993,10,13,286,30,42.266667,-69.766667,0,0,0,0,0,"DE",0.038
"11147",514,"199306.288.3660.1","NMFS",1993,10,13,286,30,42.333333,-70.633333,45,17,28,44,1,"DE",0.038
"11148",514,"199306.289.3600.2","NMFS",1993,10,13,286,30,41.983333,-70.45,89,46,43,80,9,"DE",0.038
"11149",514,"199306.290.3580.1","NMFS",1993,10,13,286,30,41.8,-70.466667,133,71,62,122,11,"DE",0.038
"11150",514,"199306.291.3590.1","NMFS",1993,10,13,286,30,41.866667,-70.216667,8,1,7,7,1,"DE",0.038
"11151",514,"199306.292.3600.1","NMFS",1993,10,14,287,30,41.95,-70.15,8,1,7,6,2,"DE",0.038
"11152",514,"199306.293.3610.1","NMFS",1993,10,14,287,30,42.1,-70.416667,21,6,15,20,1,"DE",0.038
"11153",514,"199306.294.1260.3","NMFS",1993,10,14,287,30,42.183333,-70.166667,1,0,1,1,0,"DE",0.038
"11154",514,"199306.295.3610.2","NMFS",1993,10,14,287,30,42.066667,-70.033333,2,1,1,2,0,"DE",0.038
"11155",514,"199306.298.1270.4","NMFS",1993,10,14,287,30,42.4,-70.016667,0,0,0,0,0,"DE",0.038
"11156",514,"199306.299.1260.4","NMFS",1993,10,14,287,30,42.45,-70.116667,0,0,0,0,0,"DE",0.038
"11157",514,"199306.300.1270.3","NMFS",1993,10,14,287,30,42.533333,-69.983333,0,0,0,0,0,"DE",0.038
"11158",514,"199306.301.1270.2","NMFS",1993,10,14,287,30,42.566667,-70.05,0,0,0,0,0,"DE",0.038
"11159",514,"199306.303.1260.5","NMFS",1993,10,20,293,30,42.566667,-70.35,0,0,0,0,0,"DE",0.038
"11160",514,"199306.304.3660.2","NMFS",1993,10,20,293,30,42.65,-70.5,59,33,26,52,7,"DE",0.038
"11161",514,"199306.305.3650.1","NMFS",1993,10,20,293,30,42.766667,-70.7,8,2,6,7,1,"DE",0.038
"11162",514,"199306.306.1400.1","NMFS",1993,10,20,293,30,42.816667,-70.433333,0,0,0,0,0,"DE",0.038
"11163",513,"199306.307.1260.1","NMFS",1993,10,20,293,30,42.9,-70.183333,1,0,1,1,0,"DE",0.038
"11164",513,"199306.309.1270.1","NMFS",1993,10,20,293,30,43.083333,-69.95,0,0,0,0,0,"DE",0.038
"11165",513,"199306.311.1370.1","NMFS",1993,10,21,294,30,43.233333,-69.533333,0,0,0,0,0,"DE",0.038
"11166",513,"199306.313.1400.2","NMFS",1993,10,21,294,30,43.716667,-69.5,0,0,0,0,0,"DE",0.038
"11167",513,"199306.314.1380.2","NMFS",1993,10,21,294,30,43.483333,-69.1,0,0,0,0,0,"DE",0.038
"11168",512,"199306.315.1400.3","NMFS",1993,10,21,294,30,43.75,-69.1,2,0,2,2,0,"DE",0.038
"11169",512,"199306.316.1390.3","NMFS",1993,10,23,296,30,43.816667,-69.066667,2,0,2,2,0,"DE",0.038
"11170",512,"199306.317.1390.5","NMFS",1993,10,23,296,30,43.9,-68.766667,5,3,2,5,0,"DE",0.038
"11171",512,"199306.318.1380.4","NMFS",1993,10,23,296,30,43.65,-68.5,0,0,0,0,0,"DE",0.038
"11172",465,"199306.319.1360.2","NMFS",1993,10,23,296,30,43.45,-67.516667,0,0,0,0,0,"DE",0.038
"11173",465,"199306.320.1360.6","NMFS",1993,10,24,297,30,43.633333,-67.5,1,0,1,1,0,"DE",0.038
"11174",465,"199306.321.1360.1","NMFS",1993,10,24,297,30,43.683333,-67.65,0,0,0,0,0,"DE",0.038
"11175",512,"199306.322.1360.7","NMFS",1993,10,24,297,30,43.866667,-67.933333,1,1,0,1,0,"DE",0.038
"11176",512,"199306.323.1390.2","NMFS",1993,10,24,297,30,44.066667,-68.216667,10,7,3,10,0,"DE",0.038
"11177",512,"199306.324.1390.1","NMFS",1993,10,24,297,30,44.183333,-68.016667,0,0,0,0,0,"DE",0.038
"11178",511,"199306.325.1390.4","NMFS",1993,10,24,297,30,44.35,-67.65,17,10,7,17,0,"DE",0.038
"11179",511,"199306.327.1360.3","NMFS",1993,10,25,298,30,44.166667,-67.35,0,0,0,0,0,"DE",0.038
"11180",511,"199306.328.1351.1","NMFS",1993,10,25,298,30,44.2,-67.116667,0,0,0,0,0,"DE",0.038
"11181",511,"199306.329.1351.2","NMFS",1993,10,25,298,30,44.133333,-67.033333,0,0,0,0,0,"DE",0.038
"11182",511,"199306.330.1340.4","NMFS",1993,10,25,298,30,44.05,-67.2,0,0,0,0,0,"DE",0.038
"11183",511,"199306.331.1340.5","NMFS",1993,10,26,299,30,43.933333,-67.05,1,1,0,1,0,"DE",0.038
"11184",465,"199306.332.1340.1","NMFS",1993,10,26,299,30,43.816667,-66.9,0,0,0,0,0,"DE",0.038
"11185",465,"199306.333.1340.6","NMFS",1993,10,26,299,30,43.883333,-66.766667,4,3,1,4,0,"DE",0.038
"11186",465,"199306.334.1330.3","NMFS",1993,10,26,299,30,43.8,-66.666667,3,1,2,3,0,"DE",0.038
"11187",465,"199306.335.1330.2","NMFS",1993,10,26,299,30,43.933333,-66.516667,6,3,3,6,0,"DE",0.038
"11188",465,"199306.336.1330.1","NMFS",1993,10,26,299,30,43.766667,-66.416667,28,20,8,28,0,"DE",0.038
"11189",465,"199306.337.1330.4","NMFS",1993,10,26,299,30,43.583333,-66.466667,3,2,1,3,0,"DE",0.038
"11190",465,"199306.338.1340.2","NMFS",1993,10,26,299,30,43.55,-66.766667,0,0,0,0,0,"DE",0.038
"11191",465,"199306.339.1340.3","NMFS",1993,10,26,299,30,43.483333,-66.85,0,0,0,0,0,"DE",0.038
"11192",526,"199402.174.1090.1","NMFS",1994,4,5,95,30,40.7,-69.983333,0,0,0,0,0,"DE",0.038
"11193",526,"199402.175.1090.4","NMFS",1994,4,5,95,30,40.666667,-69.933333,0,0,0,0,0,"DE",0.038
"11194",526,"199402.176.1090.5","NMFS",1994,4,5,95,30,40.633333,-69.633333,1,0,1,1,0,"DE",0.038
"11195",526,"199402.181.1100.2","NMFS",1994,4,6,96,30,40.066667,-69.55,0,0,0,0,0,"DE",0.038
"11196",526,"199402.182.1100.8","NMFS",1994,4,6,96,30,40.183333,-69.516667,0,0,0,0,0,"DE",0.038
"11197",526,"199402.183.1100.6","NMFS",1994,4,6,96,30,40.383333,-69.45,0,0,0,0,0,"DE",0.038
"11198",526,"199402.184.1100.4","NMFS",1994,4,6,96,30,40.516667,-69.066667,0,0,0,0,0,"DE",0.038
"11199",526,"199402.185.1100.1","NMFS",1994,4,6,96,30,40.583333,-69,0,0,0,0,0,"DE",0.038
"11200",525,"199402.186.1130.6","NMFS",1994,4,6,96,30,40.416667,-68.666667,0,0,0,0,0,"DE",0.038
"11201",525,"199402.187.1100.3","NMFS",1994,4,6,96,30,40.416667,-68.833333,0,0,0,0,0,"DE",0.038
"11202",526,"199402.188.1100.5","NMFS",1994,4,6,96,30,40.316667,-68.883333,0,0,0,0,0,"DE",0.038
"11203",526,"199402.189.1110.1","NMFS",1994,4,6,96,30,40.133333,-68.916667,0,0,0,0,0,"DE",0.038
"11204",525,"199402.190.1140.2","NMFS",1994,4,6,96,30,40.35,-68.383333,0,0,0,0,0,"DE",0.038
"11205",525,"199402.191.1130.8","NMFS",1994,4,7,97,30,40.45,-68.35,0,0,0,0,0,"DE",0.038
"11206",525,"199402.192.1130.7","NMFS",1994,4,7,97,30,40.533333,-68.416667,0,0,0,0,0,"DE",0.038
"11207",525,"199402.193.1190.5","NMFS",1994,4,7,97,30,40.8,-68.216667,0,0,0,0,0,"DE",0.038
"11208",525,"199402.194.1190.4","NMFS",1994,4,7,97,30,40.916667,-68.2,0,0,0,0,0,"DE",0.038
"11209",525,"199402.196.1130.2","NMFS",1994,4,7,97,30,40.566667,-67.75,0,0,0,0,0,"DE",0.038
"11210",525,"199402.197.1150.1","NMFS",1994,4,7,97,30,40.416667,-67.466667,0,0,0,0,0,"DE",0.038
"11211",525,"199402.198.1140.1","NMFS",1994,4,7,97,30,40.6,-67.2,0,0,0,0,0,"DE",0.038
"11212",525,"199402.199.1130.9","NMFS",1994,4,7,97,30,40.683333,-67.35,0,0,0,0,0,"DE",0.038
"11213",525,"199402.200.1130.3","NMFS",1994,4,7,97,30,40.916667,-67.35,0,0,0,0,0,"DE",0.038
"11214",525,"199402.201.1130.4","NMFS",1994,4,7,97,30,41.083333,-67.2,0,0,0,0,0,"DE",0.038
"11215",562,"199402.202.1130.5","NMFS",1994,4,8,98,30,40.866667,-66.916667,0,0,0,0,0,"DE",0.038
"11216",562,"199402.203.1140.3","NMFS",1994,4,8,98,30,40.766667,-66.816667,0,0,0,0,0,"DE",0.038
"11217",562,"199402.204.1160.4","NMFS",1994,4,8,98,30,40.95,-66.716667,0,0,0,0,0,"DE",0.038
"11218",562,"199402.205.1160.9","NMFS",1994,4,8,98,30,41.083333,-66.616667,0,0,0,0,0,"DE",0.038
"11219",562,"199402.206.1180.1","NMFS",1994,4,8,98,30,41.1,-66.366667,0,0,0,0,0,"DE",0.038
"11220",562,"199402.207.1170.3","NMFS",1994,4,8,98,30,41.15,-66.4,0,0,0,0,0,"DE",0.038
"11221",562,"199402.208.1160.5","NMFS",1994,4,8,98,30,41.383333,-66.833333,0,0,0,0,0,"DE",0.038
"11222",562,"199402.209.1160.1","NMFS",1994,4,8,98,30,41.483333,-66.883333,0,0,0,0,0,"DE",0.038
"11223",562,"199402.210.1160.10","NMFS",1994,4,8,98,30,41.45,-67,0,0,0,0,0,"DE",0.038
"11224",562,"199402.211.1160.8","NMFS",1994,4,9,99,30,41.35,-67.016667,0,0,0,0,0,"DE",0.038
"11225",562,"199402.212.1190.8","NMFS",1994,4,9,99,30,41.583333,-67.266667,1,0,1,1,0,"DE",0.038
"11226",562,"199402.213.1190.7","NMFS",1994,4,9,99,30,41.55,-67.5,0,0,0,0,0,"DE",0.038
"11227",562,"199402.214.1190.9","NMFS",1994,4,9,99,30,41.633333,-67.433333,0,0,0,0,0,"DE",0.038
"11228",562,"199402.215.1190.1","NMFS",1994,4,9,99,30,41.716667,-67.45,2,2,0,2,0,"DE",0.038
"11229",562,"199402.216.1190.6","NMFS",1994,4,9,99,30,41.733333,-67.033333,0,0,0,0,0,"DE",0.038
"11230",561,"199402.217.1190.3","NMFS",1994,4,9,99,30,41.966667,-67.05,0,0,0,0,0,"DE",0.038
"11231",561,"199402.218.1210.3","NMFS",1994,4,9,99,30,42.133333,-67.15,0,0,0,0,0,"DE",0.038
"11232",551,"199402.219.1210.4","NMFS",1994,4,9,99,30,42.15,-66.8,0,0,0,0,0,"DE",0.038
"11233",552,"199402.221.1160.3","NMFS",1994,4,9,99,30,41.816667,-66.4,0,0,0,0,0,"DE",0.038
"11234",552,"199402.222.1160.2","NMFS",1994,4,9,99,30,41.733333,-66.416667,0,0,0,0,0,"DE",0.038
"11235",552,"199402.223.1160.7","NMFS",1994,4,10,100,30,41.533333,-66.25,0,0,0,0,0,"DE",0.038
"11236",552,"199402.224.1160.6","NMFS",1994,4,10,100,30,41.383333,-66.316667,0,0,0,0,0,"DE",0.038
"11237",552,"199402.225.1170.2","NMFS",1994,4,10,100,30,41.483333,-66.066667,0,0,0,0,0,"DE",0.038
"11238",552,"199402.226.1170.1","NMFS",1994,4,10,100,30,41.65,-65.866667,1,1,0,1,0,"DE",0.038
"11239",551,"199402.227.1210.1","NMFS",1994,4,10,100,30,42.083333,-66.166667,0,0,0,0,0,"DE",0.038
"11240",551,"199402.228.1220.2","NMFS",1994,4,10,100,30,42.15,-66.4,0,0,0,0,0,"DE",0.038
"11241",551,"199402.229.1290.5","NMFS",1994,4,10,100,30,42.266667,-66.4,0,0,0,0,0,"DE",0.038
"11242",551,"199402.230.1290.8","NMFS",1994,4,10,100,30,42.266667,-66.316667,0,0,0,0,0,"DE",0.038
"11243",551,"199402.231.1290.7","NMFS",1994,4,10,100,30,42.283333,-66.133333,1,1,0,1,0,"DE",0.038
"11244",464,"199402.232.1290.2","NMFS",1994,4,10,100,30,42.433333,-66.3,0,0,0,0,0,"DE",0.038
"11245",464,"199402.233.1290.4","NMFS",1994,4,10,100,30,42.55,-66.533333,1,1,0,1,0,"DE",0.038
"11246",551,"199402.234.1300.2","NMFS",1994,4,11,101,30,42.3,-67.066667,4,4,0,4,0,"DE",0.038
"11247",464,"199402.235.1300.1","NMFS",1994,4,11,101,30,42.383333,-67.316667,8,6,2,8,0,"DE",0.038
"11248",561,"199402.236.1300.3","NMFS",1994,4,11,101,30,42.333333,-67.483333,12,9,3,12,0,"DE",0.038
"11249",522,"199402.237.1220.3","NMFS",1994,4,11,101,30,42.133333,-67.716667,0,0,0,0,0,"DE",0.038
"11250",522,"199402.238.1290.6","NMFS",1994,4,11,101,30,42.283333,-68.016667,0,0,0,0,0,"DE",0.038
"11251",522,"199402.239.1290.3","NMFS",1994,4,11,101,30,42.166667,-68.1,0,0,0,0,0,"DE",0.038
"11252",522,"199402.240.1220.1","NMFS",1994,4,11,101,30,41.933333,-68.05,0,0,0,0,0,"DE",0.038
"11253",522,"199402.241.1290.1","NMFS",1994,4,11,101,30,41.833333,-68.4,2,2,0,2,0,"DE",0.038
"11254",522,"199402.242.1220.4","NMFS",1994,4,12,102,30,41.866667,-68.133333,0,0,0,0,0,"DE",0.038
"11255",522,"199402.243.1210.2","NMFS",1994,4,12,102,30,41.833333,-68.016667,0,0,0,0,0,"DE",0.038
"11256",522,"199402.244.1200.1","NMFS",1994,4,12,102,30,41.783333,-67.9,2,2,0,2,0,"DE",0.038
"11257",522,"199402.245.1200.3","NMFS",1994,4,12,102,30,41.75,-67.95,1,0,1,1,0,"DE",0.038
"11258",522,"199402.246.1200.6","NMFS",1994,4,12,102,30,41.733333,-68.116667,0,0,0,0,0,"DE",0.038
"11259",522,"199402.247.1200.2","NMFS",1994,4,12,102,30,41.633333,-68.066667,0,0,0,0,0,"DE",0.038
"11260",522,"199402.248.1200.4","NMFS",1994,4,12,102,30,41.566667,-68.216667,0,0,0,0,0,"DE",0.038
"11261",525,"199402.249.1190.2","NMFS",1994,4,12,102,30,41.2,-68.083333,0,0,0,0,0,"DE",0.038
"11262",522,"199402.250.1200.5","NMFS",1994,4,12,102,30,41.15,-68.533333,0,0,0,0,0,"DE",0.038
"11263",525,"199402.251.1130.1","NMFS",1994,4,12,102,30,40.883333,-68.766667,0,0,0,0,0,"DE",0.038
"11264",522,"199402.252.1230.5","NMFS",1994,4,12,102,30,41.083333,-68.833333,0,0,0,0,0,"DE",0.038
"11265",521,"199402.253.1240.3","NMFS",1994,4,12,102,30,41.216667,-69.05,0,0,0,0,0,"DE",0.038
"11266",526,"199402.256.3550.1","NMFS",1994,4,13,103,28,41.1,-69.5,0,0,0,0,0,"DE",0.038
"11267",526,"199402.257.3550.4","NMFS",1994,4,13,103,30,41.033333,-69.616667,0,0,0,0,0,"DE",0.038
"11268",526,"199402.258.3550.5","NMFS",1994,4,13,103,30,41.083333,-69.65,0,0,0,0,0,"DE",0.038
"11269",526,"199402.259.3550.2","NMFS",1994,4,13,103,30,41.133333,-69.583333,0,0,0,0,0,"DE",0.038
"11270",521,"199402.260.3550.3","NMFS",1994,4,13,103,30,41.216667,-69.5,0,0,0,0,0,"DE",0.038
"11271",521,"199402.261.1250.3","NMFS",1994,4,13,103,29,41.383333,-69.433333,0,0,0,0,0,"DE",0.038
"11272",521,"199402.262.1240.4","NMFS",1994,4,13,103,30,41.5,-69.016667,0,0,0,0,0,"DE",0.038
"11273",522,"199402.263.1240.1","NMFS",1994,4,13,103,30,41.466667,-68.8,0,0,0,0,0,"DE",0.038
"11274",522,"199402.264.1230.3","NMFS",1994,4,13,103,30,41.366667,-68.65,0,0,0,0,0,"DE",0.038
"11275",522,"199402.265.1240.2","NMFS",1994,4,13,103,30,41.583333,-68.766667,0,0,0,0,0,"DE",0.038
"11276",521,"199402.266.1240.6","NMFS",1994,4,14,104,30,41.7,-69.216667,0,0,0,0,0,"DE",0.038
"11277",521,"199402.268.1250.1","NMFS",1994,4,14,104,30,41.5,-69.65,5,1,4,5,0,"DE",0.038
"11278",521,"199402.269.1230.2","NMFS",1994,4,14,104,30,41.633333,-69.616667,0,0,0,0,0,"DE",0.038
"11279",521,"199402.270.1230.1","NMFS",1994,4,14,104,30,41.8,-69.816667,3,0,3,3,0,"DE",0.038
"11280",521,"199402.271.1250.2","NMFS",1994,4,14,104,30,41.833333,-69.85,1,1,0,1,0,"DE",0.038
"11281",521,"199402.272.3560.1","NMFS",1994,4,14,104,30,41.883333,-69.933333,2,1,1,2,0,"DE",0.038
"11282",521,"199402.273.3610.1","NMFS",1994,4,14,104,29,42.033333,-69.95,0,0,0,0,0,"DE",0.038
"11283",514,"199402.274.1260.5","NMFS",1994,4,14,104,30,42.1,-70.016667,0,0,0,0,0,"DE",0.038
"11284",521,"199402.275.1270.5","NMFS",1994,4,14,104,30,42.166667,-69.816667,0,0,0,0,0,"DE",0.038
"11285",521,"199402.276.1280.2","NMFS",1994,4,14,104,30,42.133333,-69.45,0,0,0,0,0,"DE",0.038
"11286",521,"199402.277.1280.1","NMFS",1994,4,14,104,30,42,-69.483333,0,0,0,0,0,"DE",0.038
"11287",514,"199402.278.3590.1","NMFS",1994,4,20,110,30,41.8,-70.366667,1,0,1,1,0,"DE",0.038
"11288",514,"199402.279.3580.1","NMFS",1994,4,20,110,30,41.85,-70.183333,0,0,0,0,0,"DE",0.038
"11289",514,"199402.280.3600.2","NMFS",1994,4,20,110,30,41.966667,-70.216667,2,0,2,2,0,"DE",0.038
"11290",514,"199402.281.3610.2","NMFS",1994,4,20,110,30,42.05,-70.283333,4,3,1,4,0,"DE",0.038
"11291",514,"199402.282.3600.1","NMFS",1994,4,20,110,30,42.15,-70.516667,9,4,5,9,0,"DE",0.038
"11292",514,"199402.283.1260.3","NMFS",1994,4,21,111,30,42.183333,-70.433333,3,1,2,3,0,"DE",0.038
"11293",514,"199402.284.1270.3","NMFS",1994,4,21,111,30,42.416667,-69.966667,0,0,0,0,0,"DE",0.038
"11294",514,"199402.285.1260.1","NMFS",1994,4,21,111,30,42.4,-70.216667,0,0,0,0,0,"DE",0.038
"11295",514,"199402.287.1260.6","NMFS",1994,4,21,111,30,42.633333,-70.266667,0,0,0,0,0,"DE",0.038
"11296",514,"199402.288.1270.2","NMFS",1994,4,21,111,30,42.783333,-70.066667,1,0,1,1,0,"DE",0.038
"11297",514,"199402.289.1280.3","NMFS",1994,4,21,111,30,42.766667,-69.683333,0,0,0,0,0,"DE",0.038
"11298",514,"199402.290.1280.6","NMFS",1994,4,21,111,30,42.6,-69.733333,0,0,0,0,0,"DE",0.038
"11299",515,"199402.291.1280.7","NMFS",1994,4,21,111,30.6,42.4,-69.633333,0,0,0,0,0,"DE",0.038
"11300",515,"199402.292.1370.5","NMFS",1994,4,21,111,30,42.683333,-69.216667,0,0,0,0,0,"DE",0.038
"11301",521,"199402.293.1240.5","NMFS",1994,4,22,112,30,42.1,-68.866667,0,0,0,0,0,"DE",0.038
"11302",515,"199402.294.1280.4","NMFS",1994,4,22,112,30,42.416667,-68.633333,0,0,0,0,0,"DE",0.038
"11303",515,"199402.295.1360.2","NMFS",1994,4,22,112,30,42.766667,-68.416667,0,0,0,0,0,"DE",0.038
"11304",515,"199402.296.1360.4","NMFS",1994,4,22,112,30,43.116667,-68.333333,1,1,0,1,0,"DE",0.038
"11305",515,"199402.297.1360.1","NMFS",1994,4,22,112,30,43.116667,-67.833333,0,0,0,0,0,"DE",0.038
"11306",515,"199402.298.1360.6","NMFS",1994,4,22,112,30,42.85,-67.816667,3,3,0,3,0,"DE",0.038
"11307",465,"199402.299.1360.7","NMFS",1994,4,22,112,30,43.05,-67.1,1,1,0,1,0,"DE",0.038
"11308",464,"199402.300.1360.5","NMFS",1994,4,22,112,30,42.85,-66.833333,0,0,0,0,0,"DE",0.038
"11309",464,"199402.301.1360.8","NMFS",1994,4,23,113,30,42.866667,-66.666667,0,0,0,0,0,"DE",0.038
"11310",465,"199402.302.1340.2","NMFS",1994,4,23,113,27,43.066667,-66.85,1,1,0,1,0,"DE",0.038
"11311",465,"199402.303.1340.4","NMFS",1994,4,23,113,30,43.283333,-66.866667,0,0,0,0,0,"DE",0.038
"11312",465,"199402.304.1340.1","NMFS",1994,4,23,113,30,43.266667,-66.716667,1,1,0,1,0,"DE",0.038
"11313",465,"199402.305.1330.3","NMFS",1994,4,23,113,30,43.133333,-66.416667,0,0,0,0,0,"DE",0.038
"11314",465,"199402.306.1330.1","NMFS",1994,4,23,113,30,43.35,-66.55,0,0,0,0,0,"DE",0.038
"11315",465,"199402.308.1340.6","NMFS",1994,4,23,113,30,43.65,-66.583333,1,1,0,1,0,"DE",0.038
"11316",465,"199402.309.1340.3","NMFS",1994,4,23,113,30,43.7,-66.85,5,0,5,5,0,"DE",0.038
"11317",465,"199402.310.1330.2","NMFS",1994,4,24,114,30,43.883333,-66.633333,0,0,0,0,0,"DE",0.038
"11318",466,"199402.311.1351.1","NMFS",1994,4,24,114,30,44.166667,-66.833333,0,0,0,0,0,"DE",0.038
"11319",511,"199402.312.1351.2","NMFS",1994,4,24,114,30,44.166667,-67.133333,0,0,0,0,0,"DE",0.038
"11320",511,"199402.313.1340.5","NMFS",1994,4,24,114,30,44.05,-67.433333,0,0,0,0,0,"DE",0.038
"11321",511,"199402.314.1390.4","NMFS",1994,4,24,114,30,44.333333,-67.5,1,0,1,1,0,"DE",0.038
"11322",512,"199402.315.1390.5","NMFS",1994,4,24,114,30,44.2,-67.983333,0,0,0,0,0,"DE",0.038
"11323",512,"199402.316.1390.1","NMFS",1994,4,24,114,30,43.966667,-68.283333,0,0,0,0,0,"DE",0.038
"11324",512,"199402.317.1390.3","NMFS",1994,4,24,114,30,43.9,-68.783333,8,5,3,8,0,"DE",0.038
"11325",512,"199402.318.1390.2","NMFS",1994,4,25,115,30,43.8,-68.633333,0,0,0,0,0,"DE",0.038
"11326",512,"199402.319.1380.2","NMFS",1994,4,25,115,30,43.633333,-68.516667,0,0,0,0,0,"DE",0.038
"11327",512,"199402.320.1360.3","NMFS",1994,4,25,115,30,43.616667,-68.033333,0,0,0,0,0,"DE",0.038
"11328",512,"199402.321.1380.4","NMFS",1994,4,25,115,30,43.516667,-68.183333,0,0,0,0,0,"DE",0.038
"11329",512,"199402.322.1380.3","NMFS",1994,4,25,115,30,43.5,-68.766667,1,1,0,1,0,"DE",0.038
"11330",512,"199402.323.1380.5","NMFS",1994,4,25,115,30,43.383333,-68.7,0,0,0,0,0,"DE",0.038
"11331",515,"199402.324.1370.3","NMFS",1994,4,25,115,30,43.166667,-68.833333,0,0,0,0,0,"DE",0.038
"11332",513,"199402.325.1370.4","NMFS",1994,4,25,115,30,43.216667,-69.116667,0,0,0,0,0,"DE",0.038
"11333",513,"199402.326.1370.2","NMFS",1994,4,25,115,30,43.183333,-69.333333,0,0,0,0,0,"DE",0.038
"11334",513,"199402.327.1370.1","NMFS",1994,4,25,115,30,43.116667,-69.55,0,0,0,0,0,"DE",0.038
"11335",513,"199402.328.1380.1","NMFS",1994,4,26,116,22,43.6,-69.283333,1,1,0,1,0,"DE",0.038
"11336",513,"199402.329.1400.2","NMFS",1994,4,26,116,30,43.766667,-69.5,1,1,0,1,0,"DE",0.038
"11337",513,"199402.330.1400.3","NMFS",1994,4,26,116,30,43.483333,-69.85,2,2,0,2,0,"DE",0.038
"11338",513,"199402.331.1270.4","NMFS",1994,4,26,116,30,43.133333,-70.316667,2,1,1,2,0,"DE",0.038
"11339",513,"199402.332.1270.1","NMFS",1994,4,26,116,30,43,-70.366667,2,1,1,2,0,"DE",0.038
"11340",513,"199402.333.1400.1","NMFS",1994,4,26,116,30,42.85,-70.5,0,0,0,0,0,"DE",0.038
"11341",514,"199402.334.3660.2","NMFS",1994,4,26,116,30,42.816667,-70.683333,2,2,0,2,0,"DE",0.038
"11342",514,"199402.335.3630.1","NMFS",1994,4,26,116,30,42.7,-70.716667,2,0,2,2,0,"DE",0.038
"11343",514,"199402.336.3650.1","NMFS",1994,4,26,116,30,42.75,-70.683333,1,0,1,1,0,"DE",0.038
"11344",514,"199402.337.1260.2","NMFS",1994,4,26,116,30,42.733333,-70.466667,6,5,1,6,0,"DE",0.038
"11345",514,"199402.339.3640.1","NMFS",1994,4,27,117,25,42.516667,-70.716667,6,5,1,6,0,"DE",0.038
"11346",526,"199406.173.1100.8","NMFS",1994,10,4,277,30,40.55,-69.95,0,0,0,0,0,"AL",0.038
"11347",526,"199406.175.1100.6","NMFS",1994,10,4,277,30,40.2,-69.95,0,0,0,0,0,"AL",0.038
"11348",526,"199406.176.1100.5","NMFS",1994,10,4,277,30,40.366667,-69.666667,2,0,2,2,0,"AL",0.038
"11349",526,"199406.177.1100.3","NMFS",1994,10,4,277,30,40.416667,-69.483333,0,0,0,0,0,"AL",0.038
"11350",526,"199406.178.1120.1","NMFS",1994,10,5,278,30,39.95,-69.316667,3,2,1,2,1,"AL",0.038
"11351",526,"199406.179.1110.2","NMFS",1994,10,5,278,30,39.983333,-69.366667,0,0,0,0,0,"AL",0.038
"11352",526,"199406.180.1110.1","NMFS",1994,10,5,278,30,40.066667,-69.166667,0,0,0,0,0,"AL",0.038
"11353",525,"199406.181.1140.3","NMFS",1994,10,5,278,30,40.283333,-68.383333,0,0,0,0,0,"AL",0.038
"11354",525,"199406.182.1130.5","NMFS",1994,10,5,278,30,40.466667,-68.333333,0,0,0,0,0,"AL",0.038
"11355",525,"199406.183.1140.2","NMFS",1994,10,5,278,30,40.466667,-67.883333,0,0,0,0,0,"AL",0.038
"11356",525,"199406.184.1140.1","NMFS",1994,10,5,278,30,40.433333,-67.883333,0,0,0,0,0,"AL",0.038
"11357",525,"199406.185.1150.1","NMFS",1994,10,5,278,30,40.416667,-67.533333,1,0,1,0,1,"AL",0.038
"11358",525,"199406.186.1130.7","NMFS",1994,10,5,278,30,40.583333,-67.783333,1,1,0,1,0,"AL",0.038
"11359",525,"199406.187.1130.6","NMFS",1994,10,6,279,30,40.75,-68.066667,0,0,0,0,0,"AL",0.038
"11360",525,"199406.188.1130.2","NMFS",1994,10,6,279,30,40.916667,-67.583333,0,0,0,0,0,"AL",0.038
"11361",525,"199406.189.1130.3","NMFS",1994,10,6,279,30,40.75,-67.516667,0,0,0,0,0,"AL",0.038
"11362",525,"199406.190.1130.9","NMFS",1994,10,6,279,30,40.75,-67.233333,3,3,0,3,0,"AL",0.038
"11363",525,"199406.191.1130.8","NMFS",1994,10,6,279,30,40.783333,-67.116667,4,4,0,4,0,"AL",0.038
"11364",562,"199406.192.1160.9","NMFS",1994,10,6,279,30,41.033333,-66.783333,0,0,0,0,0,"AL",0.038
"11365",562,"199406.193.1160.8","NMFS",1994,10,6,279,30,41.166667,-66.933333,0,0,0,0,0,"AL",0.038
"11366",562,"199406.194.1160.7","NMFS",1994,10,6,279,30,41.2,-66.966667,1,1,0,1,0,"AL",0.038
"11367",562,"199406.195.1160.6","NMFS",1994,10,6,279,30,41.3,-67.05,2,2,0,2,0,"AL",0.038
"11368",562,"199406.196.1190.1","NMFS",1994,10,6,279,30,41.383333,-67.416667,1,1,0,1,0,"AL",0.038
"11369",562,"199406.197.1160.2","NMFS",1994,10,6,279,30,41.4,-67.066667,2,2,0,2,0,"AL",0.038
"11370",562,"199406.198.1160.1","NMFS",1994,10,6,279,30,41.466667,-66.95,0,0,0,0,0,"AL",0.038
"11371",562,"199406.199.1160.12","NMFS",1994,10,7,280,30,41.533333,-66.7,2,2,0,2,0,"AL",0.038
"11372",562,"199406.200.1160.11","NMFS",1994,10,7,280,30,41.3,-66.55,0,0,0,0,0,"AL",0.038
"11373",552,"199406.201.1160.5","NMFS",1994,10,7,280,30,41.5,-66.233333,0,0,0,0,0,"AL",0.038
"11374",552,"199406.202.1170.2","NMFS",1994,10,7,280,30,41.466667,-66.05,2,2,0,2,0,"AL",0.038
"11375",552,"199406.203.1160.3","NMFS",1994,10,7,280,30,41.633333,-65.95,0,0,0,0,0,"AL",0.038
"11376",552,"199406.204.1170.1","NMFS",1994,10,7,280,30,41.666667,-65.9,0,0,0,0,0,"AL",0.038
"11377",552,"199406.205.1160.10","NMFS",1994,10,7,280,30,41.7,-65.916667,1,0,1,1,0,"AL",0.038
"11378",552,"199406.206.1170.3","NMFS",1994,10,7,280,30,41.8,-65.783333,0,0,0,0,0,"AL",0.038
"11379",551,"199406.207.1180.1","NMFS",1994,10,7,280,30,42,-65.75,0,0,0,0,0,"AL",0.038
"11380",464,"199406.209.1290.2","NMFS",1994,10,8,281,30,42.383333,-66.433333,0,0,0,0,0,"AL",0.038
"11381",464,"199406.210.1300.1","NMFS",1994,10,8,281,30,42.6,-67.083333,0,0,0,0,0,"AL",0.038
"11382",464,"199406.211.1300.2","NMFS",1994,10,8,281,30,42.433333,-67.183333,0,0,0,0,0,"AL",0.038
"11383",464,"199406.212.1290.6","NMFS",1994,10,8,281,30,42.483333,-67.5,0,0,0,0,0,"AL",0.038
"11384",515,"199406.213.1290.1","NMFS",1994,10,8,281,30,42.4,-67.666667,0,0,0,0,0,"AL",0.038
"11385",561,"199406.214.1290.5","NMFS",1994,10,8,281,30,42.25,-67.483333,0,0,0,0,0,"AL",0.038
"11386",561,"199406.215.1210.2","NMFS",1994,10,8,281,30,42.133333,-67.3,0,0,0,0,0,"AL",0.038
"11387",551,"199406.216.1220.1","NMFS",1994,10,8,281,30,42.216667,-67.133333,0,0,0,0,0,"AL",0.038
"11388",551,"199406.217.1290.4","NMFS",1994,10,8,281,30,42.25,-67.1,0,0,0,0,0,"AL",0.038
"11389",464,"199406.218.1290.3","NMFS",1994,10,8,281,30,42.4,-66.95,0,0,0,0,0,"AL",0.038
"11390",551,"199406.219.1210.3","NMFS",1994,10,9,282,30,42.116667,-66.833333,1,1,0,1,0,"AL",0.038
"11391",551,"199406.220.1220.3","NMFS",1994,10,9,282,30,42.166667,-66.466667,0,0,0,0,0,"AL",0.038
"11392",551,"199406.221.1210.4","NMFS",1994,10,9,282,30,42.1,-66.45,0,0,0,0,0,"AL",0.038
"11393",551,"199406.222.1160.4","NMFS",1994,10,9,282,30,41.866667,-66.3,0,0,0,0,0,"AL",0.038
"11394",551,"199406.223.1160.13","NMFS",1994,10,9,282,30,41.9,-66.683333,0,0,0,0,0,"AL",0.038
"11395",561,"199406.224.1190.2","NMFS",1994,10,9,282,30,41.9,-67.133333,4,2,2,4,0,"AL",0.038
"11396",562,"199406.225.1190.4","NMFS",1994,10,9,282,30,41.766667,-67.433333,0,0,0,0,0,"AL",0.038
"11397",561,"199406.226.1200.6","NMFS",1994,10,9,282,30,41.85,-67.433333,1,0,1,1,0,"AL",0.038
"11398",522,"199406.227.1210.1","NMFS",1994,10,9,282,30,42,-67.733333,1,0,1,1,0,"AL",0.038
"11399",522,"199406.228.1200.3","NMFS",1994,10,9,282,30,41.833333,-67.783333,3,3,0,3,0,"AL",0.038
"11400",522,"199406.229.1200.4","NMFS",1994,10,9,282,30,41.783333,-67.9,2,2,0,2,0,"AL",0.038
"11401",522,"199406.230.1220.4","NMFS",1994,10,10,283,30,41.883333,-68.2,0,0,0,0,0,"AL",0.038
"11402",522,"199406.231.1220.2","NMFS",1994,10,10,283,30,41.816667,-68.283333,0,0,0,0,0,"AL",0.038
"11403",522,"199406.232.1240.6","NMFS",1994,10,10,283,30,41.866667,-68.533333,0,0,0,0,0,"AL",0.038
"11404",522,"199406.233.1240.2","NMFS",1994,10,10,283,30,41.75,-68.566667,0,0,0,0,0,"AL",0.038
"11405",522,"199406.234.1200.5","NMFS",1994,10,10,283,30,41.616667,-68.266667,0,0,0,0,0,"AL",0.038
"11406",522,"199406.235.1200.2","NMFS",1994,10,10,283,30,41.616667,-68.116667,4,3,1,3,1,"AL",0.038
"11407",522,"199406.236.1190.6","NMFS",1994,10,10,283,30,41.516667,-67.85,5,2,3,5,0,"AL",0.038
"11408",525,"199406.237.1190.7","NMFS",1994,10,10,283,30,41.316667,-67.933333,0,0,0,0,0,"AL",0.038
"11409",522,"199406.238.1200.1","NMFS",1994,10,10,283,30,41.35,-68.283333,1,0,1,1,0,"AL",0.038
"11410",522,"199406.239.1230.3","NMFS",1994,10,10,283,30,41.533333,-68.55,0,0,0,0,0,"AL",0.038
"11411",522,"199406.240.1230.5","NMFS",1994,10,10,283,30,41.416667,-68.6,0,0,0,0,0,"AL",0.038
"11412",521,"199406.241.1240.5","NMFS",1994,10,11,284,30,41.466667,-68.933333,0,0,0,0,0,"AL",0.038
"11413",521,"199406.242.1240.3","NMFS",1994,10,11,284,30,41.333333,-69.033333,0,0,0,0,0,"AL",0.038
"11414",522,"199406.243.1230.1","NMFS",1994,10,11,284,30,41.216667,-68.583333,0,0,0,0,0,"AL",0.038
"11415",522,"199406.244.1190.9","NMFS",1994,10,11,284,30,41.083333,-68.45,0,0,0,0,0,"AL",0.038
"11416",522,"199406.245.1230.4","NMFS",1994,10,11,284,30,41.05,-68.75,1,1,0,1,0,"AL",0.038
"11417",525,"199406.246.1190.8","NMFS",1994,10,11,284,30,40.916667,-68.616667,0,0,0,0,0,"AL",0.038
"11418",525,"199406.247.1190.5","NMFS",1994,10,11,284,30,40.933333,-68.45,1,0,1,1,0,"AL",0.038
"11419",525,"199406.248.1190.3","NMFS",1994,10,11,284,30,40.883333,-68.616667,1,1,0,1,0,"AL",0.038
"11420",525,"199406.249.1130.4","NMFS",1994,10,11,284,30,40.783333,-68.783333,2,2,0,2,0,"AL",0.038
"11421",525,"199406.250.1130.1","NMFS",1994,10,12,285,30,40.683333,-68.75,0,0,0,0,0,"AL",0.038
"11422",526,"199406.251.1100.2","NMFS",1994,10,12,285,30,40.566667,-68.866667,0,0,0,0,0,"AL",0.038
"11423",526,"199406.252.1100.7","NMFS",1994,10,12,285,30,40.783333,-69.116667,0,0,0,0,0,"AL",0.038
"11424",526,"199406.253.1100.4","NMFS",1994,10,12,285,30,40.883333,-69.233333,1,1,0,1,0,"AL",0.038
"11425",521,"199406.254.1090.3","NMFS",1994,10,12,285,30,41.016667,-69.233333,2,1,1,2,0,"AL",0.038
"11426",526,"199406.256.1090.6","NMFS",1994,10,12,285,30,40.9,-69.283333,1,0,1,1,0,"AL",0.038
"11427",526,"199406.257.1090.4","NMFS",1994,10,12,285,30,40.7,-69.5,0,0,0,0,0,"AL",0.038
"11428",526,"199406.258.3550.5","NMFS",1994,10,12,285,30,40.95,-69.6,0,0,0,0,0,"AL",0.038
"11429",526,"199406.259.3550.4","NMFS",1994,10,12,285,30,41.016667,-69.716667,0,0,0,0,0,"AL",0.038
"11430",526,"199406.260.3550.3","NMFS",1994,10,12,285,30,41.066667,-69.516667,0,0,0,0,0,"AL",0.038
"11431",526,"199406.261.3550.2","NMFS",1994,10,12,285,30,41.05,-69.5,0,0,0,0,0,"AL",0.038
"11432",521,"199406.262.1250.1","NMFS",1994,10,13,286,30,41.316667,-69.45,7,4,3,7,0,"AL",0.038
"11433",521,"199406.263.1230.2","NMFS",1994,10,13,286,30,41.45,-69.366667,0,0,0,0,0,"AL",0.038
"11434",521,"199406.264.1250.2","NMFS",1994,10,13,286,30,41.433333,-69.483333,24,10,14,22,2,"AL",0.038
"11435",521,"199406.266.3550.6","NMFS",1994,10,13,286,30,41.316667,-69.55,8,8,0,8,0,"AL",0.038
"11436",521,"199406.267.1250.4","NMFS",1994,10,13,286,25,41.616667,-69.733333,10,5,5,10,0,"AL",0.038
"11437",521,"199406.269.1250.5","NMFS",1994,10,13,286,30,41.933333,-69.883333,0,0,0,0,0,"AL",0.038
"11438",514,"199406.271.3610.1","NMFS",1994,10,13,286,30,42.066667,-70,1,1,0,1,0,"AL",0.038
"11439",521,"199406.272.1270.4","NMFS",1994,10,13,286,30,42.116667,-69.916667,0,0,0,0,0,"AL",0.038
"11440",514,"199406.274.1260.1","NMFS",1994,10,19,292,30,42.183333,-70.4,5,1,4,5,0,"AL",0.038
"11441",514,"199406.275.1260.2","NMFS",1994,10,19,292,30,42.316667,-70.383333,15,6,9,15,0,"AL",0.038
"11442",514,"199406.276.1260.4","NMFS",1994,10,19,292,30,42.383333,-70.183333,0,0,0,0,0,"AL",0.038
"11443",521,"199406.277.1280.5","NMFS",1994,10,19,292,30,42.3,-69.783333,0,0,0,0,0,"AL",0.038
"11444",515,"199406.278.1280.7","NMFS",1994,10,19,292,30,42.566667,-69.533333,0,0,0,0,0,"AL",0.038
"11445",515,"199406.279.1280.1","NMFS",1994,10,19,292,30,42.65,-69.55,0,0,0,0,0,"AL",0.038
"11446",515,"199406.280.1370.3","NMFS",1994,10,19,292,30,42.766667,-69.45,0,0,0,0,0,"AL",0.038
"11447",513,"199406.281.1370.5","NMFS",1994,10,19,292,30,43.066667,-69.55,0,0,0,0,0,"AL",0.038
"11448",515,"199406.282.1370.1","NMFS",1994,10,20,293,30,42.983333,-68.866667,1,1,0,1,0,"AL",0.038
"11449",515,"199406.283.1370.4","NMFS",1994,10,20,293,30,42.616667,-68.933333,0,0,0,0,0,"AL",0.038
"11450",521,"199406.284.1280.6","NMFS",1994,10,20,293,30,42.233333,-69.3,0,0,0,0,0,"AL",0.038
"11451",521,"199406.285.1280.2","NMFS",1994,10,20,293,30,42.016667,-69.5,0,0,0,0,0,"AL",0.038
"11452",521,"199406.286.1280.4","NMFS",1994,10,20,293,30,41.95,-69.583333,0,0,0,0,0,"AL",0.038
"11453",521,"199406.287.1240.1","NMFS",1994,10,20,293,30,42.166667,-68.9,0,0,0,0,0,"AL",0.038
"11454",521,"199406.288.1240.4","NMFS",1994,10,20,293,30,42.083333,-68.916667,0,0,0,0,0,"AL",0.038
"11455",515,"199406.289.1290.9","NMFS",1994,10,20,293,30,42.35,-68.35,0,0,0,0,0,"AL",0.038
"11456",515,"199406.290.1290.8","NMFS",1994,10,21,294,30,42.616667,-68.266667,0,0,0,0,0,"AL",0.038
"11457",515,"199406.291.1360.6","NMFS",1994,10,21,294,30,43.233333,-68.066667,0,0,0,0,0,"AL",0.038
"11458",515,"199406.292.1360.5","NMFS",1994,10,21,294,30,43.3,-67.783333,0,0,0,0,0,"AL",0.038
"11459",465,"199406.293.1360.8","NMFS",1994,10,21,294,30,43.033333,-67.65,0,0,0,0,0,"AL",0.038
"11460",465,"199406.294.1360.7","NMFS",1994,10,21,294,30,43.05,-67.316667,2,1,1,2,0,"AL",0.038
"11461",465,"199406.295.1360.1","NMFS",1994,10,21,294,30,43.233333,-67.216667,0,0,0,0,0,"AL",0.038
"11462",465,"199406.296.1360.2","NMFS",1994,10,22,295,30,43.316667,-67.316667,2,2,0,2,0,"AL",0.038
"11463",465,"199406.297.1340.4","NMFS",1994,10,22,295,30,43.166667,-66.9,1,0,1,1,0,"AL",0.038
"11464",465,"199406.299.1330.5","NMFS",1994,10,22,295,25,43.3,-66.466667,0,0,0,0,0,"AL",0.038
"11465",465,"199406.300.1330.1","NMFS",1994,10,22,295,30,43.433333,-66.333333,1,1,0,1,0,"AL",0.038
"11466",465,"199406.301.1330.2","NMFS",1994,10,22,295,30,43.5,-66.3,29,10,19,29,0,"AL",0.038
"11467",465,"199406.302.1330.4","NMFS",1994,10,23,296,30,43.633333,-66.366667,31,16,15,30,1,"AL",0.038
"11468",465,"199406.303.1340.5","NMFS",1994,10,23,296,30,43.7,-66.783333,1,1,0,1,0,"AL",0.038
"11469",465,"199406.304.1340.2","NMFS",1994,10,23,296,30,43.733333,-67.15,0,0,0,0,0,"AL",0.038
"11470",511,"199406.305.1340.3","NMFS",1994,10,23,296,30,43.9,-67.133333,1,0,1,1,0,"AL",0.038
"11471",511,"199406.306.1340.6","NMFS",1994,10,23,296,30,44.033333,-67.016667,2,2,0,2,0,"AL",0.038
"11472",465,"199406.307.1330.6","NMFS",1994,10,23,296,30,43.983333,-66.55,8,2,6,8,0,"AL",0.038
"11473",511,"199406.308.1351.2","NMFS",1994,10,23,296,30,44.183333,-67.05,0,0,0,0,0,"AL",0.038
"11474",511,"199406.309.1351.1","NMFS",1994,10,23,296,30,44.233333,-67.183333,0,0,0,0,0,"AL",0.038
"11475",511,"199406.310.1340.1","NMFS",1994,10,23,296,30,44.016667,-67.45,0,0,0,0,0,"AL",0.038
"11476",512,"199406.311.1390.3","NMFS",1994,10,24,297,30,44.166667,-67.95,18,11,7,17,1,"AL",0.038
"11477",512,"199406.312.1380.2","NMFS",1994,10,24,297,22,43.916667,-68.283333,0,0,0,0,0,"AL",0.038
"11478",512,"199406.313.1380.4","NMFS",1994,10,24,297,30,43.85,-68.116667,0,0,0,0,0,"AL",0.038
"11479",512,"199406.314.1360.4","NMFS",1994,10,24,297,30,43.7,-67.833333,0,0,0,0,0,"AL",0.038
"11480",512,"199406.315.1360.3","NMFS",1994,10,24,297,30,43.616667,-67.966667,0,0,0,0,0,"AL",0.038
"11481",512,"199406.316.1380.3","NMFS",1994,10,24,297,30,43.516667,-68.35,0,0,0,0,0,"AL",0.038
"11482",512,"199406.317.1380.5","NMFS",1994,10,24,297,30,43.683333,-68.283333,0,0,0,0,0,"AL",0.038
"11483",512,"199406.318.1390.2","NMFS",1994,10,24,297,23,43.85,-68.45,1,1,0,1,0,"AL",0.038
"11484",512,"199406.319.1390.4","NMFS",1994,10,24,297,30,43.866667,-68.6,2,2,0,2,0,"AL",0.038
"11485",512,"199406.320.1390.1","NMFS",1994,10,25,298,30,43.916667,-68.783333,9,6,3,9,0,"AL",0.038
"11486",512,"199406.321.1400.1","NMFS",1994,10,25,298,30,43.733333,-69.25,10,6,4,9,1,"AL",0.038
"11487",513,"199406.322.1380.1","NMFS",1994,10,25,298,30,43.55,-69.05,0,0,0,0,0,"AL",0.038
"11488",513,"199406.323.1370.2","NMFS",1994,10,25,298,30,43.233333,-69.183333,0,0,0,0,0,"AL",0.038
"11489",513,"199406.324.1400.2","NMFS",1994,10,25,298,30,43.416667,-70.033333,0,0,0,0,0,"AL",0.038
"11490",513,"199406.325.1270.2","NMFS",1994,10,25,298,30,43.233333,-70.083333,0,0,0,0,0,"AL",0.038
"11491",513,"199406.326.1400.3","NMFS",1994,10,25,298,30,43.216667,-70.283333,6,3,3,6,0,"AL",0.038
"11492",513,"199406.327.1270.1","NMFS",1994,10,26,299,30,43.016667,-70.116667,1,1,0,1,0,"AL",0.038
"11493",514,"199406.329.1280.3","NMFS",1994,10,26,299,30,42.816667,-69.916667,0,0,0,0,0,"AL",0.038
"11494",513,"199406.330.3650.1","NMFS",1994,10,26,299,30,42.85,-70.716667,59,32,27,48,11,"AL",0.038
"11495",514,"199406.331.3640.1","NMFS",1994,10,26,299,30,42.7,-70.7,2,1,1,2,0,"AL",0.038
"11496",514,"199406.332.3630.1","NMFS",1994,10,26,299,26,42.816667,-70.783333,15,6,9,9,6,"AL",0.038
"11497",514,"199406.333.3660.1","NMFS",1994,10,26,299,30,42.516667,-70.683333,186,75,111,170,16,"AL",0.038
"11498",514,"199406.334.1260.5","NMFS",1994,10,26,299,30,42.3,-70.483333,53,24,29,53,0,"AL",0.038
"11499",514,"199406.335.1260.6","NMFS",1994,10,27,300,30,42.216667,-70.466667,50,23,27,50,0,"AL",0.038
"11500",514,"199406.336.3610.3","NMFS",1994,10,27,300,30,42.166667,-70.466667,42,18,24,42,0,"AL",0.038
"11501",514,"199406.337.3610.2","NMFS",1994,10,27,300,30,42.083333,-70.333333,17,9,8,17,0,"AL",0.038
"11502",514,"199406.338.3600.2","NMFS",1994,10,27,300,30,41.983333,-70.2,27,7,20,27,0,"AL",0.038
"11503",514,"199406.339.3600.1","NMFS",1994,10,27,300,30,41.916667,-70.25,24,9,15,23,1,"AL",0.038
"11504",514,"199406.340.3580.1","NMFS",1994,10,27,300,30,41.883333,-70.15,0,0,0,0,0,"AL",0.038
"11505",514,"199406.341.3590.1","NMFS",1994,10,27,300,30,41.8,-70.383333,19,8,11,9,10,"AL",0.038
"11506",526,"199503.174.1100.1","NMFS",1995,4,7,97,30,40.216667,-69.933333,0,0,0,0,0,"AL",0.038
"11507",526,"199503.175.1100.5","NMFS",1995,4,7,97,30,40.333333,-69.833333,0,0,0,0,0,"AL",0.038
"11508",526,"199503.176.1100.7","NMFS",1995,4,7,97,30,40.25,-69.516667,1,0,1,1,0,"AL",0.038
"11509",526,"199503.177.1120.1","NMFS",1995,4,8,98,25,40.016667,-69.116667,1,1,0,1,0,"AL",0.038
"11510",526,"199503.178.1110.2","NMFS",1995,4,8,98,30,40.2,-68.966667,0,0,0,0,0,"AL",0.038
"11511",526,"199503.179.1110.1","NMFS",1995,4,8,98,30,40.116667,-68.95,0,0,0,0,0,"AL",0.038
"11512",525,"199503.180.1140.3","NMFS",1995,4,8,98,30,40.283333,-68.566667,0,0,0,0,0,"AL",0.038
"11513",525,"199503.181.1130.6","NMFS",1995,4,8,98,30,40.316667,-68.783333,0,0,0,0,0,"AL",0.038
"11514",526,"199503.182.1100.3","NMFS",1995,4,8,98,30,40.5,-68.883333,0,0,0,0,0,"AL",0.038
"11515",525,"199503.183.1130.3","NMFS",1995,4,8,98,30,40.666667,-68.45,0,0,0,0,0,"AL",0.038
"11516",525,"199503.184.1130.5","NMFS",1995,4,8,98,30,40.383333,-68.416667,0,0,0,0,0,"AL",0.038
"11517",525,"199503.185.1150.1","NMFS",1995,4,8,98,30,40.316667,-68.05,0,0,0,0,0,"AL",0.038
"11518",525,"199503.186.1140.2","NMFS",1995,4,8,98,30,40.4,-67.816667,0,0,0,0,0,"AL",0.038
"11519",525,"199503.187.1140.1","NMFS",1995,4,9,99,30,40.5,-67.3,0,0,0,0,0,"AL",0.038
"11520",525,"199503.188.1130.2","NMFS",1995,4,9,99,30,40.733333,-67.15,0,0,0,0,0,"AL",0.038
"11521",525,"199503.189.1130.9","NMFS",1995,4,9,99,30,40.633333,-67.433333,0,0,0,0,0,"AL",0.038
"11522",525,"199503.190.1130.8","NMFS",1995,4,9,99,30,40.733333,-67.516667,0,0,0,0,0,"AL",0.038
"11523",525,"199503.191.1130.7","NMFS",1995,4,9,99,30,40.883333,-67.866667,0,0,0,0,0,"AL",0.038
"11524",525,"199503.192.1190.9","NMFS",1995,4,9,99,30,41.05,-67.816667,0,0,0,0,0,"AL",0.038
"11525",525,"199503.193.1190.1","NMFS",1995,4,9,99,30,41.133333,-68.166667,0,0,0,0,0,"AL",0.038
"11526",522,"199503.194.1190.5","NMFS",1995,4,9,99,30,41.366667,-67.666667,0,0,0,0,0,"AL",0.038
"11527",522,"199503.195.1190.7","NMFS",1995,4,9,99,30,41.383333,-67.683333,0,0,0,0,0,"AL",0.038
"11528",522,"199503.196.1190.3","NMFS",1995,4,9,99,30,41.533333,-67.75,0,0,0,0,0,"AL",0.038
"11529",562,"199503.197.1190.2","NMFS",1995,4,9,99,30,41.55,-67.516667,0,0,0,0,0,"AL",0.038
"11530",562,"199503.198.1190.8","NMFS",1995,4,9,99,30,41.416667,-67.183333,0,0,0,0,0,"AL",0.038
"11531",562,"199503.199.1160.1","NMFS",1995,4,10,100,30,41.283333,-66.966667,0,0,0,0,0,"AL",0.038
"11532",562,"199503.200.1160.6","NMFS",1995,4,10,100,30,41.183333,-67.233333,0,0,0,0,0,"AL",0.038
"11533",525,"199503.201.1130.1","NMFS",1995,4,10,100,30,41.1,-67.433333,1,0,1,1,0,"AL",0.038
"11534",525,"199503.202.1130.4","NMFS",1995,4,10,100,30,41.116667,-67.283333,0,0,0,0,0,"AL",0.038
"11535",562,"199503.203.1160.3","NMFS",1995,4,10,100,30,41.083333,-66.883333,0,0,0,0,0,"AL",0.038
"11536",562,"199503.205.1180.1","NMFS",1995,4,10,100,30,41.033333,-66.433333,1,1,0,1,0,"AL",0.038
"11537",552,"199503.206.1160.2","NMFS",1995,4,10,100,30,41.483333,-66.15,0,0,0,0,0,"AL",0.038
"11538",552,"199503.208.1170.4","NMFS",1995,4,10,100,30,41.666667,-65.85,1,1,0,1,0,"AL",0.038
"11539",552,"199503.209.1170.3","NMFS",1995,4,10,100,30,41.816667,-65.766667,0,0,0,0,0,"AL",0.038
"11540",551,"199503.210.1160.4","NMFS",1995,4,11,101,30,41.883333,-66.016667,0,0,0,0,0,"AL",0.038
"11541",551,"199503.211.1170.2","NMFS",1995,4,11,101,25,42,-65.933333,0,0,0,0,0,"AL",0.038
"11542",551,"199503.212.1160.8","NMFS",1995,4,11,101,30,42.1,-66.116667,0,0,0,0,0,"AL",0.038
"11543",551,"199503.213.1220.3","NMFS",1995,4,11,101,30,42.116667,-66.033333,0,0,0,0,0,"AL",0.038
"11544",464,"199503.214.1290.5","NMFS",1995,4,11,101,30,42.166667,-65.883333,0,0,0,0,0,"AL",0.038
"11545",551,"199503.215.1220.1","NMFS",1995,4,11,101,30,42.15,-66.466667,0,0,0,0,0,"AL",0.038
"11546",551,"199503.216.1210.2","NMFS",1995,4,11,101,30,42.133333,-66.55,0,0,0,0,0,"AL",0.038
"11547",551,"199503.217.1210.3","NMFS",1995,4,11,101,30,42.15,-66.8,0,0,0,0,0,"AL",0.038
"11548",464,"199503.218.1300.2","NMFS",1995,4,11,101,30,42.35,-66.966667,0,0,0,0,0,"AL",0.038
"11549",464,"199503.219.1300.1","NMFS",1995,4,11,101,30,42.4,-67.016667,0,0,0,0,0,"AL",0.038
"11550",464,"199503.220.1290.2","NMFS",1995,4,11,101,30,42.633333,-66.883333,0,0,0,0,0,"AL",0.038
"11551",464,"199503.221.1300.3","NMFS",1995,4,11,101,30,42.516667,-67.25,2,1,1,2,0,"AL",0.038
"11552",551,"199503.222.1290.1","NMFS",1995,4,12,102,30,42.266667,-67.066667,0,0,0,0,0,"AL",0.038
"11553",551,"199503.223.1210.4","NMFS",1995,4,12,102,30,42.1,-66.95,0,0,0,0,0,"AL",0.038
"11554",551,"199503.224.1160.10","NMFS",1995,4,12,102,30,41.966667,-66.783333,0,0,0,0,0,"AL",0.038
"11555",551,"199503.225.1160.7","NMFS",1995,4,12,102,30,41.916667,-66.816667,0,0,0,0,0,"AL",0.038
"11556",562,"199503.226.1160.5","NMFS",1995,4,12,102,30,41.833333,-66.95,2,2,0,2,0,"AL",0.038
"11557",562,"199503.227.1190.6","NMFS",1995,4,12,102,30,41.8,-67.116667,3,3,0,3,0,"AL",0.038
"11558",561,"199503.228.1190.4","NMFS",1995,4,12,102,30,41.9,-67.133333,0,0,0,0,0,"AL",0.038
"11559",561,"199503.229.1200.3","NMFS",1995,4,12,102,30,41.866667,-67.366667,0,0,0,0,0,"AL",0.038
"11560",561,"199503.230.1200.4","NMFS",1995,4,12,102,30,41.866667,-67.416667,0,0,0,0,0,"AL",0.038
"11561",522,"199503.231.1220.2","NMFS",1995,4,12,102,30,42.083333,-67.683333,1,1,0,1,0,"AL",0.038
"11562",522,"199503.232.1220.4","NMFS",1995,4,12,102,30,42.016667,-67.833333,0,0,0,0,0,"AL",0.038
"11563",522,"199503.233.1210.1","NMFS",1995,4,12,102,30,41.866667,-68,0,0,0,0,0,"AL",0.038
"11564",522,"199503.234.1200.2","NMFS",1995,4,12,102,30,41.783333,-67.766667,0,0,0,0,0,"AL",0.038
"11565",522,"199503.236.1200.7","NMFS",1995,4,13,103,30,41.666667,-68.05,0,0,0,0,0,"AL",0.038
"11566",522,"199503.237.1200.5","NMFS",1995,4,13,103,30,41.666667,-68.15,1,0,1,1,0,"AL",0.038
"11567",522,"199503.238.1230.3","NMFS",1995,4,13,103,30,41.55,-68.45,0,0,0,0,0,"AL",0.038
"11568",522,"199503.239.1230.2","NMFS",1995,4,13,103,30,41.416667,-68.366667,0,0,0,0,0,"AL",0.038
"11569",522,"199503.240.1230.5","NMFS",1995,4,13,103,30,41.333333,-68.583333,0,0,0,0,0,"AL",0.038
"11570",522,"199503.241.1200.1","NMFS",1995,4,13,103,30,41.1,-68.583333,0,0,0,0,0,"AL",0.038
"11571",526,"199503.243.1100.6","NMFS",1995,4,13,103,30,40.8,-69.066667,0,0,0,0,0,"AL",0.038
"11572",526,"199503.244.1100.8","NMFS",1995,4,13,103,30,40.883333,-69.183333,0,0,0,0,0,"AL",0.038
"11573",526,"199503.245.1090.4","NMFS",1995,4,13,103,30,40.866667,-69.283333,0,0,0,0,0,"AL",0.038
"11574",526,"199503.246.1090.2","NMFS",1995,4,14,104,30,40.85,-69.6,0,0,0,0,0,"AL",0.038
"11575",526,"199503.247.3550.2","NMFS",1995,4,14,104,30,41,-69.733333,0,0,0,0,0,"AL",0.038
"11576",521,"199503.248.1250.1","NMFS",1995,4,14,104,30,41.266667,-69.4,0,0,0,0,0,"AL",0.038
"11577",521,"199503.249.3550.3","NMFS",1995,4,14,104,30,41.333333,-69.483333,0,0,0,0,0,"AL",0.038
"11578",521,"199503.250.3550.5","NMFS",1995,4,14,104,30,41.366667,-69.566667,1,0,1,1,0,"AL",0.038
"11579",521,"199503.251.3550.4","NMFS",1995,4,14,104,21,41.433333,-69.7,1,1,0,1,0,"AL",0.038
"11580",521,"199503.252.1250.4","NMFS",1995,4,18,108,30,41.55,-69.583333,0,0,0,0,0,"AL",0.038
"11581",521,"199503.253.1230.1","NMFS",1995,4,18,108,30,41.466667,-69.366667,0,0,0,0,0,"AL",0.038
"11582",521,"199503.254.1250.2","NMFS",1995,4,18,108,30,41.633333,-69.716667,0,0,0,0,0,"AL",0.038
"11583",521,"199503.256.3560.1","NMFS",1995,4,18,108,30,41.766667,-69.883333,0,0,0,0,0,"AL",0.038
"11584",521,"199503.259.1240.5","NMFS",1995,4,18,108,30,41.833333,-69.45,0,0,0,0,0,"AL",0.038
"11585",521,"199503.260.1280.2","NMFS",1995,4,19,109,30,41.916667,-69.3,0,0,0,0,0,"AL",0.038
"11586",521,"199503.261.1240.6","NMFS",1995,4,19,109,30,41.616667,-69.033333,0,0,0,0,0,"AL",0.038
"11587",522,"199503.262.1290.8","NMFS",1995,4,19,109,30,41.8,-68.483333,0,0,0,0,0,"AL",0.038
"11588",522,"199503.263.1240.1","NMFS",1995,4,19,109,30,41.883333,-68.466667,0,0,0,0,0,"AL",0.038
"11589",522,"199503.264.1240.2","NMFS",1995,4,19,109,30,42.016667,-68.766667,0,0,0,0,0,"AL",0.038
"11590",521,"199503.265.1240.4","NMFS",1995,4,19,109,30,42.133333,-68.916667,0,0,0,0,0,"AL",0.038
"11591",521,"199503.266.1240.3","NMFS",1995,4,19,109,30,42.25,-69.05,0,0,0,0,0,"AL",0.038
"11592",521,"199503.267.1280.3","NMFS",1995,4,20,110,30,42.2,-69.45,0,0,0,0,0,"AL",0.038
"11593",521,"199503.268.1280.7","NMFS",1995,4,20,110,30,42.266667,-69.333333,0,0,0,0,0,"AL",0.038
"11594",515,"199503.269.1280.4","NMFS",1995,4,20,110,30,42.4,-69.166667,0,0,0,0,0,"AL",0.038
"11595",515,"199503.270.1280.5","NMFS",1995,4,20,110,30,42.433333,-68.65,0,0,0,0,0,"AL",0.038
"11596",522,"199503.271.1290.7","NMFS",1995,4,20,110,30,42.116667,-68.15,0,0,0,0,0,"AL",0.038
"11597",522,"199503.272.1290.3","NMFS",1995,4,20,110,30,42.316667,-67.9,1,0,1,1,0,"AL",0.038
"11598",515,"199503.273.1290.6","NMFS",1995,4,20,110,30,42.55,-67.85,0,0,0,0,0,"AL",0.038
"11599",515,"199503.274.1360.1","NMFS",1995,4,20,110,30,42.783333,-67.966667,3,2,1,3,0,"AL",0.038
"11600",515,"199503.275.1290.4","NMFS",1995,4,21,111,30,42.7,-68.4,0,0,0,0,0,"AL",0.038
"11601",515,"199503.276.1370.3","NMFS",1995,4,21,111,30,42.833333,-68.983333,0,0,0,0,0,"AL",0.038
"11602",515,"199503.277.1370.5","NMFS",1995,4,21,111,30,42.933333,-69.1,0,0,0,0,0,"AL",0.038
"11603",515,"199503.278.1370.2","NMFS",1995,4,21,111,30,42.933333,-68.683333,0,0,0,0,0,"AL",0.038
"11604",515,"199503.279.1370.1","NMFS",1995,4,21,111,30,42.866667,-68.5,1,1,0,1,0,"AL",0.038
"11605",465,"199503.280.1360.3","NMFS",1995,4,21,111,30,43.05,-67.6,2,2,0,2,0,"AL",0.038
"11606",465,"199503.281.1360.6","NMFS",1995,4,21,111,30,43.2,-67.483333,1,0,1,1,0,"AL",0.038
"11607",512,"199503.282.1360.4","NMFS",1995,4,21,111,30,43.4,-67.883333,0,0,0,0,0,"AL",0.038
"11608",465,"199503.283.1360.8","NMFS",1995,4,21,111,30,43.55,-67.633333,0,0,0,0,0,"AL",0.038
"11609",465,"199503.284.1360.7","NMFS",1995,4,22,112,30,43.433333,-67.433333,2,1,1,2,0,"AL",0.038
"11610",465,"199503.285.1340.3","NMFS",1995,4,22,112,30,43.216667,-66.933333,0,0,0,0,0,"AL",0.038
"11611",465,"199503.286.1330.2","NMFS",1995,4,22,112,30,43.316667,-66.3,1,1,0,1,0,"AL",0.038
"11612",465,"199503.287.1330.3","NMFS",1995,4,22,112,30,43.35,-66.566667,1,1,0,1,0,"AL",0.038
"11613",465,"199503.288.1340.1","NMFS",1995,4,22,112,30,43.516667,-66.766667,3,3,0,3,0,"AL",0.038
"11614",465,"199503.289.1330.4","NMFS",1995,4,22,112,30,43.733333,-66.55,2,2,0,2,0,"AL",0.038
"11615",465,"199503.290.1340.4","NMFS",1995,4,22,112,30,43.666667,-67.016667,4,2,2,4,0,"AL",0.038
"11616",465,"199503.291.1360.5","NMFS",1995,4,22,112,30,43.75,-67.416667,1,1,0,1,0,"AL",0.038
"11617",511,"199503.292.1360.2","NMFS",1995,4,23,113,30,43.866667,-67.5,0,0,0,0,0,"AL",0.038
"11618",511,"199503.293.1340.2","NMFS",1995,4,23,113,30,43.966667,-67.15,0,0,0,0,0,"AL",0.038
"11619",511,"199503.294.1340.5","NMFS",1995,4,23,113,30,44,-67.183333,0,0,0,0,0,"AL",0.038
"11620",511,"199503.295.1340.6","NMFS",1995,4,23,113,30,44.133333,-67.266667,0,0,0,0,0,"AL",0.038
"11621",466,"199503.296.1330.1","NMFS",1995,4,23,113,30,44.183333,-66.55,4,2,2,4,0,"AL",0.038
"11622",466,"199503.297.1351.1","NMFS",1995,4,23,113,30,44.3,-66.733333,0,0,0,0,0,"AL",0.038
"11623",466,"199503.298.1351.2","NMFS",1995,4,23,113,30,44.316667,-66.783333,0,0,0,0,0,"AL",0.038
"11624",511,"199503.299.1380.4","NMFS",1995,4,23,113,30,44.316667,-67.5,2,0,2,2,0,"AL",0.038
"11625",511,"199503.300.1390.1","NMFS",1995,4,23,113,30,44.333333,-67.716667,0,0,0,0,0,"AL",0.038
"11626",512,"199503.301.1390.4","NMFS",1995,4,23,113,30,44.083333,-68.1,0,0,0,0,0,"AL",0.038
"11627",512,"199503.302.1390.5","NMFS",1995,4,24,114,30,43.966667,-68.316667,0,0,0,0,0,"AL",0.038
"11628",512,"199503.303.1390.3","NMFS",1995,4,24,114,30,43.95,-68.45,0,0,0,0,0,"AL",0.038
"11629",512,"199503.304.1380.5","NMFS",1995,4,24,114,30,43.7,-68.166667,1,0,1,1,0,"AL",0.038
"11630",512,"199503.305.1380.1","NMFS",1995,4,24,114,30,43.65,-68.466667,0,0,0,0,0,"AL",0.038
"11631",512,"199503.307.1390.6","NMFS",1995,4,24,114,30,43.633333,-68.933333,0,0,0,0,0,"AL",0.038
"11632",512,"199503.308.1380.3","NMFS",1995,4,24,114,30,43.516667,-68.966667,2,1,1,2,0,"AL",0.038
"11633",513,"199503.310.1380.6","NMFS",1995,4,24,114,28,43.6,-69.283333,2,2,0,2,0,"AL",0.038
"11634",513,"199503.311.1400.2","NMFS",1995,4,24,114,30,43.733333,-69.45,2,1,1,2,0,"AL",0.038
"11635",513,"199503.312.1400.3","NMFS",1995,4,25,115,30,43.483333,-70.066667,1,1,0,1,0,"AL",0.038
"11636",513,"199503.313.1370.4","NMFS",1995,4,25,115,30,43.116667,-69.533333,0,0,0,0,0,"AL",0.038
"11637",513,"199503.314.1270.3","NMFS",1995,4,25,115,30,43.1,-70.25,0,0,0,0,0,"AL",0.038
"11638",513,"199503.315.1400.1","NMFS",1995,4,25,115,30,43.116667,-70.366667,6,2,4,6,0,"AL",0.038
"11639",513,"199503.316.1270.4","NMFS",1995,4,25,115,30,43.016667,-70.316667,1,1,0,1,0,"AL",0.038
"11640",514,"199503.317.3660.1","NMFS",1995,4,25,115,30,42.8,-70.683333,0,0,0,0,0,"AL",0.038
"11641",514,"199503.318.1270.1","NMFS",1995,4,25,115,30,42.766667,-70,0,0,0,0,0,"AL",0.038
"11642",514,"199503.319.1270.2","NMFS",1995,4,25,115,30,42.6,-69.95,0,0,0,0,0,"AL",0.038
"11643",514,"199503.320.1280.6","NMFS",1995,4,26,116,30,42.483333,-69.716667,0,0,0,0,0,"AL",0.038
"11644",514,"199503.321.1280.1","NMFS",1995,4,26,116,30,42.366667,-69.916667,0,0,0,0,0,"AL",0.038
"11645",514,"199503.322.1260.5","NMFS",1995,4,26,116,30,42.4,-70.15,1,1,0,1,0,"AL",0.038
"11646",514,"199503.323.1260.3","NMFS",1995,4,26,116,30,42.466667,-70.533333,6,4,2,6,0,"AL",0.038
"11647",514,"199503.324.1260.4","NMFS",1995,4,26,116,30,42.5,-70.616667,38,16,22,38,0,"AL",0.038
"11648",514,"199503.325.3640.1","NMFS",1995,4,26,116,28,42.6,-70.583333,0,0,0,0,0,"AL",0.038
"11649",514,"199503.326.3660.2","NMFS",1995,4,26,116,30,42.5,-70.633333,23,10,13,23,0,"AL",0.038
"11650",514,"199503.327.3650.1","NMFS",1995,4,26,116,25,42.333333,-70.716667,54,19,35,54,0,"AL",0.038
"11651",514,"199503.328.1260.1","NMFS",1995,4,26,116,30,42.216667,-70.183333,0,0,0,0,0,"AL",0.038
"11652",514,"199503.329.1260.2","NMFS",1995,4,26,116,30,42.15,-70.383333,7,0,7,7,0,"AL",0.038
"11653",514,"199503.330.3610.1","NMFS",1995,4,27,117,30,42.116667,-70.483333,34,12,22,33,1,"AL",0.038
"11654",514,"199503.331.3610.2","NMFS",1995,4,27,117,30,42.016667,-70.383333,90,26,64,86,4,"AL",0.038
"11655",514,"199503.332.3600.1","NMFS",1995,4,27,117,30,41.9,-70.383333,41,13,28,39,2,"AL",0.038
"11656",514,"199503.333.3600.2","NMFS",1995,4,27,117,30,41.916667,-70.233333,10,3,7,9,1,"AL",0.038
"11657",514,"199503.334.3590.1","NMFS",1995,4,27,117,30,41.85,-70.216667,4,2,2,3,1,"AL",0.038
"11658",514,"199503.335.3580.1","NMFS",1995,4,27,117,30,41.816667,-70.133333,5,2,3,3,2,"AL",0.038
"11659",526,"199507.178.1110.1","NMFS",1995,9,26,269,30,39.983333,-69.85,2,2,0,2,0,"AL",0.038
"11660",526,"199507.179.1100.1","NMFS",1995,9,26,269,30,40.4,-69.766667,0,0,0,0,0,"AL",0.038
"11661",526,"199507.180.1090.3","NMFS",1995,9,26,269,30,40.65,-69.6,0,0,0,0,0,"AL",0.038
"11662",526,"199507.181.1100.4","NMFS",1995,9,26,269,30,40.466667,-69.533333,0,0,0,0,0,"AL",0.038
"11663",526,"199507.182.1100.2","NMFS",1995,9,26,269,30,40.15,-69.25,0,0,0,0,0,"AL",0.038
"11664",526,"199507.183.1110.2","NMFS",1995,9,26,269,30,40.1,-69.183333,0,0,0,0,0,"AL",0.038
"11665",526,"199507.184.1100.3","NMFS",1995,9,26,269,30,40.766667,-68.95,1,1,0,1,0,"AL",0.038
"11666",526,"199507.185.1100.5","NMFS",1995,9,27,270,30,40.766667,-69.066667,0,0,0,0,0,"AL",0.038
"11667",526,"199507.186.1100.8","NMFS",1995,9,27,270,30,40.766667,-69.15,0,0,0,0,0,"AL",0.038
"11668",526,"199507.187.3550.4","NMFS",1995,9,27,270,30,41.05,-69.716667,0,0,0,0,0,"AL",0.038
"11669",526,"199507.188.3550.5","NMFS",1995,9,27,270,30,41.033333,-69.6,0,0,0,0,0,"AL",0.038
"11670",526,"199507.189.3550.2","NMFS",1995,9,27,270,30,40.983333,-69.433333,0,0,0,0,0,"AL",0.038
"11671",521,"199507.190.1250.1","NMFS",1995,9,27,270,30,41.216667,-69.316667,0,0,0,0,0,"AL",0.038
"11672",521,"199507.191.1230.5","NMFS",1995,9,27,270,30,41.266667,-69.3,0,0,0,0,0,"AL",0.038
"11673",521,"199507.192.3550.3","NMFS",1995,9,27,270,30,41.316667,-69.55,12,8,4,12,0,"AL",0.038
"11674",521,"199507.195.1250.4","NMFS",1995,9,27,270,30,41.566667,-69.633333,1,1,0,1,0,"AL",0.038
"11675",521,"199507.196.3550.1","NMFS",1995,9,28,271,30,41.533333,-69.783333,0,0,0,0,0,"AL",0.038
"11676",521,"199507.197.1240.5","NMFS",1995,9,28,271,30,41.533333,-69.266667,0,0,0,0,0,"AL",0.038
"11677",521,"199507.198.1240.1","NMFS",1995,9,28,271,30,41.733333,-69.133333,0,0,0,0,0,"AL",0.038
"11678",521,"199507.199.1240.3","NMFS",1995,9,28,271,30,41.633333,-69.316667,0,0,0,0,0,"AL",0.038
"11679",521,"199507.200.1230.3","NMFS",1995,9,28,271,30,41.6,-69.45,1,0,1,1,0,"AL",0.038
"11680",521,"199507.201.1250.3","NMFS",1995,9,28,271,30,41.6,-69.716667,4,3,1,4,0,"AL",0.038
"11681",521,"199507.203.1230.6","NMFS",1995,9,28,271,30,41.75,-69.75,1,0,1,1,0,"AL",0.038
"11682",521,"199507.204.3560.1","NMFS",1995,9,28,271,30,41.75,-69.883333,0,0,0,0,0,"AL",0.038
"11683",522,"199507.205.1240.6","NMFS",1995,10,3,276,30,41.383333,-68.766667,0,0,0,0,0,"AL",0.038
"11684",521,"199507.206.1230.2","NMFS",1995,10,3,276,30,41.266667,-68.883333,0,0,0,0,0,"AL",0.038
"11685",522,"199507.207.1230.4","NMFS",1995,10,3,276,30,41.216667,-68.7,0,0,0,0,0,"AL",0.038
"11686",522,"199507.208.1200.4","NMFS",1995,10,3,276,30,41.333333,-68.2,1,1,0,1,0,"AL",0.038
"11687",525,"199507.209.1190.9","NMFS",1995,10,3,276,30,41.283333,-68.05,6,2,4,6,0,"AL",0.038
"11688",525,"199507.210.1190.8","NMFS",1995,10,3,276,30,40.983333,-67.866667,0,0,0,0,0,"AL",0.038
"11689",525,"199507.211.1190.6","NMFS",1995,10,3,276,30,41.016667,-68.3,1,1,0,1,0,"AL",0.038
"11690",522,"199507.212.1190.7","NMFS",1995,10,4,277,30,41.133333,-68.466667,0,0,0,0,0,"AL",0.038
"11691",522,"199507.213.1190.1","NMFS",1995,10,4,277,30,41.016667,-68.55,0,0,0,0,0,"AL",0.038
"11692",525,"199507.214.1130.1","NMFS",1995,10,4,277,30,40.75,-68.8,0,0,0,0,0,"AL",0.038
"11693",525,"199507.215.1130.8","NMFS",1995,10,4,277,30,40.416667,-68.583333,0,0,0,0,0,"AL",0.038
"11694",525,"199507.216.1130.4","NMFS",1995,10,4,277,30,40.366667,-68.583333,1,1,0,1,0,"AL",0.038
"11695",525,"199507.217.1140.3","NMFS",1995,10,4,277,30,40.233333,-68.7,1,0,1,1,0,"AL",0.038
"11696",525,"199507.218.1140.1","NMFS",1995,10,4,277,30,40.316667,-68.466667,0,0,0,0,0,"AL",0.038
"11697",525,"199507.219.1130.2","NMFS",1995,10,4,277,30,40.516667,-68.25,1,1,0,1,0,"AL",0.038
"11698",525,"199507.220.1130.5","NMFS",1995,10,4,277,30,40.65,-68.166667,0,0,0,0,0,"AL",0.038
"11699",525,"199507.221.1130.9","NMFS",1995,10,4,277,30,40.683333,-67.95,0,0,0,0,0,"AL",0.038
"11700",525,"199507.222.1130.6","NMFS",1995,10,4,277,30,40.516667,-68.016667,0,0,0,0,0,"AL",0.038
"11701",525,"199507.223.1140.2","NMFS",1995,10,4,277,30,40.416667,-68.066667,0,0,0,0,0,"AL",0.038
"11702",525,"199507.224.1150.1","NMFS",1995,10,5,278,30,40.483333,-67.266667,0,0,0,0,0,"AL",0.038
"11703",562,"199507.225.1130.7","NMFS",1995,10,5,278,30,40.85,-66.983333,3,3,0,3,0,"AL",0.038
"11704",562,"199507.226.1160.9","NMFS",1995,10,5,278,30,40.866667,-66.816667,0,0,0,0,0,"AL",0.038
"11705",562,"199507.227.1160.6","NMFS",1995,10,5,278,30,41.016667,-66.816667,1,1,0,1,0,"AL",0.038
"11706",562,"199507.228.1160.1","NMFS",1995,10,5,278,30,41.283333,-67.066667,1,1,0,1,0,"AL",0.038
"11707",525,"199507.229.1130.3","NMFS",1995,10,5,278,30,41.066667,-67.516667,1,1,0,1,0,"AL",0.038
"11708",522,"199507.231.1200.6","NMFS",1995,10,5,278,30,41.683333,-67.85,1,0,1,1,0,"AL",0.038
"11709",522,"199507.232.1200.1","NMFS",1995,10,5,278,30,41.616667,-68.216667,1,1,0,1,0,"AL",0.038
"11710",522,"199507.233.1200.2","NMFS",1995,10,6,279,30,41.8,-68,0,0,0,0,0,"AL",0.038
"11711",522,"199507.234.1220.4","NMFS",1995,10,6,279,30,41.933333,-68.033333,1,1,0,1,0,"AL",0.038
"11712",522,"199507.235.1290.5","NMFS",1995,10,6,279,30,42.1,-68.033333,0,0,0,0,0,"AL",0.038
"11713",522,"199507.236.1290.1","NMFS",1995,10,6,279,30,42.033333,-68.133333,1,0,1,1,0,"AL",0.038
"11714",522,"199507.237.1220.3","NMFS",1995,10,6,279,30,41.85,-68.266667,1,0,1,1,0,"AL",0.038
"11715",522,"199507.238.1290.9","NMFS",1995,10,6,279,30,41.783333,-68.416667,0,0,0,0,0,"AL",0.038
"11716",522,"199507.239.1240.4","NMFS",1995,10,6,279,30,41.816667,-68.716667,0,0,0,0,0,"AL",0.038
"11717",522,"199507.240.1220.2","NMFS",1995,10,6,279,30,41.766667,-68.366667,0,0,0,0,0,"AL",0.038
"11718",522,"199507.241.1240.2","NMFS",1995,10,6,279,30,42.316667,-68.516667,0,0,0,0,0,"AL",0.038
"11719",515,"199507.242.1290.2","NMFS",1995,10,7,280,30,42.433333,-68.383333,0,0,0,0,0,"AL",0.038
"11720",515,"199507.243.1290.3","NMFS",1995,10,7,280,30,42.516667,-67.966667,2,1,1,2,0,"AL",0.038
"11721",515,"199507.244.1290.6","NMFS",1995,10,7,280,30,42.6,-67.766667,1,0,1,1,0,"AL",0.038
"11722",464,"199507.245.1300.2","NMFS",1995,10,7,280,30,42.516667,-67.283333,0,0,0,0,0,"AL",0.038
"11723",522,"199507.246.1290.8","NMFS",1995,10,7,280,30,42.3,-67.683333,0,0,0,0,0,"AL",0.038
"11724",561,"199507.247.1290.4","NMFS",1995,10,7,280,30,42.266667,-67.616667,0,0,0,0,0,"AL",0.038
"11725",561,"199507.248.1220.1","NMFS",1995,10,7,280,30,42.116667,-67.616667,1,1,0,1,0,"AL",0.038
"11726",561,"199507.249.1210.2","NMFS",1995,10,7,280,30,42.133333,-67.316667,1,1,0,1,0,"AL",0.038
"11727",561,"199507.250.1210.4","NMFS",1995,10,7,280,30,42.1,-67.116667,0,0,0,0,0,"AL",0.038
"11728",561,"199507.251.1200.3","NMFS",1995,10,7,280,30,41.983333,-67.466667,2,2,0,2,0,"AL",0.038
"11729",561,"199507.252.1200.5","NMFS",1995,10,8,281,30,41.916667,-67.633333,0,0,0,0,0,"AL",0.038
"11730",562,"199507.253.1190.3","NMFS",1995,10,8,281,30,41.75,-67.483333,2,2,0,2,0,"AL",0.038
"11731",562,"199507.254.1190.5","NMFS",1995,10,8,281,30,41.816667,-67.183333,3,2,1,3,0,"AL",0.038
"11732",562,"199507.255.1190.4","NMFS",1995,10,8,281,30,41.8,-67.05,1,0,1,1,0,"AL",0.038
"11733",562,"199507.256.1190.2","NMFS",1995,10,8,281,30,41.55,-67.183333,1,0,1,1,0,"AL",0.038
"11734",562,"199507.257.1160.5","NMFS",1995,10,8,281,30,41.45,-67.1,2,2,0,2,0,"AL",0.038
"11735",562,"199507.258.1160.4","NMFS",1995,10,8,281,30,41.616667,-66.8,5,4,1,5,0,"AL",0.038
"11736",562,"199507.259.1160.8","NMFS",1995,10,8,281,30,41.483333,-66.883333,0,0,0,0,0,"AL",0.038
"11737",562,"199507.260.1160.10","NMFS",1995,10,8,281,30,41.433333,-66.716667,0,0,0,0,0,"AL",0.038
"11738",552,"199507.262.1160.7","NMFS",1995,10,8,281,30,41.45,-66.316667,0,0,0,0,0,"AL",0.038
"11739",552,"199507.263.1170.2","NMFS",1995,10,9,282,30,41.4,-66.066667,1,1,0,1,0,"AL",0.038
"11740",552,"199507.264.1170.1","NMFS",1995,10,9,282,30,41.766667,-65.833333,0,0,0,0,0,"AL",0.038
"11741",551,"199507.265.1180.1","NMFS",1995,10,9,282,30,41.933333,-65.816667,0,0,0,0,0,"AL",0.038
"11742",551,"199507.266.1170.3","NMFS",1995,10,9,282,30,42.016667,-65.966667,0,0,0,0,0,"AL",0.038
"11743",551,"199507.267.1160.2","NMFS",1995,10,9,282,30,42.066667,-66.066667,0,0,0,0,0,"AL",0.038
"11744",551,"199507.268.1210.1","NMFS",1995,10,9,282,30,42.1,-66.216667,0,0,0,0,0,"AL",0.038
"11745",551,"199507.270.1210.5","NMFS",1995,10,10,283,30,42.1,-66.366667,0,0,0,0,0,"AL",0.038
"11746",551,"199507.271.1160.3","NMFS",1995,10,10,283,30,42.066667,-66.416667,0,0,0,0,0,"AL",0.038
"11747",551,"199507.272.1160.12","NMFS",1995,10,10,283,30,41.933333,-66.8,0,0,0,0,0,"AL",0.038
"11748",551,"199507.273.1300.1","NMFS",1995,10,10,283,30,42.316667,-66.683333,0,0,0,0,0,"AL",0.038
"11749",464,"199507.274.1300.3","NMFS",1995,10,10,283,30,42.416667,-66.616667,0,0,0,0,0,"AL",0.038
"11750",464,"199507.275.1290.7","NMFS",1995,10,10,283,30,42.533333,-66.233333,1,0,1,1,0,"AL",0.038
"11751",465,"199507.276.1340.2","NMFS",1995,10,10,283,30,43.116667,-67.033333,2,1,1,2,0,"AL",0.038
"11752",465,"199507.277.1360.6","NMFS",1995,10,11,284,30,43.45,-67.183333,0,0,0,0,0,"AL",0.038
"11753",465,"199507.278.1340.5","NMFS",1995,10,11,284,30,43.266667,-66.816667,3,2,1,3,0,"AL",0.038
"11754",465,"199507.279.1330.2","NMFS",1995,10,11,284,25,43.3,-66.25,4,3,1,3,1,"AL",0.038
"11755",465,"199507.280.1330.4","NMFS",1995,10,11,284,30,43.566667,-66.366667,10,5,5,10,0,"AL",0.038
"11756",465,"199507.281.1340.6","NMFS",1995,10,11,284,30,43.7,-66.883333,1,0,1,1,0,"AL",0.038
"11757",511,"199507.282.1340.3","NMFS",1995,10,11,284,30,43.883333,-66.9,0,0,0,0,0,"AL",0.038
"11758",465,"199507.283.1330.3","NMFS",1995,10,11,284,30,43.983333,-66.55,0,0,0,0,0,"AL",0.038
"11759",465,"199507.284.1340.1","NMFS",1995,10,11,284,30,44,-66.766667,1,1,0,1,0,"AL",0.038
"11760",466,"199507.285.1330.1","NMFS",1995,10,11,284,30,44.15,-66.716667,2,1,1,2,0,"AL",0.038
"11761",511,"199507.286.1351.2","NMFS",1995,10,12,285,30,44.333333,-67,0,0,0,0,0,"AL",0.038
"11762",511,"199507.287.1351.1","NMFS",1995,10,12,285,30,44.183333,-67.116667,1,1,0,1,0,"AL",0.038
"11763",511,"199507.288.1340.4","NMFS",1995,10,12,285,30,44.083333,-67.216667,1,1,0,1,0,"AL",0.038
"11764",511,"199507.289.1390.4","NMFS",1995,10,12,285,30,44.333333,-67.516667,0,0,0,0,0,"AL",0.038
"11765",512,"199507.290.1390.3","NMFS",1995,10,12,285,30,44.066667,-68.033333,0,0,0,0,0,"AL",0.038
"11766",521,"199507.291.1280.2","NMFS",1995,10,12,285,30,42.3,-69.033333,0,0,0,0,0,"AL",0.038
"11767",521,"199507.292.1280.1","NMFS",1995,10,13,286,30,42.05,-69.316667,0,0,0,0,0,"AL",0.038
"11768",514,"199507.293.1260.3","NMFS",1995,10,17,290,30,42.316667,-70.116667,0,0,0,0,0,"AL",0.038
"11769",514,"199507.294.1270.4","NMFS",1995,10,17,290,30,42.25,-70,0,0,0,0,0,"AL",0.038
"11770",514,"199507.295.3610.1","NMFS",1995,10,17,290,30,42.116667,-70.166667,9,3,6,9,0,"AL",0.038
"11771",514,"199507.296.3600.2","NMFS",1995,10,17,290,30,42.016667,-70.166667,1,1,0,1,0,"AL",0.038
"11772",514,"199507.297.3600.1","NMFS",1995,10,17,290,30,41.95,-70.5,107,54,53,70,37,"AL",0.038
"11773",514,"199507.298.1260.2","NMFS",1995,10,18,291,30,42.416667,-70.633333,126,38,88,126,0,"AL",0.038
"11774",514,"199507.299.1260.4","NMFS",1995,10,18,291,30,42.533333,-70.333333,0,0,0,0,0,"AL",0.038
"11775",514,"199507.300.1280.7","NMFS",1995,10,18,291,30,42.566667,-69.8,0,0,0,0,0,"AL",0.038
"11776",514,"199507.301.1270.3","NMFS",1995,10,18,291,30,42.533333,-69.933333,0,0,0,0,0,"AL",0.038
"11777",514,"199507.302.1280.4","NMFS",1995,10,18,291,30,42.45,-69.883333,0,0,0,0,0,"AL",0.038
"11778",515,"199507.303.1280.5","NMFS",1995,10,18,291,30,42.366667,-69.616667,0,0,0,0,0,"AL",0.038
"11779",515,"199507.304.1280.3","NMFS",1995,10,18,291,30,42.583333,-69.483333,0,0,0,0,0,"AL",0.038
"11780",515,"199507.305.1280.6","NMFS",1995,10,18,291,30,42.566667,-69.316667,0,0,0,0,0,"AL",0.038
"11781",513,"199507.306.1370.6","NMFS",1995,10,19,292,30,42.9,-69.45,0,0,0,0,0,"AL",0.038
"11782",513,"199507.307.1270.2","NMFS",1995,10,19,292,30,43.033333,-70.016667,0,0,0,0,0,"AL",0.038
"11783",513,"199507.308.1270.1","NMFS",1995,10,19,292,30,43.016667,-70.216667,0,0,0,0,0,"AL",0.038
"11784",514,"199507.310.1260.6","NMFS",1995,10,19,292,30,42.8,-70.283333,1,0,1,0,1,"AL",0.038
"11785",514,"199507.311.1260.1","NMFS",1995,10,19,292,30,42.766667,-70.433333,2,2,0,2,0,"AL",0.038
"11786",514,"199507.312.1400.3","NMFS",1995,10,19,292,30,42.816667,-70.633333,17,9,8,17,0,"AL",0.038
"11787",514,"199507.313.3660.1","NMFS",1995,10,19,292,30,42.833333,-70.666667,5,2,3,5,0,"AL",0.038
"11788",513,"199507.314.1400.2","NMFS",1995,10,19,292,30,43.533333,-69.933333,3,3,0,3,0,"AL",0.038
"11789",513,"199507.315.1380.7","NMFS",1995,10,20,293,30,43.4,-69.683333,1,0,1,1,0,"AL",0.038
"11790",513,"199507.316.1370.4","NMFS",1995,10,20,293,30,43.183333,-69.316667,0,0,0,0,0,"AL",0.038
"11791",515,"199507.317.1370.2","NMFS",1995,10,20,293,30,43.116667,-69.1,0,0,0,0,0,"AL",0.038
"11792",515,"199507.318.1370.5","NMFS",1995,10,20,293,30,43.05,-69.116667,0,0,0,0,0,"AL",0.038
"11793",515,"199507.319.1370.1","NMFS",1995,10,20,293,30,43.066667,-68.916667,0,0,0,0,0,"AL",0.038
"11794",515,"199507.320.1370.3","NMFS",1995,10,20,293,30,43.116667,-68.816667,0,0,0,0,0,"AL",0.038
"11795",515,"199507.321.1360.2","NMFS",1995,10,20,293,30,43.033333,-68.45,0,0,0,0,0,"AL",0.038
"11796",515,"199507.322.1360.5","NMFS",1995,10,20,293,30,43.266667,-68.483333,0,0,0,0,0,"AL",0.038
"11797",512,"199507.323.1380.5","NMFS",1995,10,20,293,30,43.35,-68.533333,0,0,0,0,0,"AL",0.038
"11798",512,"199507.324.1380.1","NMFS",1995,10,20,293,30,43.4,-68.9,0,0,0,0,0,"AL",0.038
"11799",513,"199507.325.1380.2","NMFS",1995,10,20,293,30,43.45,-69.183333,0,0,0,0,0,"AL",0.038
"11800",513,"199507.326.1380.3","NMFS",1995,10,21,294,30,43.566667,-69.116667,0,0,0,0,0,"AL",0.038
"11801",512,"199507.327.1400.1","NMFS",1995,10,21,294,30,43.783333,-69.233333,25,12,13,25,0,"AL",0.038
"11802",513,"199507.328.1380.4","NMFS",1995,10,22,295,30,43.566667,-69.416667,2,2,0,2,0,"AL",0.038
"11803",512,"199507.329.1390.5","NMFS",1995,10,23,296,30,43.916667,-68.783333,61,20,41,60,1,"AL",0.038
"11804",512,"199507.330.1390.2","NMFS",1995,10,23,296,30,43.933333,-68.516667,8,3,5,8,0,"AL",0.038
"11805",512,"199507.331.1390.1","NMFS",1995,10,23,296,30,43.916667,-68.433333,0,0,0,0,0,"AL",0.038
"11806",512,"199507.332.1380.6","NMFS",1995,10,23,296,30,43.683333,-68.35,1,1,0,1,0,"AL",0.038
"11807",512,"199507.333.1360.7","NMFS",1995,10,23,296,30,43.483333,-67.866667,0,0,0,0,0,"AL",0.038
"11808",512,"199507.334.1360.3","NMFS",1995,10,23,296,30,43.483333,-68.1,0,0,0,0,0,"AL",0.038
"11809",515,"199507.335.1360.4","NMFS",1995,10,24,297,30,43.283333,-68.083333,0,0,0,0,0,"AL",0.038
"11810",515,"199507.336.1360.8","NMFS",1995,10,24,297,30,43.083333,-67.883333,0,0,0,0,0,"AL",0.038
"11811",515,"199507.337.1360.1","NMFS",1995,10,24,297,30,43,-68.1,0,0,0,0,0,"AL",0.038
"11812",526,"199602.194.1100.6","NMFS",1996,4,7,98,30,40.6,-69.95,0,0,0,0,0,"AL",0.038
"11813",514,"199602.196.3580.1","NMFS",1996,4,7,98,30,41.866667,-70.166667,0,0,0,0,0,"AL",0.038
"11814",514,"199602.197.3600.2","NMFS",1996,4,7,98,30,41.9,-70.216667,0,0,0,0,0,"AL",0.038
"11815",514,"199602.198.3610.2","NMFS",1996,4,7,98,30,42.016667,-70.35,26,9,17,26,0,"AL",0.038
"11816",514,"199602.199.3610.1","NMFS",1996,4,8,99,30,42.1,-70.45,81,44,37,75,6,"AL",0.038
"11817",514,"199602.200.3600.1","NMFS",1996,4,8,99,20,42.133333,-70.533333,34,21,13,26,8,"AL",0.038
"11818",514,"199602.201.3590.1","NMFS",1996,4,8,99,27,42.133333,-70.583333,12,7,5,12,0,"AL",0.038
"11819",514,"199602.202.1260.5","NMFS",1996,4,8,99,30,42.366667,-70.533333,1,0,1,1,0,"AL",0.038
"11820",514,"199602.204.3660.1","NMFS",1996,4,8,99,30,42.666667,-70.416667,1,0,1,1,0,"AL",0.038
"11821",514,"199602.205.1260.1","NMFS",1996,4,8,99,30,42.733333,-70.3,0,0,0,0,0,"AL",0.038
"11822",514,"199602.206.1260.3","NMFS",1996,4,8,99,30,42.6,-70.35,6,4,2,6,0,"AL",0.038
"11823",514,"199602.207.1260.4","NMFS",1996,4,9,100,30,42.616667,-70.2,0,0,0,0,0,"AL",0.038
"11824",514,"199602.208.1260.2","NMFS",1996,4,9,100,30,42.583333,-70.1,0,0,0,0,0,"AL",0.038
"11825",514,"199602.209.1280.2","NMFS",1996,4,9,100,30,42.433333,-69.866667,0,0,0,0,0,"AL",0.038
"11826",514,"199602.210.1280.5","NMFS",1996,4,9,100,30,42.433333,-69.7,0,0,0,0,0,"AL",0.038
"11827",521,"199602.212.1280.3","NMFS",1996,4,9,100,30,42.283333,-69.533333,1,1,0,1,0,"AL",0.038
"11828",521,"199602.213.1280.7","NMFS",1996,4,9,100,30,42.216667,-69.516667,0,0,0,0,0,"AL",0.038
"11829",521,"199602.214.1280.1","NMFS",1996,4,9,100,30,42.133333,-69.716667,2,2,0,2,0,"AL",0.038
"11830",521,"199602.217.3550.3","NMFS",1996,4,16,107,30,41.533333,-69.733333,2,1,1,2,0,"AL",0.038
"11831",521,"199602.218.1250.1","NMFS",1996,4,16,107,30,41.566667,-69.633333,0,0,0,0,0,"AL",0.038
"11832",521,"199602.220.1250.3","NMFS",1996,4,16,107,22,41.2,-69.4,0,0,0,0,0,"AL",0.038
"11833",521,"199602.221.1230.4","NMFS",1996,4,16,107,29.5,41.15,-69.033333,0,0,0,0,0,"AL",0.038
"11834",521,"199602.222.1230.2","NMFS",1996,4,16,107,24,41.033333,-69.016667,0,0,0,0,0,"AL",0.038
"11835",526,"199602.223.3550.2","NMFS",1996,4,16,107,30,40.916667,-69.55,0,0,0,0,0,"AL",0.038
"11836",526,"199602.224.3550.4","NMFS",1996,4,16,107,30,41.066667,-69.566667,0,0,0,0,0,"AL",0.038
"11837",526,"199602.225.3550.1","NMFS",1996,4,16,107,30,40.983333,-69.733333,0,0,0,0,0,"AL",0.038
"11838",526,"199602.226.1090.1","NMFS",1996,4,17,108,30,40.85,-69.85,0,0,0,0,0,"AL",0.038
"11839",526,"199602.227.1090.4","NMFS",1996,4,17,108,30,40.7,-69.583333,0,0,0,0,0,"AL",0.038
"11840",526,"199602.228.1100.8","NMFS",1996,4,17,108,30,40.416667,-69.716667,0,0,0,0,0,"AL",0.038
"11841",526,"199602.232.1100.4","NMFS",1996,4,17,108,30,40.2,-69.65,0,0,0,0,0,"AL",0.038
"11842",526,"199602.233.1100.3","NMFS",1996,4,18,109,30,40.333333,-69.5,0,0,0,0,0,"AL",0.038
"11843",526,"199602.234.1100.5","NMFS",1996,4,18,109,30,40.283333,-69.166667,0,0,0,0,0,"AL",0.038
"11844",526,"199602.235.1100.7","NMFS",1996,4,18,109,30,40.35,-69.083333,0,0,0,0,0,"AL",0.038
"11845",526,"199602.236.1110.2","NMFS",1996,4,18,109,30,40.233333,-68.883333,1,0,1,1,0,"AL",0.038
"11846",525,"199602.237.1140.2","NMFS",1996,4,18,109,30,40.183333,-68.733333,0,0,0,0,0,"AL",0.038
"11847",525,"199602.238.1130.9","NMFS",1996,4,18,109,30,40.3,-68.783333,0,0,0,0,0,"AL",0.038
"11848",525,"199602.239.1130.6","NMFS",1996,4,18,109,30,40.35,-68.783333,0,0,0,0,0,"AL",0.038
"11849",526,"199602.240.1100.2","NMFS",1996,4,18,109,30,40.616667,-68.933333,0,0,0,0,0,"AL",0.038
"11850",525,"199602.241.1130.8","NMFS",1996,4,18,109,30,40.65,-68.45,0,0,0,0,0,"AL",0.038
"11851",525,"199602.242.1130.1","NMFS",1996,4,18,109,30,40.683333,-68.25,0,0,0,0,0,"AL",0.038
"11852",525,"199602.243.1130.3","NMFS",1996,4,18,109,30,40.616667,-68.066667,0,0,0,0,0,"AL",0.038
"11853",525,"199602.244.1140.1","NMFS",1996,4,18,109,30,40.416667,-68.183333,0,0,0,0,0,"AL",0.038
"11854",525,"199602.245.1150.1","NMFS",1996,4,19,110,30,40.3,-67.966667,0,0,0,0,0,"AL",0.038
"11855",525,"199602.246.1140.3","NMFS",1996,4,19,110,30,40.533333,-67.75,0,0,0,0,0,"AL",0.038
"11856",525,"199602.247.1130.5","NMFS",1996,4,19,110,30,40.716667,-67.233333,0,0,0,0,0,"AL",0.038
"11857",525,"199602.248.1130.4","NMFS",1996,4,19,110,30,40.866667,-67.316667,0,0,0,0,0,"AL",0.038
"11858",525,"199602.249.1130.7","NMFS",1996,4,19,110,30,40.816667,-67.516667,0,0,0,0,0,"AL",0.038
"11859",525,"199602.250.1130.2","NMFS",1996,4,19,110,30,41.083333,-67.466667,0,0,0,0,0,"AL",0.038
"11860",525,"199602.251.1190.9","NMFS",1996,4,19,110,30,41.033333,-67.816667,0,0,0,0,0,"AL",0.038
"11861",525,"199602.252.1190.5","NMFS",1996,4,19,110,30,41.066667,-67.916667,0,0,0,0,0,"AL",0.038
"11862",525,"199602.253.1190.3","NMFS",1996,4,19,110,30,41.15,-67.916667,0,0,0,0,0,"AL",0.038
"11863",525,"199602.254.1190.2","NMFS",1996,4,19,110,30,41.066667,-68.05,0,0,0,0,0,"AL",0.038
"11864",522,"199602.255.1190.6","NMFS",1996,4,19,110,30,41.183333,-68.283333,2,1,1,2,0,"AL",0.038
"11865",522,"199602.256.1200.4","NMFS",1996,4,19,110,30,41.266667,-68.316667,0,0,0,0,0,"AL",0.038
"11866",522,"199602.257.1190.4","NMFS",1996,4,20,111,30,41.116667,-68.483333,0,0,0,0,0,"AL",0.038
"11867",522,"199602.258.1230.3","NMFS",1996,4,20,111,30,41.233333,-68.683333,0,0,0,0,0,"AL",0.038
"11868",522,"199602.259.1230.5","NMFS",1996,4,20,111,30,41.466667,-68.466667,0,0,0,0,0,"AL",0.038
"11869",522,"199602.260.1200.3","NMFS",1996,4,20,111,30,41.533333,-68.3,0,0,0,0,0,"AL",0.038
"11870",522,"199602.261.1200.6","NMFS",1996,4,20,111,30,41.65,-68.3,0,0,0,0,0,"AL",0.038
"11871",522,"199602.262.1240.5","NMFS",1996,4,20,111,30,41.666667,-68.583333,5,5,0,5,0,"AL",0.038
"11872",522,"199602.264.1220.1","NMFS",1996,4,20,111,30,41.866667,-68.233333,0,0,0,0,0,"AL",0.038
"11873",522,"199602.265.1210.1","NMFS",1996,4,20,111,30,41.85,-68.116667,0,0,0,0,0,"AL",0.038
"11874",522,"199602.266.1200.2","NMFS",1996,4,20,111,30,41.683333,-67.916667,0,0,0,0,0,"AL",0.038
"11875",522,"199602.267.1200.5","NMFS",1996,4,20,111,30,41.766667,-67.733333,0,0,0,0,0,"AL",0.038
"11876",562,"199602.268.1190.8","NMFS",1996,4,20,111,30,41.683333,-67.5,0,0,0,0,0,"AL",0.038
"11877",562,"199602.269.1190.7","NMFS",1996,4,21,112,30,41.533333,-67.15,0,0,0,0,0,"AL",0.038
"11878",562,"199602.270.1160.10","NMFS",1996,4,21,112,30,41.55,-67.05,0,0,0,0,0,"AL",0.038
"11879",562,"199602.271.1160.1","NMFS",1996,4,21,112,30,41.616667,-66.85,0,0,0,0,0,"AL",0.038
"11880",562,"199602.272.1160.8","NMFS",1996,4,21,112,30,41.533333,-66.666667,0,0,0,0,0,"AL",0.038
"11881",562,"199602.273.1160.3","NMFS",1996,4,21,112,30,41.416667,-66.75,2,1,1,2,0,"AL",0.038
"11882",562,"199602.274.1160.4","NMFS",1996,4,21,112,30,41.183333,-66.883333,0,0,0,0,0,"AL",0.038
"11883",562,"199602.275.1160.7","NMFS",1996,4,21,112,30,41.083333,-66.95,0,0,0,0,0,"AL",0.038
"11884",552,"199602.276.1160.5","NMFS",1996,4,21,112,30,41.25,-66.366667,0,0,0,0,0,"AL",0.038
"11885",552,"199602.277.1170.3","NMFS",1996,4,21,112,30,41.4,-66.083333,1,1,0,1,0,"AL",0.038
"11886",552,"199602.278.1180.1","NMFS",1996,4,21,112,30,41.466667,-65.95,2,1,1,2,0,"AL",0.038
"11887",552,"199602.279.1170.1","NMFS",1996,4,21,112,30,41.533333,-66.033333,0,0,0,0,0,"AL",0.038
"11888",552,"199602.280.1160.9","NMFS",1996,4,22,113,30,41.766667,-66.15,0,0,0,0,0,"AL",0.038
"11889",551,"199602.282.1170.4","NMFS",1996,4,22,113,30,41.9,-65.883333,3,2,1,3,0,"AL",0.038
"11890",551,"199602.283.1220.4","NMFS",1996,4,22,113,30,42.1,-66.016667,0,0,0,0,0,"AL",0.038
"11891",551,"199602.284.1290.8","NMFS",1996,4,22,113,30,42.316667,-66.183333,0,0,0,0,0,"AL",0.038
"11892",464,"199602.285.1290.4","NMFS",1996,4,22,113,30,42.5,-66.3,0,0,0,0,0,"AL",0.038
"11893",464,"199602.286.1290.3","NMFS",1996,4,22,113,30,42.566667,-66.55,1,1,0,1,0,"AL",0.038
"11894",464,"199602.287.1300.2","NMFS",1996,4,22,113,30,42.466667,-66.6,1,0,1,1,0,"AL",0.038
"11895",464,"199602.288.1300.1","NMFS",1996,4,22,113,30,42.433333,-66.833333,8,8,0,8,0,"AL",0.038
"11896",551,"199602.289.1220.2","NMFS",1996,4,22,113,30,42.183333,-66.55,3,2,1,3,0,"AL",0.038
"11897",551,"199602.290.1210.2","NMFS",1996,4,22,113,30,42.133333,-66.6,0,0,0,0,0,"AL",0.038
"11898",551,"199602.291.1160.2","NMFS",1996,4,23,114,30,41.966667,-66.6,0,0,0,0,0,"AL",0.038
"11899",552,"199602.292.1160.6","NMFS",1996,4,23,114,30,41.8,-66.666667,0,0,0,0,0,"AL",0.038
"11900",561,"199602.293.1190.1","NMFS",1996,4,23,114,30,41.85,-67.016667,3,1,2,3,0,"AL",0.038
"11901",551,"199602.294.1210.3","NMFS",1996,4,23,114,30,42.1,-67,1,0,1,1,0,"AL",0.038
"11902",561,"199602.295.1220.3","NMFS",1996,4,23,114,30,42.2,-67.283333,0,0,0,0,0,"AL",0.038
"11903",561,"199602.296.1200.1","NMFS",1996,4,23,114,30,42.05,-67.416667,0,0,0,0,0,"AL",0.038
"11904",522,"199602.297.1210.4","NMFS",1996,4,23,114,30,42.016667,-67.7,0,0,0,0,0,"AL",0.038
"11905",522,"199602.298.1290.7","NMFS",1996,4,23,114,30,42.333333,-67.766667,3,2,1,3,0,"AL",0.038
"11906",515,"199602.299.1290.1","NMFS",1996,4,23,114,30,42.416667,-67.75,1,1,0,1,0,"AL",0.038
"11907",464,"199602.300.1300.3","NMFS",1996,4,23,114,30,42.5,-67.366667,2,2,0,2,0,"AL",0.038
"11908",464,"199602.301.1290.5","NMFS",1996,4,24,115,30,42.666667,-67.533333,0,0,0,0,0,"AL",0.038
"11909",464,"199602.302.1360.2","NMFS",1996,4,24,115,30,42.916667,-67.333333,4,3,1,4,0,"AL",0.038
"11910",464,"199602.303.1360.8","NMFS",1996,4,24,115,30,42.95,-66.8,0,0,0,0,0,"AL",0.038
"11911",465,"199602.304.1340.4","NMFS",1996,4,24,115,30,43.1,-66.733333,0,0,0,0,0,"AL",0.038
"11912",465,"199602.306.1360.5","NMFS",1996,4,24,115,30,43.35,-67.35,0,0,0,0,0,"AL",0.038
"11913",465,"199602.307.1360.6","NMFS",1996,4,24,115,30,43.566667,-67.35,0,0,0,0,0,"AL",0.038
"11914",465,"199602.308.1360.4","NMFS",1996,4,24,115,30,43.633333,-67.466667,0,0,0,0,0,"AL",0.038
"11915",465,"199602.309.1340.1","NMFS",1996,4,24,115,30,43.75,-67.166667,3,0,3,3,0,"AL",0.038
"11916",511,"199602.310.1340.2","NMFS",1996,4,25,116,30,43.85,-67.05,0,0,0,0,0,"AL",0.038
"11917",465,"199602.311.1330.1","NMFS",1996,4,25,116,30,43.766667,-66.6,1,1,0,1,0,"AL",0.038
"11918",465,"199602.312.1340.5","NMFS",1996,4,25,116,26,44,-66.666667,0,0,0,0,0,"AL",0.038
"11919",466,"199602.313.1330.2","NMFS",1996,4,25,116,30,44.083333,-66.683333,3,0,3,3,0,"AL",0.038
"11920",466,"199602.314.1351.2","NMFS",1996,4,25,116,30,44.283333,-66.816667,1,0,1,1,0,"AL",0.038
"11921",511,"199602.315.1351.1","NMFS",1996,4,25,116,30,44.266667,-67.266667,1,0,1,1,0,"AL",0.038
"11922",511,"199602.316.1360.1","NMFS",1996,4,25,116,30,44.233333,-67.366667,1,1,0,1,0,"AL",0.038
"11923",511,"199602.318.1390.5","NMFS",1996,4,25,116,29,44.25,-67.866667,4,2,2,4,0,"AL",0.038
"11924",512,"199602.319.1390.4","NMFS",1996,4,26,117,20,44,-68.466667,6,3,3,6,0,"AL",0.038
"11925",512,"199602.320.1390.3","NMFS",1996,4,26,117,30,43.933333,-68.65,18,11,7,18,0,"AL",0.038
"11926",512,"199602.321.1380.3","NMFS",1996,4,26,117,30,43.816667,-68.416667,2,1,1,2,0,"AL",0.038
"11927",512,"199602.322.1380.5","NMFS",1996,4,26,117,30,43.783333,-68.466667,6,6,0,6,0,"AL",0.038
"11928",512,"199602.323.1390.1","NMFS",1996,4,26,117,28,43.716667,-69.05,4,2,2,4,0,"AL",0.038
"11929",513,"199602.324.1380.2","NMFS",1996,4,26,117,30,43.483333,-69.7,0,0,0,0,0,"AL",0.038
"11930",513,"199602.325.1380.1","NMFS",1996,4,26,117,30,43.366667,-69.766667,0,0,0,0,0,"AL",0.038
"11931",513,"199602.326.1370.1","NMFS",1996,4,26,117,30,43.183333,-69.75,0,0,0,0,0,"AL",0.038
"11932",513,"199602.327.1270.2","NMFS",1996,4,27,118,30,43.3,-70.133333,2,2,0,2,0,"AL",0.038
"11933",513,"199602.328.1400.1","NMFS",1996,4,27,118,30,43.283333,-70.183333,4,0,4,4,0,"AL",0.038
"11934",513,"199602.329.1270.3","NMFS",1996,4,27,118,30,43.183333,-70.216667,1,0,1,1,0,"AL",0.038
"11935",513,"199602.330.1270.1","NMFS",1996,4,27,118,30,43.033333,-70.133333,0,0,0,0,0,"AL",0.038
"11936",513,"199602.331.1400.2","NMFS",1996,4,27,118,30,42.983333,-70.5,13,4,9,12,1,"AL",0.038
"11937",514,"199602.332.3640.1","NMFS",1996,4,27,118,30,42.783333,-70.733333,0,0,0,0,0,"AL",0.038
"11938",514,"199602.333.3630.1","NMFS",1996,4,27,118,30,42.733333,-70.733333,2,1,1,2,0,"AL",0.038
"11939",514,"199602.334.3650.1","NMFS",1996,4,27,118,30,42.733333,-70.633333,4,2,2,4,0,"AL",0.038
"11940",514,"199602.335.1400.3","NMFS",1996,4,27,118,30,42.766667,-70.55,2,1,1,2,0,"AL",0.038
"11941",514,"199602.336.1270.4","NMFS",1996,4,27,118,30,42.816667,-70.05,4,4,0,4,0,"AL",0.038
"11942",514,"199602.337.1280.6","NMFS",1996,4,28,119,30,42.766667,-69.883333,0,0,0,0,0,"AL",0.038
"11943",515,"199602.338.1280.4","NMFS",1996,4,28,119,30,42.666667,-69.633333,0,0,0,0,0,"AL",0.038
"11944",515,"199602.339.1370.2","NMFS",1996,4,28,119,30,42.616667,-68.783333,0,0,0,0,0,"AL",0.038
"11945",515,"199602.340.1370.4","NMFS",1996,4,28,119,30,42.75,-68.766667,0,0,0,0,0,"AL",0.038
"11946",515,"199602.341.1370.3","NMFS",1996,4,28,119,30,42.866667,-69.083333,1,0,1,1,0,"AL",0.038
"11947",515,"199602.342.1370.5","NMFS",1996,4,28,119,30,43.033333,-69.066667,0,0,0,0,0,"AL",0.038
"11948",515,"199602.343.1380.4","NMFS",1996,4,28,119,30,43.266667,-68.383333,0,0,0,0,0,"AL",0.038
"11949",515,"199602.344.1360.7","NMFS",1996,4,28,119,30,42.966667,-68.066667,1,1,0,1,0,"AL",0.038
"11950",515,"199602.345.1360.3","NMFS",1996,4,28,119,30,42.916667,-68.4,1,1,0,1,0,"AL",0.038
"11951",515,"199602.346.1290.6","NMFS",1996,4,29,120,30,42.65,-68.45,0,0,0,0,0,"AL",0.038
"11952",515,"199602.347.1290.2","NMFS",1996,4,29,120,30,42.45,-68.4,0,0,0,0,0,"AL",0.038
"11953",522,"199602.348.1240.4","NMFS",1996,4,29,120,30,42.216667,-68.416667,0,0,0,0,0,"AL",0.038
"11954",521,"199602.349.1240.2","NMFS",1996,4,29,120,30,42.05,-68.9,0,0,0,0,0,"AL",0.038
"11955",521,"199602.350.1240.3","NMFS",1996,4,29,120,30,41.766667,-69.016667,0,0,0,0,0,"AL",0.038
"11956",526,"199604.170.3550.1","NMFS",1996,9,28,272,30,41,-69.716667,1,0,1,1,0,"AL",0.038
"11957",526,"199604.171.3550.3","NMFS",1996,9,28,272,30,41.05,-69.65,2,2,0,1,1,"AL",0.038
"11958",526,"199604.172.1090.1","NMFS",1996,9,28,272,30,40.7,-69.716667,0,0,0,0,0,"AL",0.038
"11959",526,"199604.173.1100.2","NMFS",1996,9,28,272,30,40.566667,-69.8,0,0,0,0,0,"AL",0.038
"11960",526,"199604.175.1100.6","NMFS",1996,9,29,273,30,40.35,-69.816667,0,0,0,0,0,"AL",0.038
"11961",526,"199604.176.1110.1","NMFS",1996,9,29,273,30,40,-69.833333,1,1,0,1,0,"AL",0.038
"11962",526,"199604.177.1110.2","NMFS",1996,9,29,273,30,40.033333,-69.25,1,0,1,0,1,"AL",0.038
"11963",526,"199604.178.1120.1","NMFS",1996,9,29,273,30,40.033333,-69.083333,14,5,9,13,1,"AL",0.038
"11964",526,"199604.179.1100.5","NMFS",1996,9,29,273,30,40.166667,-69.35,0,0,0,0,0,"AL",0.038
"11965",526,"199604.180.1100.8","NMFS",1996,9,29,273,30,40.2,-69.283333,0,0,0,0,0,"AL",0.038
"11966",526,"199604.181.1100.3","NMFS",1996,9,29,273,30,40.516667,-69.2,1,0,1,0,1,"AL",0.038
"11967",526,"199604.182.1090.2","NMFS",1996,9,29,273,30,40.666667,-69.283333,0,0,0,0,0,"AL",0.038
"11968",526,"199604.183.1100.7","NMFS",1996,9,30,274,30,40.783333,-69.1,1,1,0,1,0,"AL",0.038
"11969",526,"199604.184.1100.4","NMFS",1996,9,30,274,30,40.916667,-68.933333,0,0,0,0,0,"AL",0.038
"11970",521,"199604.185.1230.1","NMFS",1996,9,30,274,30,41.15,-68.983333,0,0,0,0,0,"AL",0.038
"11971",521,"199604.186.1230.4","NMFS",1996,9,30,274,30,41.1,-69.133333,0,0,0,0,0,"AL",0.038
"11972",521,"199604.187.1250.1","NMFS",1996,9,30,274,30,41.066667,-69.183333,0,0,0,0,0,"AL",0.038
"11973",521,"199604.189.1250.5","NMFS",1996,9,30,274,30,41.15,-69.35,0,0,0,0,0,"AL",0.038
"11974",521,"199604.190.1230.2","NMFS",1996,9,30,274,30,41.266667,-69.166667,0,0,0,0,0,"AL",0.038
"11975",522,"199604.191.1230.3","NMFS",1996,9,30,274,30,41.366667,-68.633333,0,0,0,0,0,"AL",0.038
"11976",522,"199604.192.1200.3","NMFS",1996,9,30,274,30,41.233333,-68.516667,0,0,0,0,0,"AL",0.038
"11977",522,"199604.193.1200.6","NMFS",1996,9,30,274,30,41.083333,-68.6,0,0,0,0,0,"AL",0.038
"11978",522,"199604.194.1190.6","NMFS",1996,9,30,274,30,41.1,-68.5,4,1,3,4,0,"AL",0.038
"11979",525,"199604.195.1130.2","NMFS",1996,10,1,275,30,40.7,-68.4,2,2,0,2,0,"AL",0.038
"11980",525,"199604.196.1130.3","NMFS",1996,10,1,275,30,40.483333,-68.733333,0,0,0,0,0,"AL",0.038
"11981",525,"199604.197.1140.3","NMFS",1996,10,1,275,30,40.35,-68.35,0,0,0,0,0,"AL",0.038
"11982",525,"199604.198.1140.2","NMFS",1996,10,1,275,30,40.433333,-68.083333,0,0,0,0,0,"AL",0.038
"11983",525,"199604.199.1140.1","NMFS",1996,10,1,275,30,40.433333,-67.85,0,0,0,0,0,"AL",0.038
"11984",525,"199604.200.1130.6","NMFS",1996,10,1,275,30,40.6,-67.75,0,0,0,0,0,"AL",0.038
"11985",525,"199604.201.1150.1","NMFS",1996,10,1,275,30,40.483333,-67.283333,0,0,0,0,0,"AL",0.038
"11986",525,"199604.202.1130.1","NMFS",1996,10,1,275,30,40.766667,-67.333333,0,0,0,0,0,"AL",0.038
"11987",525,"199604.203.1130.7","NMFS",1996,10,1,275,30,40.816667,-67.366667,0,0,0,0,0,"AL",0.038
"11988",525,"199604.204.1130.5","NMFS",1996,10,1,275,30,40.783333,-67.466667,0,0,0,0,0,"AL",0.038
"11989",525,"199604.205.1130.4","NMFS",1996,10,1,275,30,40.9,-67.5,0,0,0,0,0,"AL",0.038
"11990",525,"199604.206.1130.8","NMFS",1996,10,1,275,30,40.9,-67.633333,0,0,0,0,0,"AL",0.038
"11991",525,"199604.207.1130.9","NMFS",1996,10,2,276,30,40.883333,-67.966667,0,0,0,0,0,"AL",0.038
"11992",525,"199604.208.1190.8","NMFS",1996,10,2,276,30,41.15,-67.8,0,0,0,0,0,"AL",0.038
"11993",522,"199604.209.1190.5","NMFS",1996,10,2,276,30,41.35,-68.033333,2,1,1,2,0,"AL",0.038
"11994",522,"199604.210.1200.4","NMFS",1996,10,2,276,30,41.483333,-68.233333,2,1,1,2,0,"AL",0.038
"11995",522,"199604.211.1200.5","NMFS",1996,10,2,276,30,41.683333,-68.216667,1,0,1,1,0,"AL",0.038
"11996",522,"199604.212.1220.1","NMFS",1996,10,2,276,30,41.8,-68.266667,0,0,0,0,0,"AL",0.038
"11997",522,"199604.213.1200.1","NMFS",1996,10,2,276,30,41.666667,-68.383333,1,1,0,1,0,"AL",0.038
"11998",521,"199604.214.1240.2","NMFS",1996,10,2,276,30,41.933333,-68.85,1,1,0,1,0,"AL",0.038
"11999",521,"199604.215.1240.6","NMFS",1996,10,2,276,30,41.583333,-69.166667,0,0,0,0,0,"AL",0.038
"12000",521,"199604.216.1230.5","NMFS",1996,10,3,277,30,41.4,-69.333333,1,1,0,1,0,"AL",0.038
"12001",521,"199604.217.3550.2","NMFS",1996,10,3,277,30,41.316667,-69.483333,15,8,7,15,0,"AL",0.038
"12002",521,"199604.218.1250.4","NMFS",1996,10,3,277,30,41.45,-69.6,18,8,10,18,0,"AL",0.038
"12003",521,"199604.219.3550.5","NMFS",1996,10,3,277,30,41.383333,-69.7,38,28,10,34,4,"AL",0.038
"12004",521,"199604.221.3560.1","NMFS",1996,10,3,277,20,41.75,-69.9,3,1,2,2,1,"AL",0.038
"12005",521,"199604.224.1240.5","NMFS",1996,10,3,277,30,41.933333,-69.683333,1,0,1,1,0,"AL",0.038
"12006",521,"199604.225.1280.4","NMFS",1996,10,3,277,30,41.966667,-69.433333,0,0,0,0,0,"AL",0.038
"12007",521,"199604.226.1280.6","NMFS",1996,10,3,277,30,42,-69.233333,0,0,0,0,0,"AL",0.038
"12008",562,"199604.227.1190.9","NMFS",1996,10,8,282,30,41.45,-67.5,1,0,1,1,0,"AL",0.038
"12009",562,"199604.228.1190.1","NMFS",1996,10,8,282,30,41.5,-67.416667,1,1,0,1,0,"AL",0.038
"12010",562,"199604.229.1190.4","NMFS",1996,10,8,282,30,41.416667,-67.25,8,7,1,8,0,"AL",0.038
"12011",562,"199604.230.1190.3","NMFS",1996,10,8,282,30,41.266667,-67.416667,1,1,0,1,0,"AL",0.038
"12012",562,"199604.231.1160.9","NMFS",1996,10,8,282,30,41.016667,-66.733333,0,0,0,0,0,"AL",0.038
"12013",514,"199604.232.3580.1","NMFS",1996,10,9,283,30,41.75,-70.333333,1,0,1,1,0,"AL",0.038
"12014",514,"199604.233.3600.1","NMFS",1996,10,9,283,29,41.9,-70.4,125,59,66,105,20,"AL",0.038
"12015",514,"199604.234.3590.1","NMFS",1996,10,9,283,30,41.85,-70.3,51,24,27,39,12,"AL",0.038
"12016",522,"199604.235.1220.2","NMFS",1996,10,10,284,30,42,-68,0,0,0,0,0,"AL",0.038
"12017",522,"199604.236.1220.4","NMFS",1996,10,10,284,30,41.95,-68.066667,0,0,0,0,0,"AL",0.038
"12018",522,"199604.238.1210.5","NMFS",1996,10,10,284,30,41.95,-67.883333,0,0,0,0,0,"AL",0.038
"12019",522,"199604.239.1200.2","NMFS",1996,10,10,284,30,41.883333,-67.816667,2,1,1,2,0,"AL",0.038
"12020",561,"199604.240.1190.2","NMFS",1996,10,10,284,30,41.9,-67.2,4,3,1,4,0,"AL",0.038
"12021",562,"199604.241.1190.7","NMFS",1996,10,10,284,30,41.733333,-67.266667,3,1,2,2,1,"AL",0.038
"12022",562,"199604.242.1160.1","NMFS",1996,10,11,285,30,41.633333,-66.916667,1,1,0,1,0,"AL",0.038
"12023",562,"199604.243.1160.10","NMFS",1996,10,11,285,30,41.45,-66.566667,0,0,0,0,0,"AL",0.038
"12024",552,"199604.244.1160.2","NMFS",1996,10,11,285,30,41.35,-66.416667,0,0,0,0,0,"AL",0.038
"12025",552,"199604.245.1170.1","NMFS",1996,10,11,285,30,41.5,-66.066667,0,0,0,0,0,"AL",0.038
"12026",552,"199604.246.1170.3","NMFS",1996,10,11,285,30,41.716667,-65.866667,0,0,0,0,0,"AL",0.038
"12027",552,"199604.247.1160.5","NMFS",1996,10,11,285,30,41.783333,-66.016667,0,0,0,0,0,"AL",0.038
"12028",551,"199604.248.1170.2","NMFS",1996,10,11,285,30,41.933333,-65.833333,1,1,0,1,0,"AL",0.038
"12029",551,"199604.249.1180.1","NMFS",1996,10,11,285,30,42.05,-65.9,0,0,0,0,0,"AL",0.038
"12030",551,"199604.250.1160.4","NMFS",1996,10,11,285,30,41.983333,-66.116667,0,0,0,0,0,"AL",0.038
"12031",551,"199604.251.1160.3","NMFS",1996,10,11,285,30,42.05,-66.15,0,0,0,0,0,"AL",0.038
"12032",464,"199604.252.1290.3","NMFS",1996,10,12,286,30,42.3,-65.933333,2,1,1,2,0,"AL",0.038
"12033",551,"199604.254.1210.1","NMFS",1996,10,12,286,30,42.1,-66.7,1,0,1,1,0,"AL",0.038
"12034",551,"199604.255.1160.8","NMFS",1996,10,12,286,30,41.933333,-66.55,2,0,2,2,0,"AL",0.038
"12035",552,"199604.256.1160.6","NMFS",1996,10,12,286,30,41.783333,-66.7,1,0,1,1,0,"AL",0.038
"12036",551,"199604.257.1160.7","NMFS",1996,10,12,286,30,42.033333,-66.85,0,0,0,0,0,"AL",0.038
"12037",551,"199604.258.1210.4","NMFS",1996,10,12,286,30,42.1,-67.016667,0,0,0,0,0,"AL",0.038
"12038",561,"199604.259.1210.2","NMFS",1996,10,12,286,30,42.116667,-67.233333,0,0,0,0,0,"AL",0.038
"12039",551,"199604.260.1220.3","NMFS",1996,10,12,286,30,42.216667,-67.083333,0,0,0,0,0,"AL",0.038
"12040",464,"199604.261.1300.2","NMFS",1996,10,13,287,30,42.533333,-67.05,0,0,0,0,0,"AL",0.038
"12041",464,"199604.262.1290.6","NMFS",1996,10,13,287,30,42.683333,-67.083333,2,1,1,2,0,"AL",0.038
"12042",464,"199604.263.1300.1","NMFS",1996,10,13,287,30,42.516667,-67.216667,2,0,2,2,0,"AL",0.038
"12043",464,"199604.264.1290.1","NMFS",1996,10,13,287,30,42.533333,-67.55,0,0,0,0,0,"AL",0.038
"12044",464,"199604.265.1300.3","NMFS",1996,10,13,287,30,42.35,-67.433333,2,1,1,2,0,"AL",0.038
"12045",561,"199604.266.1290.2","NMFS",1996,10,13,287,30,42.233333,-67.633333,0,0,0,0,0,"AL",0.038
"12046",515,"199604.267.1290.4","NMFS",1996,10,13,287,30,42.35,-67.816667,0,0,0,0,0,"AL",0.038
"12047",522,"199604.268.1290.5","NMFS",1996,10,13,287,30,42.166667,-67.983333,0,0,0,0,0,"AL",0.038
"12048",515,"199604.269.1290.7","NMFS",1996,10,13,287,30,42.366667,-68.1,0,0,0,0,0,"AL",0.038
"12049",515,"199604.270.1360.1","NMFS",1996,10,14,288,30,42.883333,-67.683333,0,0,0,0,0,"AL",0.038
"12050",465,"199604.271.1360.4","NMFS",1996,10,14,288,30,43.15,-67.316667,0,0,0,0,0,"AL",0.038
"12051",465,"199604.272.1340.4","NMFS",1996,10,14,288,20.5,43.133333,-66.516667,1,1,0,1,0,"AL",0.038
"12052",465,"199604.274.1340.5","NMFS",1996,10,14,288,30,43.4,-66.6,1,0,1,1,0,"AL",0.038
"12053",465,"199604.277.1340.3","NMFS",1996,10,14,288,30,43.483333,-66.783333,1,0,1,1,0,"AL",0.038
"12054",465,"199604.278.1360.6","NMFS",1996,10,14,288,30,43.516667,-67.033333,0,0,0,0,0,"AL",0.038
"12055",466,"199604.279.1330.3","NMFS",1996,10,16,290,30,44.116667,-66.583333,0,0,0,0,0,"AL",0.038
"12056",466,"199604.280.1351.1","NMFS",1996,10,16,290,30,44.216667,-66.766667,1,1,0,1,0,"AL",0.038
"12057",511,"199604.281.1351.2","NMFS",1996,10,16,290,30,44.25,-67.2,0,0,0,0,0,"AL",0.038
"12058",511,"199604.282.1340.1","NMFS",1996,10,16,290,30,44.15,-67.283333,1,1,0,1,0,"AL",0.038
"12059",511,"199604.283.1340.6","NMFS",1996,10,16,290,30,44.066667,-67.383333,0,0,0,0,0,"AL",0.038
"12060",511,"199604.284.1390.5","NMFS",1996,10,16,290,30,44.433333,-67.483333,23,10,13,22,1,"AL",0.038
"12061",511,"199604.285.1390.4","NMFS",1996,10,17,291,30,44.366667,-67.666667,24,16,8,24,0,"AL",0.038
"12062",512,"199604.286.1390.1","NMFS",1996,10,17,291,30,44.15,-67.883333,0,0,0,0,0,"AL",0.038
"12063",465,"199604.287.1340.2","NMFS",1996,10,17,291,30,43.666667,-67.25,0,0,0,0,0,"AL",0.038
"12064",465,"199604.288.1360.8","NMFS",1996,10,17,291,30,43.666667,-67.416667,0,0,0,0,0,"AL",0.038
"12065",512,"199604.289.1360.5","NMFS",1996,10,17,291,30,43.583333,-67.85,1,1,0,1,0,"AL",0.038
"12066",514,"199604.290.3610.1","NMFS",1996,10,23,297,30,42.033333,-70.333333,71,30,41,67,4,"AL",0.038
"12067",514,"199604.291.3600.2","NMFS",1996,10,23,297,30,41.983333,-70.233333,21,4,17,21,0,"AL",0.038
"12068",514,"199604.292.3610.2","NMFS",1996,10,23,297,30,42.033333,-70.233333,15,8,7,15,0,"AL",0.038
"12069",514,"199604.293.1260.2","NMFS",1996,10,23,297,30,42.116667,-70.366667,47,23,24,47,0,"AL",0.038
"12070",521,"199604.294.1270.2","NMFS",1996,10,23,297,30,42.266667,-69.916667,1,0,1,1,0,"AL",0.038
"12071",514,"199604.295.1280.3","NMFS",1996,10,23,297,30,42.4,-69.666667,0,0,0,0,0,"AL",0.038
"12072",514,"199604.296.1260.3","NMFS",1996,10,23,297,30,42.4,-70.05,0,0,0,0,0,"AL",0.038
"12073",514,"199604.297.1260.4","NMFS",1996,10,23,297,30,42.433333,-70.066667,1,0,1,1,0,"AL",0.038
"12074",514,"199604.298.1260.1","NMFS",1996,10,23,297,29,42.466667,-70.416667,3,1,2,3,0,"AL",0.038
"12075",514,"199604.300.3660.2","NMFS",1996,10,24,298,30,42.3,-70.65,240,116,124,222,18,"AL",0.038
"12076",514,"199604.301.3650.1","NMFS",1996,10,24,298,27.5,42.316667,-70.666667,125,67,58,115,10,"AL",0.038
"12077",514,"199604.302.3630.1","NMFS",1996,10,24,298,30,42.2,-70.65,50,32,18,41,9,"AL",0.038
"12078",514,"199604.303.3640.1","NMFS",1996,10,24,298,30,42.383333,-70.816667,306,182,124,226,80,"AL",0.038
"12079",514,"199604.304.3660.1","NMFS",1996,10,24,298,20,42.516667,-70.666667,109,44,65,99,10,"AL",0.038
"12080",514,"199604.305.1400.3","NMFS",1996,10,24,298,30,42.783333,-70.633333,23,8,15,22,1,"AL",0.038
"12081",513,"199604.306.1270.1","NMFS",1996,10,24,298,30,42.9,-69.983333,2,0,2,2,0,"AL",0.038
"12082",513,"199604.307.1260.5","NMFS",1996,10,24,298,30,43.1,-70.066667,0,0,0,0,0,"AL",0.038
"12083",513,"199604.309.1380.5","NMFS",1996,10,24,298,30,43.283333,-69.433333,0,0,0,0,0,"AL",0.038
"12084",513,"199604.310.1270.4","NMFS",1996,10,25,299,30,43.3,-69.983333,0,0,0,0,0,"AL",0.038
"12085",513,"199604.311.1380.3","NMFS",1996,10,25,299,30,43.366667,-69.966667,0,0,0,0,0,"AL",0.038
"12086",513,"199604.312.1270.3","NMFS",1996,10,25,299,30,43.366667,-70.05,0,0,0,0,0,"AL",0.038
"12087",513,"199604.313.1400.1","NMFS",1996,10,25,299,30,43.416667,-70.133333,17,7,10,16,1,"AL",0.038
"12088",513,"199604.314.1400.2","NMFS",1996,10,25,299,30,43.616667,-69.75,3,1,2,3,0,"AL",0.038
"12089",513,"199604.315.1380.2","NMFS",1996,10,25,299,30,43.616667,-69.55,2,2,0,2,0,"AL",0.038
"12090",512,"199604.316.1390.3","NMFS",1996,10,25,299,30,43.833333,-69.066667,123,61,62,119,4,"AL",0.038
"12091",512,"199604.317.1390.2","NMFS",1996,10,25,299,20,43.85,-68.8,16,9,7,14,2,"AL",0.038
"12092",512,"199604.318.1380.6","NMFS",1996,10,25,299,30,43.683333,-68.683333,0,0,0,0,0,"AL",0.038
"12093",512,"199604.319.1380.1","NMFS",1996,10,26,300,30,43.683333,-68.15,0,0,0,0,0,"AL",0.038
"12094",515,"199604.320.1360.7","NMFS",1996,10,26,300,30,43.233333,-68.033333,0,0,0,0,0,"AL",0.038
"12095",515,"199604.321.1360.2","NMFS",1996,10,26,300,30,43,-68.166667,0,0,0,0,0,"AL",0.038
"12096",515,"199604.322.1360.3","NMFS",1996,10,26,300,30,43.183333,-68.55,0,0,0,0,0,"AL",0.038
"12097",515,"199604.324.1370.6","NMFS",1996,10,26,300,30,43.216667,-68.683333,0,0,0,0,0,"AL",0.038
"12098",515,"199604.325.1370.3","NMFS",1996,10,26,300,30,43.183333,-68.766667,0,0,0,0,0,"AL",0.038
"12099",515,"199604.326.1370.1","NMFS",1996,10,26,300,30,43.033333,-68.816667,0,0,0,0,0,"AL",0.038
"12100",515,"199604.327.1370.4","NMFS",1996,10,26,300,30,42.866667,-68.8,0,0,0,0,0,"AL",0.038
"12101",515,"199604.328.1370.5","NMFS",1996,10,26,300,30,42.716667,-69.033333,0,0,0,0,0,"AL",0.038
"12102",515,"199604.329.1280.7","NMFS",1996,10,26,300,30,42.533333,-68.95,0,0,0,0,0,"AL",0.038
"12103",515,"199604.330.1280.1","NMFS",1996,10,27,301,30,42.55,-68.65,1,0,1,1,0,"AL",0.038
"12104",522,"199604.331.1240.1","NMFS",1996,10,27,301,30,42.316667,-68.6,0,0,0,0,0,"AL",0.038
"12105",522,"199604.332.1240.4","NMFS",1996,10,27,301,30,42.233333,-68.5,0,0,0,0,0,"AL",0.038
"12106",521,"199604.333.1240.3","NMFS",1996,10,27,301,30,42.15,-68.883333,0,0,0,0,0,"AL",0.038
"12107",515,"199604.334.1280.2","NMFS",1996,10,27,301,30,42.35,-68.933333,1,1,0,1,0,"AL",0.038
"12108",521,"199604.335.1280.5","NMFS",1996,10,27,301,30,42.266667,-69.15,0,0,0,0,0,"AL",0.038
"12109",526,"199702.176.1100.3","NMFS",1997,3,23,82,30,40.616667,-69.783333,0,0,0,0,0,"AL",0.038
"12110",526,"199702.177.3550.5","NMFS",1997,3,23,82,30,40.866667,-69.866667,0,0,0,0,0,"AL",0.038
"12111",526,"199702.178.1090.4","NMFS",1997,3,23,82,30,40.933333,-69.766667,0,0,0,0,0,"AL",0.038
"12112",526,"199702.179.3550.4","NMFS",1997,3,23,82,30,41.066667,-69.716667,0,0,0,0,0,"AL",0.038
"12113",526,"199702.180.3550.2","NMFS",1997,3,23,82,30,40.966667,-69.633333,0,0,0,0,0,"AL",0.038
"12114",526,"199702.181.1090.1","NMFS",1997,3,23,82,30,40.783333,-69.283333,0,0,0,0,0,"AL",0.038
"12115",526,"199702.182.1100.2","NMFS",1997,3,24,83,30,40.516667,-69.2,0,0,0,0,0,"AL",0.038
"12116",526,"199702.183.1100.1","NMFS",1997,3,24,83,30,40.4,-69.45,0,0,0,0,0,"AL",0.038
"12117",526,"199702.184.1100.5","NMFS",1997,3,24,83,30,40.316667,-69.816667,1,1,0,1,0,"AL",0.038
"12118",526,"199702.188.1110.1","NMFS",1997,3,24,83,30,40.066667,-69.233333,0,0,0,0,0,"AL",0.038
"12119",526,"199702.189.1110.2","NMFS",1997,3,24,83,30,40.233333,-68.95,0,0,0,0,0,"AL",0.038
"12120",525,"199702.190.1140.3","NMFS",1997,3,25,84,30,40.266667,-68.6,0,0,0,0,0,"AL",0.038
"12121",525,"199702.191.1140.1","NMFS",1997,3,25,84,30,40.283333,-68.566667,0,0,0,0,0,"AL",0.038
"12122",525,"199702.192.1130.5","NMFS",1997,3,25,84,30,40.483333,-68.65,0,0,0,0,0,"AL",0.038
"12123",525,"199702.193.1130.3","NMFS",1997,3,25,84,30,40.783333,-68.816667,0,0,0,0,0,"AL",0.038
"12124",521,"199702.194.1230.5","NMFS",1997,3,25,84,30,41.133333,-69.066667,0,0,0,0,0,"AL",0.038
"12125",521,"199702.196.1250.2","NMFS",1997,3,25,84,30,41.183333,-69.4,0,0,0,0,0,"AL",0.038
"12126",521,"199702.197.1230.3","NMFS",1997,3,25,84,30,41.333333,-69.35,0,0,0,0,0,"AL",0.038
"12127",521,"199702.198.3550.3","NMFS",1997,3,25,84,23,41.333333,-69.483333,0,0,0,0,0,"AL",0.038
"12128",521,"199702.199.3550.1","NMFS",1997,3,25,84,30,41.516667,-69.7,0,0,0,0,0,"AL",0.038
"12129",521,"199702.200.1250.1","NMFS",1997,3,26,85,30,41.55,-69.65,2,2,0,2,0,"AL",0.038
"12130",521,"199702.201.1230.1","NMFS",1997,3,26,85,30,41.6,-69.433333,0,0,0,0,0,"AL",0.038
"12131",514,"199702.202.3590.1","NMFS",1997,3,26,85,30,41.816667,-70.433333,3,3,0,3,0,"AL",0.038
"12132",514,"199702.203.3600.2","NMFS",1997,3,26,85,30,41.933333,-70.466667,13,8,5,9,4,"AL",0.038
"12133",514,"199702.204.3610.1","NMFS",1997,3,26,85,30,41.983333,-70.333333,2,1,1,2,0,"AL",0.038
"12134",514,"199702.205.3600.1","NMFS",1997,3,26,85,30,42,-70.183333,0,0,0,0,0,"AL",0.038
"12135",514,"199702.206.3610.2","NMFS",1997,3,26,85,30,42.066667,-70.283333,9,3,6,9,0,"AL",0.038
"12136",521,"199702.207.1270.1","NMFS",1997,3,27,86,30,42.266667,-69.983333,3,2,1,3,0,"AL",0.038
"12137",521,"199702.208.1260.1","NMFS",1997,3,27,86,30,42.1,-69.95,2,2,0,2,0,"AL",0.038
"12138",521,"199702.210.1250.5","NMFS",1997,3,27,86,26,41.933333,-69.883333,0,0,0,0,0,"AL",0.038
"12139",521,"199702.212.1240.5","NMFS",1997,3,27,86,30,41.866667,-69.483333,0,0,0,0,0,"AL",0.038
"12140",521,"199702.213.1280.2","NMFS",1997,3,27,86,30,42.083333,-69.6,0,0,0,0,0,"AL",0.038
"12141",521,"199702.214.1280.1","NMFS",1997,3,27,86,30,42.116667,-69.433333,0,0,0,0,0,"AL",0.038
"12142",521,"199702.215.1280.5","NMFS",1997,3,27,86,30,42.166667,-69.383333,0,0,0,0,0,"AL",0.038
"12143",521,"199702.216.1280.4","NMFS",1997,3,27,86,30,42.25,-69.383333,0,0,0,0,0,"AL",0.038
"12144",521,"199702.217.1280.6","NMFS",1997,3,27,86,30,42.316667,-69.4,0,0,0,0,0,"AL",0.038
"12145",522,"199702.218.1240.4","NMFS",1997,4,4,94,30,41.65,-68.75,0,0,0,0,0,"AL",0.038
"12146",522,"199702.219.1240.6","NMFS",1997,4,4,94,30,41.616667,-68.516667,0,0,0,0,0,"AL",0.038
"12147",522,"199702.220.1200.4","NMFS",1997,4,4,94,30,41.683333,-68.3,0,0,0,0,0,"AL",0.038
"12148",522,"199702.221.1210.1","NMFS",1997,4,4,94,30,41.766667,-68.266667,0,0,0,0,0,"AL",0.038
"12149",522,"199702.222.1220.3","NMFS",1997,4,4,94,30,41.85,-68.183333,0,0,0,0,0,"AL",0.038
"12150",522,"199702.223.1200.6","NMFS",1997,4,4,94,30,41.733333,-68.133333,0,0,0,0,0,"AL",0.038
"12151",522,"199702.224.1200.5","NMFS",1997,4,4,94,30,41.6,-68.216667,1,1,0,1,0,"AL",0.038
"12152",522,"199702.225.1190.7","NMFS",1997,4,4,94,30,41.35,-68.016667,0,0,0,0,0,"AL",0.038
"12153",522,"199702.226.1230.4","NMFS",1997,4,4,94,30,41.316667,-68.45,0,0,0,0,0,"AL",0.038
"12154",522,"199702.227.1230.2","NMFS",1997,4,4,94,30,41.333333,-68.55,0,0,0,0,0,"AL",0.038
"12155",522,"199702.228.1190.9","NMFS",1997,4,4,94,30,41.033333,-68.55,0,0,0,0,0,"AL",0.038
"12156",525,"199702.229.1140.2","NMFS",1997,4,5,95,30,40.333333,-68.2,0,0,0,0,0,"AL",0.038
"12157",525,"199702.230.1150.1","NMFS",1997,4,5,95,30,40.366667,-68.116667,0,0,0,0,0,"AL",0.038
"12158",525,"199702.231.1130.9","NMFS",1997,4,5,95,30,40.583333,-67.933333,0,0,0,0,0,"AL",0.038
"12159",525,"199702.232.1190.8","NMFS",1997,4,5,95,30,40.95,-68.083333,0,0,0,0,0,"AL",0.038
"12160",525,"199702.233.1190.3","NMFS",1997,4,5,95,30,41.066667,-68,0,0,0,0,0,"AL",0.038
"12161",525,"199702.234.1190.4","NMFS",1997,4,5,95,30,41.116667,-67.783333,0,0,0,0,0,"AL",0.038
"12162",562,"199702.235.1190.6","NMFS",1997,4,5,95,30,41.183333,-67.533333,0,0,0,0,0,"AL",0.038
"12163",525,"199702.236.1130.4","NMFS",1997,4,5,95,30,40.883333,-67.316667,0,0,0,0,0,"AL",0.038
"12164",525,"199702.237.1130.8","NMFS",1997,4,5,95,30,40.75,-67.333333,0,0,0,0,0,"AL",0.038
"12165",525,"199702.238.1130.6","NMFS",1997,4,5,95,30,40.616667,-67.45,0,0,0,0,0,"AL",0.038
"12166",525,"199702.239.1130.2","NMFS",1997,4,5,95,30,40.65,-67.333333,0,0,0,0,0,"AL",0.038
"12167",525,"199702.240.1130.7","NMFS",1997,4,6,96,30,40.783333,-66.933333,0,0,0,0,0,"AL",0.038
"12168",525,"199702.241.1130.1","NMFS",1997,4,6,96,30,40.833333,-67.1,0,0,0,0,0,"AL",0.038
"12169",562,"199702.242.1160.6","NMFS",1997,4,6,96,30,41.033333,-67.083333,0,0,0,0,0,"AL",0.038
"12170",562,"199702.243.1190.2","NMFS",1997,4,6,96,30,41.266667,-67.183333,0,0,0,0,0,"AL",0.038
"12171",562,"199702.244.1190.5","NMFS",1997,4,6,96,30,41.616667,-67.25,0,0,0,0,0,"AL",0.038
"12172",562,"199702.245.1160.2","NMFS",1997,4,6,96,30,41.433333,-67.083333,0,0,0,0,0,"AL",0.038
"12173",562,"199702.246.1160.4","NMFS",1997,4,6,96,30,41.266667,-67.033333,0,0,0,0,0,"AL",0.038
"12174",562,"199702.247.1160.10","NMFS",1997,4,6,96,30,41.15,-66.55,0,0,0,0,0,"AL",0.038
"12175",562,"199702.248.1180.1","NMFS",1997,4,6,96,28,41.1,-66.383333,0,0,0,0,0,"AL",0.038
"12176",562,"199702.249.1170.3","NMFS",1997,4,6,96,30,41.183333,-66.366667,0,0,0,0,0,"AL",0.038
"12177",552,"199702.250.1160.1","NMFS",1997,4,6,96,32,41.5,-66.366667,0,0,0,0,0,"AL",0.038
"12178",552,"199702.251.1160.5","NMFS",1997,4,7,97,30,41.516667,-66.4,0,0,0,0,0,"AL",0.038
"12179",552,"199702.252.1160.8","NMFS",1997,4,7,97,30,41.616667,-66.616667,0,0,0,0,0,"AL",0.038
"12180",552,"199702.253.1160.3","NMFS",1997,4,7,97,30,41.683333,-66.55,0,0,0,0,0,"AL",0.038
"12181",552,"199702.254.1160.9","NMFS",1997,4,7,97,30,41.633333,-66.316667,0,0,0,0,0,"AL",0.038
"12182",551,"199702.256.1170.2","NMFS",1997,4,7,97,30,41.866667,-65.833333,0,0,0,0,0,"AL",0.038
"12183",551,"199702.257.1180.2","NMFS",1997,4,7,97,30,41.966667,-65.816667,1,1,0,1,0,"AL",0.038
"12184",551,"199702.258.1170.4","NMFS",1997,4,7,97,30,41.966667,-65.883333,1,0,1,1,0,"AL",0.038
"12185",551,"199702.259.1160.7","NMFS",1997,4,7,97,30,41.85,-66.266667,0,0,0,0,0,"AL",0.038
"12186",464,"199702.260.1290.1","NMFS",1997,4,7,97,30,42.283333,-65.966667,0,0,0,0,0,"AL",0.038
"12187",464,"199702.261.1290.5","NMFS",1997,4,8,98,30,42.366667,-65.85,2,2,0,2,0,"AL",0.038
"12188",464,"199702.262.1290.3","NMFS",1997,4,8,98,30,42.516667,-66.083333,1,1,0,1,0,"AL",0.038
"12189",551,"199702.263.1290.4","NMFS",1997,4,8,98,30,42.283333,-66.45,4,3,1,4,0,"AL",0.038
"12190",551,"199702.264.1220.4","NMFS",1997,4,8,98,30,42.15,-66.366667,0,0,0,0,0,"AL",0.038
"12191",551,"199702.265.1210.3","NMFS",1997,4,8,98,30,42.15,-66.533333,0,0,0,0,0,"AL",0.038
"12192",551,"199702.266.1210.4","NMFS",1997,4,8,98,30,42.116667,-66.85,0,0,0,0,0,"AL",0.038
"12193",551,"199702.267.1300.3","NMFS",1997,4,8,98,30,42.316667,-66.966667,0,0,0,0,0,"AL",0.038
"12194",464,"199702.268.1290.6","NMFS",1997,4,8,98,30,42.55,-66.733333,0,0,0,0,0,"AL",0.038
"12195",464,"199702.269.1300.1","NMFS",1997,4,8,98,30,42.583333,-67.083333,0,0,0,0,0,"AL",0.038
"12196",464,"199702.270.1300.2","NMFS",1997,4,9,99,30,42.366667,-67.466667,0,0,0,0,0,"AL",0.038
"12197",561,"199702.271.1210.2","NMFS",1997,4,9,99,30,42.116667,-67.483333,2,2,0,2,0,"AL",0.038
"12198",561,"199702.272.1200.2","NMFS",1997,4,9,99,30,42.066667,-67.3,0,0,0,0,0,"AL",0.038
"12199",561,"199702.273.1200.1","NMFS",1997,4,9,99,30,41.966667,-67.483333,0,0,0,0,0,"AL",0.038
"12200",562,"199702.274.1190.1","NMFS",1997,4,9,99,30,41.683333,-67.383333,0,0,0,0,0,"AL",0.038
"12201",522,"199702.275.1200.3","NMFS",1997,4,9,99,30,41.85,-67.85,0,0,0,0,0,"AL",0.038
"12202",522,"199702.276.1220.2","NMFS",1997,4,9,99,30,42.05,-67.95,1,1,0,1,0,"AL",0.038
"12203",522,"199702.277.1220.1","NMFS",1997,4,9,99,30,42.133333,-67.816667,0,0,0,0,0,"AL",0.038
"12204",515,"199702.278.1290.2","NMFS",1997,4,9,99,30,42.566667,-67.866667,0,0,0,0,0,"AL",0.038
"12205",515,"199702.279.1360.3","NMFS",1997,4,10,100,30,42.866667,-68.016667,0,0,0,0,0,"AL",0.038
"12206",515,"199702.280.1290.7","NMFS",1997,4,10,100,30,42.666667,-68.066667,1,1,0,1,0,"AL",0.038
"12207",515,"199702.281.1290.8","NMFS",1997,4,10,100,30,42.55,-68.116667,1,1,0,1,0,"AL",0.038
"12208",522,"199702.282.1240.3","NMFS",1997,4,10,100,30,42.05,-68.383333,0,0,0,0,0,"AL",0.038
"12209",522,"199702.283.1240.1","NMFS",1997,4,10,100,30,42.05,-68.483333,0,0,0,0,0,"AL",0.038
"12210",521,"199702.284.1240.2","NMFS",1997,4,10,100,30,42.083333,-68.983333,0,0,0,0,0,"AL",0.038
"12211",514,"199702.285.3580.1","NMFS",1997,4,15,105,24,42.166667,-70.616667,6,4,2,3,3,"AL",0.038
"12212",514,"199702.286.1260.4","NMFS",1997,4,15,105,30,42.366667,-70.5,12,5,7,12,0,"AL",0.038
"12213",514,"199702.287.1260.2","NMFS",1997,4,15,105,30,42.4,-70.616667,46,17,29,45,1,"AL",0.038
"12214",514,"199702.289.3650.1","NMFS",1997,4,15,105,30,42.35,-70.7,146,61,85,137,9,"AL",0.038
"12215",514,"199702.290.3660.2","NMFS",1997,4,15,105,30,42.483333,-70.7,30,15,15,30,0,"AL",0.038
"12216",514,"199702.291.3630.1","NMFS",1997,4,15,105,30,42.55,-70.75,4,2,2,3,1,"AL",0.038
"12217",514,"199702.292.1260.5","NMFS",1997,4,15,105,30,42.5,-70.266667,4,2,2,4,0,"AL",0.038
"12218",514,"199702.293.1260.3","NMFS",1997,4,15,105,30,42.616667,-70.25,2,1,1,2,0,"AL",0.038
"12219",514,"199702.294.3660.1","NMFS",1997,4,15,105,30,42.716667,-70.516667,9,3,6,9,0,"AL",0.038
"12220",514,"199702.295.3640.1","NMFS",1997,4,16,106,30,42.75,-70.75,3,1,2,2,1,"AL",0.038
"12221",514,"199702.296.1400.3","NMFS",1997,4,16,106,30,42.833333,-70.566667,4,0,4,4,0,"AL",0.038
"12222",513,"199702.297.1400.1","NMFS",1997,4,16,106,30,42.966667,-70.416667,13,6,7,13,0,"AL",0.038
"12223",513,"199702.298.1270.3","NMFS",1997,4,16,106,30,43.083333,-70.2,1,0,1,1,0,"AL",0.038
"12224",513,"199702.299.1270.2","NMFS",1997,4,16,106,30,42.883333,-70.033333,0,0,0,0,0,"AL",0.038
"12225",514,"199702.300.1270.4","NMFS",1997,4,16,106,30,42.75,-70.033333,8,8,0,8,0,"AL",0.038
"12226",513,"199702.301.1370.5","NMFS",1997,4,16,106,30,43,-69.566667,0,0,0,0,0,"AL",0.038
"12227",513,"199702.302.1370.4","NMFS",1997,4,16,106,30,43.2,-69.716667,0,0,0,0,0,"AL",0.038
"12228",513,"199702.303.1380.1","NMFS",1997,4,16,106,30,43.35,-69.883333,2,2,0,2,0,"AL",0.038
"12229",513,"199702.304.1400.2","NMFS",1997,4,16,106,30,43.416667,-70.1,7,3,4,7,0,"AL",0.038
"12230",513,"199702.305.1380.4","NMFS",1997,4,17,107,30,43.583333,-69.55,3,3,0,3,0,"AL",0.038
"12231",512,"199702.306.1390.4","NMFS",1997,4,17,107,30,43.833333,-68.75,35,15,20,32,3,"AL",0.038
"12232",512,"199702.307.1390.3","NMFS",1997,4,17,107,30,43.933333,-68.8,35,21,14,35,0,"AL",0.038
"12233",512,"199702.308.1390.2","NMFS",1997,4,17,107,30,43.983333,-68.416667,0,0,0,0,0,"AL",0.038
"12234",512,"199702.309.1380.5","NMFS",1997,4,17,107,30,43.933333,-68.166667,4,2,2,4,0,"AL",0.038
"12235",512,"199702.310.1390.5","NMFS",1997,4,17,107,26,44.15,-68.1,6,3,3,6,0,"AL",0.038
"12236",511,"199702.311.1380.3","NMFS",1997,4,17,107,30,44.116667,-67.666667,1,1,0,1,0,"AL",0.038
"12237",511,"199702.312.1390.1","NMFS",1997,4,17,107,30,44.416667,-67.5,18,8,10,17,1,"AL",0.038
"12238",511,"199702.313.1351.1","NMFS",1997,4,18,108,30,44.283333,-67.233333,3,2,1,3,0,"AL",0.038
"12239",511,"199702.314.1351.2","NMFS",1997,4,18,108,30,44.3,-67.083333,1,1,0,1,0,"AL",0.038
"12240",511,"199702.315.1340.4","NMFS",1997,4,18,108,30,44.116667,-67.15,0,0,0,0,0,"AL",0.038
"12241",465,"199702.316.1340.6","NMFS",1997,4,18,108,30,43.816667,-67.35,1,1,0,1,0,"AL",0.038
"12242",465,"199702.317.1340.1","NMFS",1997,4,18,108,30,43.833333,-66.75,3,0,3,3,0,"AL",0.038
"12243",465,"199702.318.1330.3","NMFS",1997,4,18,108,30,44,-66.583333,8,4,4,8,0,"AL",0.038
"12244",465,"199702.319.1330.4","NMFS",1997,4,20,110,30,43.566667,-66.416667,1,0,1,1,0,"AL",0.038
"12245",465,"199702.320.1330.2","NMFS",1997,4,20,110,30,43.483333,-66.25,2,2,0,2,0,"AL",0.038
"12246",465,"199702.321.1330.1","NMFS",1997,4,21,111,30,43.383333,-66.516667,2,1,1,2,0,"AL",0.038
"12247",465,"199702.322.1340.2","NMFS",1997,4,21,111,30,43.366667,-66.783333,1,1,0,1,0,"AL",0.038
"12248",465,"199702.323.1340.5","NMFS",1997,4,21,111,30,43.283333,-66.8,1,0,1,1,0,"AL",0.038
"12249",464,"199702.324.1360.8","NMFS",1997,4,21,111,30,42.966667,-66.7,0,0,0,0,0,"AL",0.038
"12250",464,"199702.325.1340.3","NMFS",1997,4,21,111,30,42.983333,-66.85,0,0,0,0,0,"AL",0.038
"12251",465,"199702.326.1360.6","NMFS",1997,4,21,111,30,43.3,-66.983333,0,0,0,0,0,"AL",0.038
"12252",465,"199702.327.1360.4","NMFS",1997,4,21,111,30,43.466667,-67.166667,2,2,0,2,0,"AL",0.038
"12253",465,"199702.328.1360.5","NMFS",1997,4,21,111,30,43.3,-67.316667,1,0,1,1,0,"AL",0.038
"12254",515,"199702.329.1360.1","NMFS",1997,4,21,111,30,43.2,-67.833333,0,0,0,0,0,"AL",0.038
"12255",515,"199702.330.1360.7","NMFS",1997,4,21,111,30,43.233333,-68.066667,0,0,0,0,0,"AL",0.038
"12256",515,"199702.331.1360.2","NMFS",1997,4,22,112,30,43.316667,-68.216667,0,0,0,0,0,"AL",0.038
"12257",512,"199702.332.1380.2","NMFS",1997,4,22,112,30,43.466667,-68.25,0,0,0,0,0,"AL",0.038
"12258",515,"199702.333.1370.2","NMFS",1997,4,22,112,30,43.3,-68.583333,0,0,0,0,0,"AL",0.038
"12259",515,"199702.334.1280.3","NMFS",1997,4,22,112,30,42.583333,-68.6,0,0,0,0,0,"AL",0.038
"12260",515,"199702.335.1280.7","NMFS",1997,4,22,112,30,42.5,-68.633333,1,1,0,1,0,"AL",0.038
"12261",515,"199702.336.1370.3","NMFS",1997,4,22,112,30,42.733333,-69.016667,1,1,0,1,0,"AL",0.038
"12262",515,"199702.337.1370.1","NMFS",1997,4,22,112,30,42.716667,-69.166667,0,0,0,0,0,"AL",0.038
"12263",526,"199706.171.1090.5","NMFS",1997,10,5,278,30,40.933333,-69.766667,0,0,0,0,0,"AL",0.038
"12264",526,"199706.172.1090.2","NMFS",1997,10,5,278,30,40.666667,-69.616667,1,0,1,1,0,"AL",0.038
"12265",526,"199706.173.1100.3","NMFS",1997,10,5,278,30,40.416667,-69.683333,1,0,1,1,0,"AL",0.038
"12266",526,"199706.174.1100.5","NMFS",1997,10,6,279,30,40.366667,-69.916667,1,0,1,0,1,"AL",0.038
"12267",526,"199706.175.1100.4","NMFS",1997,10,6,279,30,40.1,-69.8,0,0,0,0,0,"AL",0.038
"12268",526,"199706.176.1110.2","NMFS",1997,10,6,279,30,39.95,-69.466667,17,4,13,16,1,"AL",0.038
"12269",526,"199706.177.1100.6","NMFS",1997,10,6,279,30,40.15,-69.416667,3,2,1,3,0,"AL",0.038
"12270",526,"199706.178.1100.7","NMFS",1997,10,6,279,30,40.433333,-69.283333,1,0,1,1,0,"AL",0.038
"12271",526,"199706.179.1090.1","NMFS",1997,10,6,279,30,40.65,-69.316667,0,0,0,0,0,"AL",0.038
"12272",526,"199706.180.1100.1","NMFS",1997,10,6,279,30,40.783333,-69.133333,1,0,1,1,0,"AL",0.038
"12273",526,"199706.181.3550.4","NMFS",1997,10,6,279,30,40.966667,-69.55,0,0,0,0,0,"AL",0.038
"12274",521,"199706.182.3550.5","NMFS",1997,10,6,279,30,41.116667,-69.416667,0,0,0,0,0,"AL",0.038
"12275",521,"199706.183.3550.2","NMFS",1997,10,6,279,30,41.05,-69.416667,0,0,0,0,0,"AL",0.038
"12276",526,"199706.184.1090.4","NMFS",1997,10,7,280,30,40.866667,-69.266667,1,1,0,1,0,"AL",0.038
"12277",521,"199706.185.1250.2","NMFS",1997,10,7,280,26.9,41.033333,-69.283333,2,1,1,2,0,"AL",0.038
"12278",521,"199706.186.1250.1","NMFS",1997,10,7,280,27,41.15,-69.25,0,0,0,0,0,"AL",0.038
"12279",521,"199706.187.1250.3","NMFS",1997,10,7,280,30,41.2,-69.333333,0,0,0,0,0,"AL",0.038
"12280",521,"199706.188.3550.1","NMFS",1997,10,7,280,30,41.35,-69.566667,23,12,11,23,0,"AL",0.038
"12281",521,"199706.189.3550.3","NMFS",1997,10,7,280,30,41.416667,-69.616667,10,7,3,9,1,"AL",0.038
"12282",521,"199706.190.3560.1","NMFS",1997,10,7,280,30,41.75,-69.916667,0,0,0,0,0,"AL",0.038
"12283",521,"199706.191.1230.3","NMFS",1997,10,7,280,30,41.616667,-69.55,0,0,0,0,0,"AL",0.038
"12284",521,"199706.192.1250.4","NMFS",1997,10,7,280,30,41.533333,-69.466667,0,0,0,0,0,"AL",0.038
"12285",521,"199706.193.1240.2","NMFS",1997,10,7,280,30,41.6,-69.15,1,0,1,1,0,"AL",0.038
"12286",521,"199706.195.1230.4","NMFS",1997,10,8,281,20,41.066667,-68.933333,0,0,0,0,0,"AL",0.038
"12287",521,"199706.196.1230.14","NMFS",1997,10,8,281,30,41.1,-68.9,1,1,0,1,0,"AL",0.038
"12288",522,"199706.197.1190.6","NMFS",1997,10,8,281,30,41.05,-68.583333,2,0,2,2,0,"AL",0.038
"12289",526,"199706.199.1100.8","NMFS",1997,10,8,281,30,40.55,-68.866667,1,0,1,1,0,"AL",0.038
"12290",525,"199706.200.1140.1","NMFS",1997,10,8,281,30,40.25,-68.6,1,1,0,1,0,"AL",0.038
"12291",525,"199706.201.1130.8","NMFS",1997,10,8,281,30,40.416667,-68.416667,1,1,0,1,0,"AL",0.038
"12292",525,"199706.202.1190.3","NMFS",1997,10,8,281,29,40.816667,-68.3,0,0,0,0,0,"AL",0.038
"12293",525,"199706.203.1130.1","NMFS",1997,10,9,282,30,40.766667,-68.05,0,0,0,0,0,"AL",0.038
"12294",525,"199706.204.1140.2","NMFS",1997,10,9,282,30,40.45,-67.833333,0,0,0,0,0,"AL",0.038
"12295",525,"199706.205.1130.7","NMFS",1997,10,9,282,30,40.516667,-67.833333,0,0,0,0,0,"AL",0.038
"12296",525,"199706.206.1130.9","NMFS",1997,10,9,282,30,40.816667,-67.683333,1,1,0,1,0,"AL",0.038
"12297",525,"199706.207.1130.2","NMFS",1997,10,9,282,30,40.983333,-67.516667,0,0,0,0,0,"AL",0.038
"12298",525,"199706.208.1130.3","NMFS",1997,10,9,282,30,41.083333,-67.366667,0,0,0,0,0,"AL",0.038
"12299",525,"199706.209.1130.4","NMFS",1997,10,9,282,30,40.933333,-67.4,0,0,0,0,0,"AL",0.038
"12300",525,"199706.210.1130.6","NMFS",1997,10,9,282,30,40.8,-67.316667,1,1,0,1,0,"AL",0.038
"12301",525,"199706.211.1140.3","NMFS",1997,10,9,282,30,40.616667,-67.216667,0,0,0,0,0,"AL",0.038
"12302",525,"199706.212.1150.1","NMFS",1997,10,9,282,30,40.533333,-67.133333,0,0,0,0,0,"AL",0.038
"12303",525,"199706.213.1130.5","NMFS",1997,10,9,282,30,40.766667,-67.083333,1,1,0,1,0,"AL",0.038
"12304",562,"199706.214.1160.6","NMFS",1997,10,9,282,30,40.85,-66.766667,2,2,0,2,0,"AL",0.038
"12305",562,"199706.215.1160.9","NMFS",1997,10,10,283,30,41.15,-66.533333,2,2,0,2,0,"AL",0.038
"12306",562,"199706.217.1190.7","NMFS",1997,10,10,283,30,41.4,-67.333333,0,0,0,0,0,"AL",0.038
"12307",562,"199706.218.1190.8","NMFS",1997,10,10,283,30,41.416667,-67.4,0,0,0,0,0,"AL",0.038
"12308",562,"199706.219.1190.2","NMFS",1997,10,10,283,30,41.566667,-67.35,19,9,10,16,3,"AL",0.038
"12309",562,"199706.220.1190.9","NMFS",1997,10,10,283,30,41.616667,-67.283333,7,2,5,5,2,"AL",0.038
"12310",562,"199706.221.1190.5","NMFS",1997,10,10,283,30,41.65,-67.166667,14,9,5,10,4,"AL",0.038
"12311",562,"199706.222.1160.10","NMFS",1997,10,10,283,30,41.516667,-66.983333,4,4,0,3,1,"AL",0.038
"12312",562,"199706.223.1160.3","NMFS",1997,10,10,283,30,41.4,-66.883333,0,0,0,0,0,"AL",0.038
"12313",562,"199706.224.1160.1","NMFS",1997,10,10,283,30,41.483333,-66.75,0,0,0,0,0,"AL",0.038
"12314",562,"199706.225.1160.8","NMFS",1997,10,10,283,30,41.316667,-66.566667,2,2,0,2,0,"AL",0.038
"12315",552,"199706.227.1180.2","NMFS",1997,10,11,284,30,41.383333,-66.016667,0,0,0,0,0,"AL",0.038
"12316",552,"199706.228.1170.2","NMFS",1997,10,11,284,30,41.4,-66.083333,1,1,0,1,0,"AL",0.038
"12317",552,"199706.229.1160.2","NMFS",1997,10,11,284,30,41.566667,-66.216667,0,0,0,0,0,"AL",0.038
"12318",552,"199706.230.1160.5","NMFS",1997,10,11,284,30,41.683333,-66.2,0,0,0,0,0,"AL",0.038
"12319",552,"199706.231.1170.3","NMFS",1997,10,11,284,30,41.75,-65.75,0,0,0,0,0,"AL",0.038
"12320",551,"199706.232.1170.1","NMFS",1997,10,11,284,30,41.966667,-65.866667,0,0,0,0,0,"AL",0.038
"12321",464,"199706.233.1290.2","NMFS",1997,10,11,284,30,42.233333,-65.883333,0,0,0,0,0,"AL",0.038
"12322",464,"199706.234.1290.8","NMFS",1997,10,11,284,30,42.433333,-66.083333,0,0,0,0,0,"AL",0.038
"12323",464,"199706.235.1290.4","NMFS",1997,10,12,285,30,42.566667,-66.816667,0,0,0,0,0,"AL",0.038
"12324",464,"199706.236.1300.3","NMFS",1997,10,12,285,30,42.466667,-67.1,0,0,0,0,0,"AL",0.038
"12325",464,"199706.237.1300.2","NMFS",1997,10,12,285,30,42.35,-66.7,0,0,0,0,0,"AL",0.038
"12326",464,"199706.238.1300.1","NMFS",1997,10,12,285,30,42.383333,-66.6,0,0,0,0,0,"AL",0.038
"12327",551,"199706.239.1210.1","NMFS",1997,10,12,285,30,42.133333,-66.5,0,0,0,0,0,"AL",0.038
"12328",551,"199706.241.1160.4","NMFS",1997,10,12,285,30,41.85,-66.55,0,0,0,0,0,"AL",0.038
"12329",561,"199706.242.1190.1","NMFS",1997,10,12,285,30,41.85,-67.016667,1,1,0,0,1,"AL",0.038
"12330",551,"199706.243.1160.7","NMFS",1997,10,12,285,30,41.983333,-66.95,0,0,0,0,0,"AL",0.038
"12331",551,"199706.244.1210.4","NMFS",1997,10,12,285,30,42.15,-66.883333,0,0,0,0,0,"AL",0.038
"12332",551,"199706.245.1220.2","NMFS",1997,10,12,285,30,42.183333,-66.9,0,0,0,0,0,"AL",0.038
"12333",561,"199706.247.1200.3","NMFS",1997,10,13,286,30,42.05,-67.166667,0,0,0,0,0,"AL",0.038
"12334",522,"199706.249.1200.1","NMFS",1997,10,13,286,30,41.816667,-67.666667,0,0,0,0,0,"AL",0.038
"12335",561,"199706.250.1200.4","NMFS",1997,10,13,286,30,41.95,-67.55,1,0,1,1,0,"AL",0.038
"12336",522,"199706.251.1220.3","NMFS",1997,10,13,286,30,42.2,-67.666667,0,0,0,0,0,"AL",0.038
"12337",522,"199706.252.1290.5","NMFS",1997,10,13,286,30,42.25,-67.816667,0,0,0,0,0,"AL",0.038
"12338",522,"199706.253.1210.2","NMFS",1997,10,13,286,30,42,-67.783333,0,0,0,0,0,"AL",0.038
"12339",522,"199706.254.1220.4","NMFS",1997,10,13,286,30,42.05,-67.983333,0,0,0,0,0,"AL",0.038
"12340",522,"199706.255.1290.1","NMFS",1997,10,13,286,30,42,-68.133333,1,1,0,1,0,"AL",0.038
"12341",522,"199706.256.1220.1","NMFS",1997,10,13,286,30,41.95,-68.066667,0,0,0,0,0,"AL",0.038
"12342",522,"199706.257.1210.3","NMFS",1997,10,14,287,30,41.916667,-67.95,0,0,0,0,0,"AL",0.038
"12343",522,"199706.258.1200.2","NMFS",1997,10,14,287,30,41.733333,-67.933333,3,2,1,3,0,"AL",0.038
"12344",522,"199706.259.1290.7","NMFS",1997,10,14,287,30,41.833333,-68.316667,0,0,0,0,0,"AL",0.038
"12345",522,"199706.260.1200.6","NMFS",1997,10,14,287,30,41.483333,-68.316667,1,0,1,1,0,"AL",0.038
"12346",522,"199706.261.1200.5","NMFS",1997,10,14,287,30,41.35,-68.3,7,5,2,7,0,"AL",0.038
"12347",525,"199706.262.1190.4","NMFS",1997,10,14,287,30,41.15,-68.1,4,1,3,4,0,"AL",0.038
"12348",522,"199706.263.1230.5","NMFS",1997,10,14,287,30,41.283333,-68.483333,1,0,1,1,0,"AL",0.038
"12349",522,"199706.265.1230.1","NMFS",1997,10,14,287,30,41.516667,-68.6,0,0,0,0,0,"AL",0.038
"12350",522,"199706.266.1240.5","NMFS",1997,10,15,288,30,42.066667,-68.516667,0,0,0,0,0,"AL",0.038
"12351",522,"199706.267.1240.3","NMFS",1997,10,15,288,30,42.183333,-68.566667,0,0,0,0,0,"AL",0.038
"12352",515,"199706.268.1290.3","NMFS",1997,10,15,288,30,42.483333,-68.116667,0,0,0,0,0,"AL",0.038
"12353",464,"199706.269.1360.5","NMFS",1997,10,15,288,30,42.816667,-67.566667,1,0,1,1,0,"AL",0.038
"12354",464,"199706.270.1360.4","NMFS",1997,10,15,288,30,42.816667,-67.233333,0,0,0,0,0,"AL",0.038
"12355",465,"199706.271.1340.4","NMFS",1997,10,15,288,30,43.033333,-66.85,0,0,0,0,0,"AL",0.038
"12356",465,"199706.272.1340.1","NMFS",1997,10,15,288,30,43.133333,-66.65,2,2,0,2,0,"AL",0.038
"12357",465,"199706.273.1330.1","NMFS",1997,10,15,288,30,43.35,-66.416667,2,1,1,1,1,"AL",0.038
"12358",465,"199706.274.1330.2","NMFS",1997,10,16,289,30,43.566667,-66.483333,0,0,0,0,0,"AL",0.038
"12359",465,"199706.275.1360.1","NMFS",1997,10,16,289,30,43.133333,-67.433333,0,0,0,0,0,"AL",0.038
"12360",515,"199706.276.1290.6","NMFS",1997,10,16,289,30,42.5,-68.416667,0,0,0,0,0,"AL",0.038
"12361",515,"199706.277.1240.4","NMFS",1997,10,16,289,30,42.416667,-68.566667,0,0,0,0,0,"AL",0.038
"12362",515,"199706.278.1280.1","NMFS",1997,10,16,289,30,42.383333,-68.716667,0,0,0,0,0,"AL",0.038
"12363",521,"199706.279.1240.6","NMFS",1997,10,16,289,30,42.216667,-68.866667,1,0,1,1,0,"AL",0.038
"12364",521,"199706.280.1280.4","NMFS",1997,10,16,289,30,42.1,-69.35,0,0,0,0,0,"AL",0.038
"12365",521,"199706.281.1240.1","NMFS",1997,10,17,290,30,42.066667,-69.783333,0,0,0,0,0,"AL",0.038
"12366",521,"199706.282.1230.2","NMFS",1997,10,17,290,30,41.933333,-69.766667,0,0,0,0,0,"AL",0.038
"12367",514,"199706.283.3580.1","NMFS",1997,10,21,294,30,41.783333,-70.216667,2,1,1,1,1,"AL",0.038
"12368",514,"199706.284.3590.1","NMFS",1997,10,21,294,30,41.866667,-70.2,8,2,6,8,0,"AL",0.038
"12369",514,"199706.285.3600.1","NMFS",1997,10,21,294,30,41.9,-70.416667,178,74,104,128,50,"AL",0.038
"12370",514,"199706.286.3610.2","NMFS",1997,10,21,294,30,42.066667,-70.333333,17,8,9,17,0,"AL",0.038
"12371",514,"199706.288.3610.3","NMFS",1997,10,22,295,30,42.066667,-70.5,89,40,49,76,13,"AL",0.038
"12372",514,"199706.289.3600.2","NMFS",1997,10,22,295,30,42.133333,-70.516667,89,51,38,89,0,"AL",0.038
"12373",514,"199706.290.3660.2","NMFS",1997,10,22,295,30,42.2,-70.5,41,19,22,40,1,"AL",0.038
"12374",514,"199706.291.1260.4","NMFS",1997,10,22,295,30,42.2,-70.316667,14,7,7,14,0,"AL",0.038
"12375",514,"199706.292.1270.4","NMFS",1997,10,22,295,30,42.366667,-70.033333,0,0,0,0,0,"AL",0.038
"12376",514,"199706.293.1280.6","NMFS",1997,10,22,295,30,42.35,-69.883333,0,0,0,0,0,"AL",0.038
"12377",521,"199706.294.1270.3","NMFS",1997,10,22,295,30,42.233333,-69.883333,4,2,2,4,0,"AL",0.038
"12378",515,"199706.295.1280.5","NMFS",1997,10,22,295,30,42.366667,-69.383333,0,0,0,0,0,"AL",0.038
"12379",515,"199706.296.1370.1","NMFS",1997,10,22,295,30,42.7,-69.233333,0,0,0,0,0,"AL",0.038
"12380",515,"199706.297.1370.2","NMFS",1997,10,22,295,30,42.816667,-69.283333,0,0,0,0,0,"AL",0.038
"12381",513,"199706.298.1370.4","NMFS",1997,10,23,296,30,43.05,-69.516667,0,0,0,0,0,"AL",0.038
"12382",513,"199706.299.1370.5","NMFS",1997,10,23,296,30,43.266667,-69.116667,0,0,0,0,0,"AL",0.038
"12383",513,"199706.300.1380.4","NMFS",1997,10,23,296,30,43.466667,-69.133333,0,0,0,0,0,"AL",0.038
"12384",512,"199706.301.1380.1","NMFS",1997,10,23,296,30,43.35,-68.833333,0,0,0,0,0,"AL",0.038
"12385",515,"199706.302.1370.3","NMFS",1997,10,23,296,30,42.916667,-68.65,0,0,0,0,0,"AL",0.038
"12386",515,"199706.303.1360.2","NMFS",1997,10,23,296,30,43.25,-68.066667,0,0,0,0,0,"AL",0.038
"12387",512,"199706.304.1360.3","NMFS",1997,10,23,296,30,43.483333,-67.833333,0,0,0,0,0,"AL",0.038
"12388",512,"199706.305.1360.6","NMFS",1997,10,23,296,30,43.516667,-67.75,0,0,0,0,0,"AL",0.038
"12389",465,"199706.306.1340.2","NMFS",1997,10,24,297,30,43.783333,-66.9,0,0,0,0,0,"AL",0.038
"12390",511,"199706.307.1340.3","NMFS",1997,10,24,297,30,44,-67.15,1,1,0,1,0,"AL",0.038
"12391",511,"199706.308.1340.5","NMFS",1997,10,24,297,30,44.066667,-66.883333,0,0,0,0,0,"AL",0.038
"12392",466,"199706.309.1351.2","NMFS",1997,10,24,297,30,44.1,-66.8,0,0,0,0,0,"AL",0.038
"12393",465,"199706.310.1340.6","NMFS",1997,10,24,297,30,43.983333,-66.783333,3,3,0,3,0,"AL",0.038
"12394",465,"199706.311.1330.4","NMFS",1997,10,24,297,30,43.95,-66.55,5,3,2,5,0,"AL",0.038
"12395",466,"199706.312.1330.3","NMFS",1997,10,24,297,30,44.15,-66.65,1,0,1,1,0,"AL",0.038
"12396",467,"199706.313.1351.1","NMFS",1997,10,24,297,30,44.35,-66.916667,0,0,0,0,0,"AL",0.038
"12397",511,"199706.314.1360.8","NMFS",1997,10,24,297,30,44.266667,-67.35,0,0,0,0,0,"AL",0.038
"12398",511,"199706.315.1360.7","NMFS",1997,10,25,298,30,44.1,-67.516667,0,0,0,0,0,"AL",0.038
"12399",512,"199706.316.1390.4","NMFS",1997,10,25,298,30,44.183333,-67.883333,5,1,4,4,1,"AL",0.038
"12400",512,"199706.317.1390.2","NMFS",1997,10,25,298,30,44.183333,-68.016667,16,13,3,15,1,"AL",0.038
"12401",512,"199706.318.1380.2","NMFS",1997,10,25,298,30,43.95,-68.083333,0,0,0,0,0,"AL",0.038
"12402",512,"199706.319.1390.3","NMFS",1997,10,25,298,30,44,-68.4,14,10,4,14,0,"AL",0.038
"12403",512,"199706.321.1390.1","NMFS",1997,10,25,298,30,43.9,-68.6,33,18,15,32,1,"AL",0.038
"12404",513,"199706.322.1400.2","NMFS",1997,10,25,298,27,43.75,-69.416667,11,5,6,11,0,"AL",0.038
"12405",513,"199706.323.1400.1","NMFS",1997,10,25,298,30,43.633333,-69.716667,8,3,5,8,0,"AL",0.038
"12406",513,"199706.324.1380.5","NMFS",1997,10,26,299,30,43.466667,-69.866667,0,0,0,0,0,"AL",0.038
"12407",513,"199706.325.1380.3","NMFS",1997,10,26,299,30,43.3,-69.866667,0,0,0,0,0,"AL",0.038
"12408",513,"199706.326.1260.3","NMFS",1997,10,26,299,30,43.15,-70.033333,0,0,0,0,0,"AL",0.038
"12409",513,"199706.327.1280.3","NMFS",1997,10,26,299,30,42.95,-69.9,0,0,0,0,0,"AL",0.038
"12410",513,"199706.328.1270.2","NMFS",1997,10,26,299,30,42.9,-70.033333,0,0,0,0,0,"AL",0.038
"12411",513,"199706.329.1270.1","NMFS",1997,10,26,299,30,42.966667,-70.25,0,0,0,0,0,"AL",0.038
"12412",513,"199706.330.1400.3","NMFS",1997,10,26,299,30,42.85,-70.566667,1,0,1,1,0,"AL",0.038
"12413",514,"199706.331.1260.5","NMFS",1997,10,26,299,30,42.683333,-70.283333,0,0,0,0,0,"AL",0.038
"12414",514,"199706.332.1260.2","NMFS",1997,10,26,299,30,42.55,-70.1,0,0,0,0,0,"AL",0.038
"12415",514,"199706.333.1260.1","NMFS",1997,10,26,299,30,42.483333,-70.316667,1,0,1,1,0,"AL",0.038
"12416",514,"199706.334.3650.1","NMFS",1997,10,27,300,30,42.45,-70.783333,131,80,51,116,15,"AL",0.038
"12417",514,"199706.336.3660.1","NMFS",1997,10,27,300,30,42.416667,-70.716667,49,31,18,44,5,"AL",0.038
"12418",521,"199706.338.1280.7","NMFS",1997,10,27,300,30,41.95,-69.466667,1,0,1,1,0,"AL",0.038
"12419",521,"199706.339.1280.2","NMFS",1997,10,27,300,30,41.983333,-69.3,0,0,0,0,0,"AL",0.038
"12420",526,"199802.179.1090.4","NMFS",1998,3,23,82,30,40.8,-69.8,0,0,0,0,0,"AL",0.038
"12421",526,"199802.180.1100.4","NMFS",1998,3,23,82,30,40.35,-69.833333,0,0,0,0,0,"AL",0.038
"12422",526,"199802.181.1100.8","NMFS",1998,3,23,82,30,40.233333,-69.833333,0,0,0,0,0,"AL",0.038
"12423",526,"199802.188.1100.3","NMFS",1998,3,24,83,30,40.4,-69.083333,0,0,0,0,0,"AL",0.038
"12424",526,"199802.189.1100.6","NMFS",1998,3,24,83,30,40.433333,-68.983333,0,0,0,0,0,"AL",0.038
"12425",525,"199802.190.1150.1","NMFS",1998,3,24,83,30,40.116667,-68.683333,0,0,0,0,0,"AL",0.038
"12426",525,"199802.192.1140.1","NMFS",1998,3,25,84,30,40.466667,-68.233333,0,0,0,0,0,"AL",0.038
"12427",525,"199802.194.1140.2","NMFS",1998,3,25,84,30,40.45,-67.583333,0,0,0,0,0,"AL",0.038
"12428",525,"199802.195.1140.3","NMFS",1998,3,25,84,30,40.566667,-67.683333,0,0,0,0,0,"AL",0.038
"12429",525,"199802.196.1130.5","NMFS",1998,3,25,84,30,40.733333,-68.016667,0,0,0,0,0,"AL",0.038
"12430",525,"199802.197.1130.4","NMFS",1998,3,25,84,30,40.683333,-68.383333,0,0,0,0,0,"AL",0.038
"12431",525,"199802.198.1190.7","NMFS",1998,3,25,84,30,40.733333,-68.45,0,0,0,0,0,"AL",0.038
"12432",525,"199802.199.1130.1","NMFS",1998,3,25,84,30,40.566667,-68.616667,0,0,0,0,0,"AL",0.038
"12433",525,"199802.200.1130.3","NMFS",1998,3,25,84,30,40.7,-68.75,0,0,0,0,0,"AL",0.038
"12434",526,"199802.201.1100.1","NMFS",1998,3,25,84,30,40.866667,-69.15,0,0,0,0,0,"AL",0.038
"12435",521,"199802.202.1250.1","NMFS",1998,3,26,85,30,41.016667,-69.216667,0,0,0,0,0,"AL",0.038
"12436",521,"199802.203.1230.5","NMFS",1998,3,26,85,30,41.066667,-69.066667,0,0,0,0,0,"AL",0.038
"12437",522,"199802.204.1230.3","NMFS",1998,3,26,85,30,41.016667,-68.733333,0,0,0,0,0,"AL",0.038
"12438",525,"199802.205.1130.8","NMFS",1998,3,26,85,30,40.916667,-68.816667,0,0,0,0,0,"AL",0.038
"12439",526,"199802.206.1130.6","NMFS",1998,3,26,85,30,40.933333,-68.866667,0,0,0,0,0,"AL",0.038
"12440",526,"199802.207.3550.3","NMFS",1998,3,26,85,30,40.95,-69.4,0,0,0,0,0,"AL",0.038
"12441",526,"199802.208.3550.1","NMFS",1998,3,26,85,30,40.966667,-69.483333,0,0,0,0,0,"AL",0.038
"12442",526,"199802.209.3550.4","NMFS",1998,3,26,85,30,41.05,-69.5,0,0,0,0,0,"AL",0.038
"12443",521,"199802.210.3550.2","NMFS",1998,3,26,85,30,41.233333,-69.483333,0,0,0,0,0,"AL",0.038
"12444",521,"199802.211.1230.4","NMFS",1998,3,26,85,27,41.316667,-69.316667,0,0,0,0,0,"AL",0.038
"12445",521,"199802.212.1250.4","NMFS",1998,3,26,85,30,41.433333,-69.383333,0,0,0,0,0,"AL",0.038
"12446",521,"199802.213.1230.1","NMFS",1998,3,27,86,30,41.65,-69.583333,0,0,0,0,0,"AL",0.038
"12447",521,"199802.214.1250.2","NMFS",1998,3,27,86,30,41.55,-69.7,4,3,1,3,1,"AL",0.038
"12448",521,"199802.215.3550.5","NMFS",1998,3,27,86,30,41.466667,-69.666667,1,0,1,0,1,"AL",0.038
"12449",521,"199802.217.1250.3","NMFS",1998,3,31,90,30,42,-69.916667,4,4,0,3,1,"AL",0.038
"12450",521,"199802.218.1270.4","NMFS",1998,3,31,90,30,42.1,-69.85,7,7,0,7,0,"AL",0.038
"12451",514,"199802.219.3610.2","NMFS",1998,3,31,90,30,42.15,-70.05,0,0,0,0,0,"AL",0.038
"12452",521,"199802.220.1270.2","NMFS",1998,3,31,90,30,42.283333,-69.983333,2,1,1,2,0,"AL",0.038
"12453",514,"199802.221.1260.1","NMFS",1998,3,31,90,30,42.45,-70.133333,0,0,0,0,0,"AL",0.038
"12454",514,"199802.222.1260.3","NMFS",1998,3,31,90,30,42.55,-70.216667,0,0,0,0,0,"AL",0.038
"12455",514,"199802.223.1260.6","NMFS",1998,3,31,90,30,42.416667,-70.416667,0,0,0,0,0,"AL",0.038
"12456",514,"199802.225.3660.2","NMFS",1998,3,31,90,30,42.5,-70.716667,28,16,12,23,5,"AL",0.038
"12457",514,"199802.226.3640.2","NMFS",1998,4,1,91,21,42.45,-70.833333,14,9,5,13,1,"AL",0.038
"12458",514,"199802.227.3660.1","NMFS",1998,4,1,91,30,42.4,-70.7,57,22,35,54,3,"AL",0.038
"12459",514,"199802.229.3610.1","NMFS",1998,4,1,91,30,42.05,-70.35,75,32,43,73,2,"AL",0.038
"12460",514,"199802.230.3600.2","NMFS",1998,4,1,91,30,41.966667,-70.433333,18,7,11,14,4,"AL",0.038
"12461",514,"199802.231.3600.1","NMFS",1998,4,1,91,30,41.933333,-70.416667,14,13,1,12,2,"AL",0.038
"12462",514,"199802.232.3590.1","NMFS",1998,4,1,91,30,41.85,-70.266667,0,0,0,0,0,"AL",0.038
"12463",514,"199802.233.3580.1","NMFS",1998,4,1,91,30,41.833333,-70.2,0,0,0,0,0,"AL",0.038
"12464",521,"199802.234.1240.6","NMFS",1998,4,1,91,30,42.166667,-69.2,0,0,0,0,0,"AL",0.038
"12465",521,"199802.235.1280.4","NMFS",1998,4,1,91,30,41.95,-69.166667,0,0,0,0,0,"AL",0.038
"12466",521,"199802.236.1240.4","NMFS",1998,4,2,92,30,41.933333,-68.983333,0,0,0,0,0,"AL",0.038
"12467",522,"199802.237.1240.5","NMFS",1998,4,2,92,30,41.816667,-68.716667,0,0,0,0,0,"AL",0.038
"12468",522,"199802.238.1220.4","NMFS",1998,4,2,92,30,41.816667,-68.283333,0,0,0,0,0,"AL",0.038
"12469",522,"199802.239.1210.1","NMFS",1998,4,2,92,30,41.7,-68.366667,0,0,0,0,0,"AL",0.038
"12470",522,"199802.240.1200.5","NMFS",1998,4,2,92,30,41.683333,-68.233333,0,0,0,0,0,"AL",0.038
"12471",522,"199802.241.1200.3","NMFS",1998,4,2,92,30,41.633333,-67.766667,0,0,0,0,0,"AL",0.038
"12472",522,"199802.242.1200.4","NMFS",1998,4,2,92,30,41.533333,-67.933333,0,0,0,0,0,"AL",0.038
"12473",522,"199802.243.1190.3","NMFS",1998,4,2,92,29,41.4,-67.783333,0,0,0,0,0,"AL",0.038
"12474",522,"199802.244.1190.2","NMFS",1998,4,2,92,30,41.4,-67.916667,0,0,0,0,0,"AL",0.038
"12475",522,"199802.245.1190.4","NMFS",1998,4,2,92,30,41.433333,-67.933333,2,0,2,2,0,"AL",0.038
"12476",522,"199802.246.1200.6","NMFS",1998,4,2,92,30,41.45,-68,0,0,0,0,0,"AL",0.038
"12477",522,"199802.247.1240.1","NMFS",1998,4,3,93,30,41.35,-68.833333,0,0,0,0,0,"AL",0.038
"12478",521,"199802.248.1230.2","NMFS",1998,4,3,93,30,41.183333,-68.9,0,0,0,0,0,"AL",0.038
"12479",522,"199802.249.1200.2","NMFS",1998,4,3,93,27.5,41.15,-68.533333,0,0,0,0,0,"AL",0.038
"12480",525,"199802.250.1190.9","NMFS",1998,4,3,93,30,41.083333,-68.266667,0,0,0,0,0,"AL",0.038
"12481",525,"199802.251.1190.1","NMFS",1998,4,3,93,30,40.966667,-68.2,0,0,0,0,0,"AL",0.038
"12482",525,"199802.252.1190.8","NMFS",1998,4,3,93,30,41.05,-68.066667,0,0,0,0,0,"AL",0.038
"12483",525,"199802.253.1130.9","NMFS",1998,4,3,93,30,40.9,-67.65,0,0,0,0,0,"AL",0.038
"12484",525,"199802.254.1130.2","NMFS",1998,4,3,93,30,40.683333,-67.4,0,0,0,0,0,"AL",0.038
"12485",525,"199802.255.1130.7","NMFS",1998,4,3,93,30,40.65,-67.2,0,0,0,0,0,"AL",0.038
"12486",562,"199802.256.1170.3","NMFS",1998,4,4,94,30,40.866667,-66.683333,0,0,0,0,0,"AL",0.038
"12487",562,"199802.257.1160.2","NMFS",1998,4,4,94,30,41.016667,-66.583333,0,0,0,0,0,"AL",0.038
"12488",552,"199802.258.1170.1","NMFS",1998,4,4,94,30,41.216667,-66.3,0,0,0,0,0,"AL",0.038
"12489",562,"199802.259.1160.7","NMFS",1998,4,4,94,30,41.4,-66.683333,0,0,0,0,0,"AL",0.038
"12490",562,"199802.260.1160.5","NMFS",1998,4,4,94,30,41.283333,-66.85,0,0,0,0,0,"AL",0.038
"12491",562,"199802.261.1190.6","NMFS",1998,4,4,94,30,41.483333,-67.3,0,0,0,0,0,"AL",0.038
"12492",562,"199802.262.1160.9","NMFS",1998,4,4,94,30,41.566667,-66.883333,0,0,0,0,0,"AL",0.038
"12493",552,"199802.263.1160.6","NMFS",1998,4,4,94,30,41.733333,-66.683333,0,0,0,0,0,"AL",0.038
"12494",552,"199802.264.1160.1","NMFS",1998,4,5,95,30,41.566667,-66.066667,0,0,0,0,0,"AL",0.038
"12495",552,"199802.265.1170.2","NMFS",1998,4,5,95,30,41.816667,-65.85,0,0,0,0,0,"AL",0.038
"12496",551,"199802.266.1180.1","NMFS",1998,4,5,95,30,42.033333,-65.9,1,1,0,1,0,"AL",0.038
"12497",551,"199802.267.1160.8","NMFS",1998,4,5,95,30,41.983333,-66.016667,0,0,0,0,0,"AL",0.038
"12498",551,"199802.268.1160.4","NMFS",1998,4,5,95,30,42.066667,-66.383333,0,0,0,0,0,"AL",0.038
"12499",551,"199802.269.1220.3","NMFS",1998,4,5,95,30,42.15,-66.45,0,0,0,0,0,"AL",0.038
"12500",551,"199802.270.1160.10","NMFS",1998,4,5,95,30,41.983333,-66.616667,0,0,0,0,0,"AL",0.038
"12501",551,"199802.271.1160.3","NMFS",1998,4,5,95,30,41.933333,-66.733333,0,0,0,0,0,"AL",0.038
"12502",561,"199802.272.1190.5","NMFS",1998,4,6,96,30,41.95,-67.183333,0,0,0,0,0,"AL",0.038
"12503",522,"199802.273.1200.1","NMFS",1998,4,6,96,24.7,41.95,-67.75,0,0,0,0,0,"AL",0.038
"12504",522,"199802.274.1210.4","NMFS",1998,4,6,96,30,42.016667,-67.733333,0,0,0,0,0,"AL",0.038
"12505",561,"199802.275.1220.1","NMFS",1998,4,6,96,30,42.15,-67.583333,0,0,0,0,0,"AL",0.038
"12506",561,"199802.276.1290.1","NMFS",1998,4,6,96,30,42.233333,-67.383333,1,1,0,1,0,"AL",0.038
"12507",561,"199802.277.1290.9","NMFS",1998,4,6,96,30,42.216667,-67.4,5,5,0,5,0,"AL",0.038
"12508",551,"199802.278.1290.2","NMFS",1998,4,6,96,30,42.233333,-67.216667,0,0,0,0,0,"AL",0.038
"12509",561,"199802.279.1210.3","NMFS",1998,4,6,96,30,42.116667,-67.2,3,2,1,3,0,"AL",0.038
"12510",551,"199802.280.1210.2","NMFS",1998,4,6,96,30,42.116667,-66.966667,0,0,0,0,0,"AL",0.038
"12511",551,"199802.281.1220.2","NMFS",1998,4,7,97,30,42.183333,-66.883333,0,0,0,0,0,"AL",0.038
"12512",464,"199802.282.1300.3","NMFS",1998,4,7,97,30,42.366667,-66.716667,2,2,0,2,0,"AL",0.038
"12513",464,"199802.283.1300.2","NMFS",1998,4,7,97,30,42.383333,-66.566667,6,6,0,6,0,"AL",0.038
"12514",464,"199802.284.1290.7","NMFS",1998,4,7,97,30,42.4,-66.483333,5,5,0,5,0,"AL",0.038
"12515",464,"199802.285.1290.5","NMFS",1998,4,7,97,30,42.416667,-66.216667,1,1,0,1,0,"AL",0.038
"12516",464,"199802.286.1290.4","NMFS",1998,4,7,97,30,42.516667,-66.166667,1,0,1,1,0,"AL",0.038
"12517",464,"199802.287.1290.6","NMFS",1998,4,7,97,30,42.516667,-66.316667,0,0,0,0,0,"AL",0.038
"12518",464,"199802.289.1300.4","NMFS",1998,4,7,97,30,42.483333,-66.766667,1,1,0,1,0,"AL",0.038
"12519",464,"199802.290.1290.8","NMFS",1998,4,7,97,30,42.533333,-66.716667,1,1,0,1,0,"AL",0.038
"12520",464,"199802.291.1360.1","NMFS",1998,4,7,97,30,42.916667,-67.016667,0,0,0,0,0,"AL",0.038
"12521",465,"199802.292.1360.6","NMFS",1998,4,8,98,30,43.083333,-67.15,0,0,0,0,0,"AL",0.038
"12522",465,"199802.293.1360.8","NMFS",1998,4,8,98,30,43.233333,-67,0,0,0,0,0,"AL",0.038
"12523",465,"199802.294.1330.4","NMFS",1998,4,8,98,30,43.216667,-66.333333,1,0,1,1,0,"AL",0.038
"12524",465,"199802.295.1340.4","NMFS",1998,4,8,98,30,43.566667,-66.733333,1,0,1,1,0,"AL",0.038
"12525",465,"199802.296.1340.3","NMFS",1998,4,8,98,30,43.616667,-66.833333,0,0,0,0,0,"AL",0.038
"12526",465,"199802.297.1340.5","NMFS",1998,4,8,98,30,43.65,-66.566667,1,0,1,1,0,"AL",0.038
"12527",465,"199802.298.1330.2","NMFS",1998,4,8,98,30,43.75,-66.5,4,2,2,4,0,"AL",0.038
"12528",465,"199802.299.1330.3","NMFS",1998,4,8,98,30,43.766667,-66.383333,11,8,3,11,0,"AL",0.038
"12529",465,"199802.300.1330.1","NMFS",1998,4,8,98,30,43.916667,-66.633333,4,1,3,4,0,"AL",0.038
"12530",466,"199802.301.1351.2","NMFS",1998,4,9,99,30,44.083333,-66.766667,0,0,0,0,0,"AL",0.038
"12531",511,"199802.302.1351.1","NMFS",1998,4,9,99,30,44.3,-66.95,3,2,1,3,0,"AL",0.038
"12532",511,"199802.303.1340.1","NMFS",1998,4,9,99,30,44.116667,-67.066667,0,0,0,0,0,"AL",0.038
"12533",465,"199802.304.1340.6","NMFS",1998,4,9,99,30,43.8,-67.25,1,1,0,1,0,"AL",0.038
"12534",465,"199802.305.1340.2","NMFS",1998,4,9,99,30,43.633333,-67.166667,0,0,0,0,0,"AL",0.038
"12535",514,"199802.306.3590.2","NMFS",1998,4,13,103,30,41.85,-70.383333,4,1,3,4,0,"AL",0.038
"12536",514,"199802.307.3600.3","NMFS",1998,4,14,104,30,41.9,-70.25,0,0,0,0,0,"AL",0.038
"12537",514,"199802.308.3580.2","NMFS",1998,4,14,104,30,41.9,-70.133333,1,0,1,1,0,"AL",0.038
"12538",514,"199802.309.3610.3","NMFS",1998,4,14,104,30,42.066667,-70.45,21,13,8,19,2,"AL",0.038
"12539",514,"199802.310.1260.9","NMFS",1998,4,14,104,30,42.316667,-70.6,36,16,20,35,1,"AL",0.038
"12540",514,"199802.311.1260.7","NMFS",1998,4,14,104,30,42.316667,-70.1,1,1,0,1,0,"AL",0.038
"12541",514,"199802.312.1280.9","NMFS",1998,4,14,104,30,42.45,-69.883333,1,1,0,1,0,"AL",0.038
"12542",514,"199802.313.1260.4","NMFS",1998,4,14,104,30,42.816667,-70.366667,0,0,0,0,0,"AL",0.038
"12543",514,"199802.314.3650.1","NMFS",1998,4,14,104,30,42.733333,-70.633333,1,0,1,1,0,"AL",0.038
"12544",513,"199802.315.3640.1","NMFS",1998,4,14,104,30,42.85,-70.766667,1,0,1,1,0,"AL",0.038
"12545",513,"199802.316.1400.3","NMFS",1998,4,15,105,30,42.883333,-70.45,2,2,0,2,0,"AL",0.038
"12546",514,"199802.317.1260.2","NMFS",1998,4,15,105,30,42.766667,-70.4,11,7,4,11,0,"AL",0.038
"12547",513,"199802.318.1270.3","NMFS",1998,4,15,105,30,43.066667,-70.016667,5,5,0,5,0,"AL",0.038
"12548",513,"199802.319.1370.8","NMFS",1998,4,15,105,30,43.183333,-69.866667,0,0,0,0,0,"AL",0.038
"12549",513,"199802.320.1370.2","NMFS",1998,4,15,105,30,43.05,-69.5,0,0,0,0,0,"AL",0.038
"12550",515,"199802.321.1370.5","NMFS",1998,4,15,105,30,42.8,-69.5,0,0,0,0,0,"AL",0.038
"12551",515,"199802.322.1280.1","NMFS",1998,4,15,105,30,42.683333,-69.383333,0,0,0,0,0,"AL",0.038
"12552",515,"199802.323.1280.5","NMFS",1998,4,15,105,30,42.633333,-69.166667,0,0,0,0,0,"AL",0.038
"12553",515,"199802.324.1370.1","NMFS",1998,4,15,105,30,42.65,-69.133333,0,0,0,0,0,"AL",0.038
"12554",515,"199802.325.1280.7","NMFS",1998,4,15,105,30,42.5,-69.4,2,2,0,2,0,"AL",0.038
"12555",521,"199802.326.1270.6","NMFS",1998,4,15,105,30,42.166667,-69.8,2,2,0,2,0,"AL",0.038
"12556",521,"199802.327.1260.8","NMFS",1998,4,16,106,30,42.116667,-69.95,2,1,1,2,0,"AL",0.038
"12557",521,"199802.328.1280.10","NMFS",1998,4,16,106,30,42.05,-69.683333,0,0,0,0,0,"AL",0.038
"12558",521,"199802.329.1240.8","NMFS",1998,4,16,106,30,41.916667,-69.75,1,1,0,1,0,"AL",0.038
"12559",521,"199802.330.1280.8","NMFS",1998,4,16,106,30,41.916667,-69.333333,0,0,0,0,0,"AL",0.038
"12560",521,"199802.331.1240.9","NMFS",1998,4,16,106,30,42.066667,-68.883333,0,0,0,0,0,"AL",0.038
"12561",522,"199802.332.1240.7","NMFS",1998,4,16,106,30,42.1,-68.833333,0,0,0,0,0,"AL",0.038
"12562",522,"199802.333.1240.3","NMFS",1998,4,16,106,30,42.183333,-68.533333,0,0,0,0,0,"AL",0.038
"12563",515,"199802.334.1240.2","NMFS",1998,4,16,106,30,42.383333,-68.516667,0,0,0,0,0,"AL",0.038
"12564",515,"199802.335.1280.2","NMFS",1998,4,16,106,30,42.466667,-68.666667,0,0,0,0,0,"AL",0.038
"12565",515,"199802.336.1280.6","NMFS",1998,4,16,106,30,42.366667,-68.85,0,0,0,0,0,"AL",0.038
"12566",515,"199802.337.1280.3","NMFS",1998,4,16,106,30,42.483333,-69,1,1,0,1,0,"AL",0.038
"12567",515,"199802.338.1370.7","NMFS",1998,4,17,107,30,42.7,-68.8,0,0,0,0,0,"AL",0.038
"12568",515,"199802.339.1370.6","NMFS",1998,4,17,107,30,42.883333,-68.65,1,1,0,1,0,"AL",0.038
"12569",515,"199802.340.1370.4","NMFS",1998,4,17,107,30,42.966667,-68.566667,0,0,0,0,0,"AL",0.038
"12570",515,"199802.341.1280.11","NMFS",1998,4,17,107,30,42.716667,-68.516667,0,0,0,0,0,"AL",0.038
"12571",515,"199802.342.1290.3","NMFS",1998,4,17,107,30,42.616667,-68.283333,0,0,0,0,0,"AL",0.038
"12572",515,"199802.343.1360.7","NMFS",1998,4,17,107,30,42.916667,-68.166667,0,0,0,0,0,"AL",0.038
"12573",515,"199802.344.1360.3","NMFS",1998,4,17,107,30,42.933333,-68.066667,0,0,0,0,0,"AL",0.038
"12574",515,"199802.345.1360.9","NMFS",1998,4,17,107,30,43.266667,-68.133333,0,0,0,0,0,"AL",0.038
"12575",515,"199802.346.1360.4","NMFS",1998,4,17,107,30,43.316667,-68,0,0,0,0,0,"AL",0.038
"12576",465,"199802.347.1360.11","NMFS",1998,4,17,107,30,43.25,-67.55,0,0,0,0,0,"AL",0.038
"12577",512,"199802.348.1360.2","NMFS",1998,4,18,108,30,43.4,-67.716667,0,0,0,0,0,"AL",0.038
"12578",512,"199802.349.1360.10","NMFS",1998,4,18,108,30,43.533333,-67.7,0,0,0,0,0,"AL",0.038
"12579",465,"199802.350.1360.5","NMFS",1998,4,18,108,30,43.833333,-67.5,0,0,0,0,0,"AL",0.038
"12580",511,"199802.351.1390.7","NMFS",1998,4,18,108,30,44.333333,-67.483333,0,0,0,0,0,"AL",0.038
"12581",511,"199802.352.1390.3","NMFS",1998,4,18,108,30,44.3,-67.7,1,1,0,1,0,"AL",0.038
"12582",512,"199802.354.1390.9","NMFS",1998,4,18,108,26,44.233333,-67.933333,1,1,0,1,0,"AL",0.038
"12583",512,"199802.355.1390.6","NMFS",1998,4,18,108,30,43.866667,-68.416667,0,0,0,0,0,"AL",0.038
"12584",512,"199802.356.1390.4","NMFS",1998,4,18,108,20,43.816667,-68.8,24,12,12,24,0,"AL",0.038
"12585",512,"199802.358.1390.5","NMFS",1998,4,19,109,26,43.916667,-68.65,11,6,5,11,0,"AL",0.038
"12586",512,"199802.359.1390.2","NMFS",1998,4,19,109,30,43.816667,-68.6,2,1,1,2,0,"AL",0.038
"12587",512,"199802.360.1380.2","NMFS",1998,4,19,109,30,43.783333,-68.483333,1,1,0,1,0,"AL",0.038
"12588",512,"199802.362.1380.1","NMFS",1998,4,19,109,30,43.616667,-68.7,0,0,0,0,0,"AL",0.038
"12589",512,"199802.363.1380.6","NMFS",1998,4,19,109,30,43.516667,-68.566667,2,2,0,2,0,"AL",0.038
"12590",512,"199802.364.1380.7","NMFS",1998,4,19,109,30,43.516667,-68.65,0,0,0,0,0,"AL",0.038
"12591",515,"199802.365.1370.3","NMFS",1998,4,19,109,30,43.2,-68.95,0,0,0,0,0,"AL",0.038
"12592",513,"199802.366.1380.4","NMFS",1998,4,19,109,30,43.316667,-69.35,0,0,0,0,0,"AL",0.038
"12593",513,"199802.367.1380.5","NMFS",1998,4,19,109,30,43.483333,-69.166667,0,0,0,0,0,"AL",0.038
"12594",513,"199802.368.1380.8","NMFS",1998,4,19,109,30,43.466667,-69.4,3,3,0,3,0,"AL",0.038
"12595",513,"199802.369.1270.5","NMFS",1998,4,20,110,30,43.4,-70.033333,2,2,0,2,0,"AL",0.038
"12596",513,"199802.370.1400.2","NMFS",1998,4,20,110,30,43.433333,-70.083333,14,4,10,14,0,"AL",0.038
"12597",513,"199802.371.1270.1","NMFS",1998,4,20,110,30,43.316667,-70.066667,0,0,0,0,0,"AL",0.038
"12598",513,"199802.372.1400.5","NMFS",1998,4,20,110,30,43.3,-70.166667,9,2,7,9,0,"AL",0.038
"12599",513,"199802.373.1400.1","NMFS",1998,4,20,110,30,43.266667,-70.2,22,11,11,22,0,"AL",0.038
"12600",513,"199802.374.1400.4","NMFS",1998,4,20,110,24.5,43.266667,-70.35,17,10,7,14,3,"AL",0.038
"12601",526,"199804.165.3550.1","NMFS",1998,10,10,283,30,40.983333,-69.533333,1,0,1,1,0,"AL",0.038
"12602",521,"199804.166.3550.5","NMFS",1998,10,10,283,30,41.166667,-69.516667,0,0,0,0,0,"AL",0.038
"12603",521,"199804.167.3550.2","NMFS",1998,10,10,283,30,41.283333,-69.583333,0,0,0,0,0,"AL",0.038
"12604",521,"199804.168.1250.1","NMFS",1998,10,11,284,30,41.383333,-69.466667,5,1,4,5,0,"AL",0.038
"12605",521,"199804.169.1250.4","NMFS",1998,10,11,284,30,41.483333,-69.45,0,0,0,0,0,"AL",0.038
"12606",521,"199804.170.1250.3","NMFS",1998,10,11,284,30,41.1,-69.35,1,0,1,1,0,"AL",0.038
"12607",521,"199804.171.1250.2","NMFS",1998,10,11,284,30,41.05,-69.166667,0,0,0,0,0,"AL",0.038
"12608",526,"199804.172.3550.3","NMFS",1998,10,11,284,30,40.983333,-69.45,0,0,0,0,0,"AL",0.038
"12609",526,"199804.173.1090.1","NMFS",1998,10,11,284,30,40.833333,-69.433333,0,0,0,0,0,"AL",0.038
"12610",526,"199804.174.1090.2","NMFS",1998,10,11,284,30,40.633333,-69.566667,2,0,2,2,0,"AL",0.038
"12611",526,"199804.175.1100.3","NMFS",1998,10,11,284,30,40.35,-69.516667,0,0,0,0,0,"AL",0.038
"12612",526,"199804.176.1100.1","NMFS",1998,10,11,284,30,40.316667,-69.616667,2,1,1,1,1,"AL",0.038
"12613",526,"199804.177.1100.7","NMFS",1998,10,11,284,30,40.183333,-69.55,3,2,1,3,0,"AL",0.038
"12614",526,"199804.178.1100.2","NMFS",1998,10,11,284,30,40.1,-69.533333,2,1,1,2,0,"AL",0.038
"12615",526,"199804.179.1120.1","NMFS",1998,10,12,285,30,39.95,-69.35,1,1,0,1,0,"AL",0.038
"12616",526,"199804.180.1110.2","NMFS",1998,10,12,285,30,40.183333,-69.033333,1,1,0,1,0,"AL",0.038
"12617",525,"199804.181.1150.1","NMFS",1998,10,12,285,30,40.166667,-68.566667,0,0,0,0,0,"AL",0.038
"12618",525,"199804.182.1140.2","NMFS",1998,10,12,285,30,40.4,-68.266667,1,0,1,1,0,"AL",0.038
"12619",525,"199804.183.1130.4","NMFS",1998,10,12,285,30,40.483333,-68.333333,0,0,0,0,0,"AL",0.038
"12620",525,"199804.184.1130.1","NMFS",1998,10,12,285,30,40.583333,-68.15,0,0,0,0,0,"AL",0.038
"12621",525,"199804.185.1130.8","NMFS",1998,10,12,285,30,40.683333,-68.433333,0,0,0,0,0,"AL",0.038
"12622",525,"199804.186.1190.7","NMFS",1998,10,13,286,30,40.766667,-68.5,0,0,0,0,0,"AL",0.038
"12623",525,"199804.188.1130.5","NMFS",1998,10,13,286,30,40.766667,-68.233333,0,0,0,0,0,"AL",0.038
"12624",525,"199804.189.1130.6","NMFS",1998,10,13,286,30,40.8,-67.933333,1,1,0,1,0,"AL",0.038
"12625",525,"199804.190.1140.1","NMFS",1998,10,13,286,30,40.516667,-67.633333,0,0,0,0,0,"AL",0.038
"12626",525,"199804.193.1140.3","NMFS",1998,10,13,286,30,40.533333,-67.5,1,1,0,1,0,"AL",0.038
"12627",525,"199804.194.1130.7","NMFS",1998,10,13,286,30,40.6,-67.433333,0,0,0,0,0,"AL",0.038
"12628",525,"199804.195.1130.3","NMFS",1998,10,14,287,30,40.816667,-67.266667,2,2,0,2,0,"AL",0.038
"12629",525,"199804.196.1130.2","NMFS",1998,10,14,287,30,40.85,-67.35,0,0,0,0,0,"AL",0.038
"12630",525,"199804.197.1130.9","NMFS",1998,10,14,287,30,40.95,-67.466667,0,0,0,0,0,"AL",0.038
"12631",562,"199804.200.1160.5","NMFS",1998,10,14,287,30,41.383333,-67.033333,1,1,0,1,0,"AL",0.038
"12632",562,"199804.201.1160.8","NMFS",1998,10,14,287,30,41.483333,-67.05,4,4,0,4,0,"AL",0.038
"12633",525,"199804.202.1190.5","NMFS",1998,10,15,288,30,41.216667,-67.716667,0,0,0,0,0,"AL",0.038
"12634",525,"199804.203.1190.9","NMFS",1998,10,15,288,30,41.05,-67.95,0,0,0,0,0,"AL",0.038
"12635",525,"199804.204.1190.2","NMFS",1998,10,15,288,30,41.016667,-68.283333,0,0,0,0,0,"AL",0.038
"12636",525,"199804.205.1190.4","NMFS",1998,10,15,288,30,41.2,-68.116667,1,0,1,1,0,"AL",0.038
"12637",525,"199804.206.1190.6","NMFS",1998,10,15,288,30,41.283333,-68.116667,0,0,0,0,0,"AL",0.038
"12638",522,"199804.207.1200.6","NMFS",1998,10,15,288,30,41.25,-68.35,1,0,1,0,1,"AL",0.038
"12639",522,"199804.208.1200.4","NMFS",1998,10,15,288,30,41.483333,-68.283333,1,1,0,1,0,"AL",0.038
"12640",522,"199804.209.1230.5","NMFS",1998,10,15,288,30,41.35,-68.483333,0,0,0,0,0,"AL",0.038
"12641",522,"199804.210.1230.4","NMFS",1998,10,15,288,30,41.166667,-68.783333,0,0,0,0,0,"AL",0.038
"12642",521,"199804.211.1230.1","NMFS",1998,10,15,288,30,41.15,-68.9,0,0,0,0,0,"AL",0.038
"12643",521,"199804.212.1230.3","NMFS",1998,10,15,288,30,41.15,-68.966667,0,0,0,0,0,"AL",0.038
"12644",521,"199804.213.1230.2","NMFS",1998,10,15,288,30,41.033333,-69,0,0,0,0,0,"AL",0.038
"12645",521,"199804.214.3550.4","NMFS",1998,10,20,293,30,41.683333,-69.85,37,18,19,37,0,"AL",0.038
"12646",521,"199804.215.3560.1","NMFS",1998,10,20,293,30,41.933333,-69.95,2,2,0,2,0,"AL",0.038
"12647",521,"199804.216.1240.1","NMFS",1998,10,20,293,30,41.75,-69.633333,0,0,0,0,0,"AL",0.038
"12648",521,"199804.217.1240.5","NMFS",1998,10,20,293,30,41.833333,-69.333333,0,0,0,0,0,"AL",0.038
"12649",521,"199804.218.1280.4","NMFS",1998,10,20,293,30,41.916667,-69.266667,0,0,0,0,0,"AL",0.038
"12650",521,"199804.219.1240.6","NMFS",1998,10,20,293,30,41.766667,-68.983333,0,0,0,0,0,"AL",0.038
"12651",522,"199804.220.1240.2","NMFS",1998,10,20,293,30,41.7,-68.566667,1,1,0,1,0,"AL",0.038
"12652",522,"199804.221.1240.3","NMFS",1998,10,20,293,30,41.966667,-68.616667,0,0,0,0,0,"AL",0.038
"12653",522,"199804.222.1220.1","NMFS",1998,10,20,293,30,41.85,-68.216667,0,0,0,0,0,"AL",0.038
"12654",522,"199804.223.1210.2","NMFS",1998,10,21,294,30,41.816667,-68.166667,0,0,0,0,0,"AL",0.038
"12655",522,"199804.224.1210.4","NMFS",1998,10,21,294,30,41.783333,-68.283333,0,0,0,0,0,"AL",0.038
"12656",522,"199804.225.1200.3","NMFS",1998,10,21,294,30,41.7,-68.233333,0,0,0,0,0,"AL",0.038
"12657",522,"199804.226.1200.2","NMFS",1998,10,21,294,30,41.633333,-67.783333,0,0,0,0,0,"AL",0.038
"12658",522,"199804.227.1200.5","NMFS",1998,10,21,294,30,41.816667,-67.883333,0,0,0,0,0,"AL",0.038
"12659",522,"199804.228.1210.1","NMFS",1998,10,21,294,30,41.95,-67.866667,0,0,0,0,0,"AL",0.038
"12660",522,"199804.229.1220.4","NMFS",1998,10,21,294,30,41.983333,-68,0,0,0,0,0,"AL",0.038
"12661",522,"199804.230.1220.2","NMFS",1998,10,21,294,30,42.033333,-67.816667,0,0,0,0,0,"AL",0.038
"12662",522,"199804.231.1220.3","NMFS",1998,10,21,294,30,42.1,-67.716667,0,0,0,0,0,"AL",0.038
"12663",551,"199804.234.1160.4","NMFS",1998,10,21,294,30,42.05,-67.033333,4,3,1,3,1,"AL",0.038
"12664",561,"199804.235.1200.1","NMFS",1998,10,22,295,30,42.016667,-67.283333,0,0,0,0,0,"AL",0.038
"12665",562,"199804.236.1190.3","NMFS",1998,10,22,295,30,41.6,-67.233333,5,2,3,5,0,"AL",0.038
"12666",562,"199804.237.1190.1","NMFS",1998,10,22,295,30,41.483333,-67.266667,4,3,1,4,0,"AL",0.038
"12667",562,"199804.238.1190.8","NMFS",1998,10,22,295,30,41.316667,-67.3,0,0,0,0,0,"AL",0.038
"12668",552,"199804.240.1160.7","NMFS",1998,10,22,295,30,41.516667,-66.516667,0,0,0,0,0,"AL",0.038
"12669",552,"199804.241.1170.3","NMFS",1998,10,22,295,30,41.483333,-66.066667,1,0,1,1,0,"AL",0.038
"12670",552,"199804.242.1170.2","NMFS",1998,10,22,295,30,41.533333,-65.983333,0,0,0,0,0,"AL",0.038
"12671",552,"199804.243.1170.1","NMFS",1998,10,22,295,30,41.683333,-65.883333,0,0,0,0,0,"AL",0.038
"12672",552,"199804.244.1160.6","NMFS",1998,10,22,295,30,41.766667,-66.216667,0,0,0,0,0,"AL",0.038
"12673",551,"199804.245.1160.3","NMFS",1998,10,22,295,30,41.85,-66.266667,0,0,0,0,0,"AL",0.038
"12674",551,"199804.246.1160.10","NMFS",1998,10,23,296,30,41.966667,-66.016667,0,0,0,0,0,"AL",0.038
"12675",551,"199804.247.1160.9","NMFS",1998,10,23,296,30,41.883333,-65.916667,0,0,0,0,0,"AL",0.038
"12676",551,"199804.248.1290.1","NMFS",1998,10,23,296,30,42,-65.7,0,0,0,0,0,"AL",0.038
"12677",551,"199804.249.1180.1","NMFS",1998,10,23,296,30,42.016667,-65.85,0,0,0,0,0,"AL",0.038
"12678",464,"199804.250.1290.7","NMFS",1998,10,23,296,30,42.083333,-65.783333,0,0,0,0,0,"AL",0.038
"12679",464,"199804.251.1290.3","NMFS",1998,10,23,296,30,42.233333,-65.733333,0,0,0,0,0,"AL",0.038
"12680",551,"199804.252.1160.1","NMFS",1998,10,23,296,30,42.066667,-66.15,0,0,0,0,0,"AL",0.038
"12681",551,"199804.254.1160.14","NMFS",1998,10,23,296,30,41.983333,-66.45,1,1,0,1,0,"AL",0.038
"12682",551,"199804.255.1290.8","NMFS",1998,10,24,297,30,42.183333,-66.366667,0,0,0,0,0,"AL",0.038
"12683",551,"199804.256.1210.3","NMFS",1998,10,24,297,30,42.15,-66.583333,0,0,0,0,0,"AL",0.038
"12684",551,"199804.257.1300.3","NMFS",1998,10,24,297,30,42.333333,-66.716667,0,0,0,0,0,"AL",0.038
"12685",464,"199804.258.1300.2","NMFS",1998,10,24,297,30,42.4,-67.183333,2,2,0,2,0,"AL",0.038
"12686",464,"199804.259.1300.1","NMFS",1998,10,24,297,30,42.433333,-67.133333,0,0,0,0,0,"AL",0.038
"12687",464,"199804.260.1360.3","NMFS",1998,10,24,297,30,42.8,-66.866667,0,0,0,0,0,"AL",0.038
"12688",465,"199804.261.1340.5","NMFS",1998,10,24,297,30,43,-66.833333,0,0,0,0,0,"AL",0.038
"12689",465,"199804.262.1360.1","NMFS",1998,10,24,297,30,43.033333,-67.083333,0,0,0,0,0,"AL",0.038
"12690",465,"199804.263.1340.6","NMFS",1998,10,25,298,30,43.283333,-66.7,3,1,2,3,0,"AL",0.038
"12691",465,"199804.265.1330.1","NMFS",1998,10,25,298,26.3,43.35,-66.4,5,4,1,5,0,"AL",0.038
"12692",465,"199804.266.1330.2","NMFS",1998,10,25,298,30,43.616667,-66.383333,10,7,3,9,1,"AL",0.038
"12693",465,"199804.267.1330.3","NMFS",1998,10,25,298,30,43.783333,-66.5,1,1,0,1,0,"AL",0.038
"12694",465,"199804.268.1340.1","NMFS",1998,10,25,298,30,43.566667,-66.9,0,0,0,0,0,"AL",0.038
"12695",465,"199804.269.1340.3","NMFS",1998,10,25,298,30,43.65,-66.933333,0,0,0,0,0,"AL",0.038
"12696",465,"199804.270.1340.4","NMFS",1998,10,25,298,30,43.65,-67.116667,0,0,0,0,0,"AL",0.038
"12697",466,"199804.271.1351.1","NMFS",1998,10,26,299,30,44.3,-66.716667,0,0,0,0,0,"AL",0.038
"12698",511,"199804.272.1351.2","NMFS",1998,10,26,299,30,44.15,-66.966667,0,0,0,0,0,"AL",0.038
"12699",511,"199804.273.1340.2","NMFS",1998,10,26,299,30,44.066667,-67.283333,0,0,0,0,0,"AL",0.038
"12700",511,"199804.274.1360.11","NMFS",1998,10,26,299,30,44.133333,-67.5,0,0,0,0,0,"AL",0.038
"12701",511,"199804.275.1390.4","NMFS",1998,10,26,299,30,44.333333,-67.75,61,38,23,61,0,"AL",0.038
"12702",511,"199804.276.1390.2","NMFS",1998,10,26,299,30,44.233333,-67.833333,3,3,0,3,0,"AL",0.038
"12703",512,"199804.277.1390.1","NMFS",1998,10,26,299,30,44.2,-67.95,16,12,4,15,1,"AL",0.038
"12704",512,"199804.278.1390.6","NMFS",1998,10,26,299,23,43.933333,-68.366667,0,0,0,0,0,"AL",0.038
"12705",512,"199804.279.1390.8","NMFS",1998,10,26,299,30,43.983333,-68.433333,10,5,5,9,1,"AL",0.038
"12706",512,"199804.280.1390.7","NMFS",1998,10,27,300,30,43.9,-68.6,9,5,4,9,0,"AL",0.038
"12707",512,"199804.281.1390.5","NMFS",1998,10,27,300,22,43.933333,-68.933333,47,24,23,43,4,"AL",0.038
"12708",512,"199804.282.1390.3","NMFS",1998,10,27,300,30,43.716667,-69.05,2,1,1,2,0,"AL",0.038
"12709",512,"199804.283.1380.1","NMFS",1998,10,27,300,30,43.416667,-68.633333,0,0,0,0,0,"AL",0.038
"12710",515,"199804.284.1360.5","NMFS",1998,10,27,300,30,43.116667,-68.183333,0,0,0,0,0,"AL",0.038
"12711",512,"199804.285.1360.2","NMFS",1998,10,27,300,30,43.433333,-68,0,0,0,0,0,"AL",0.038
"12712",512,"199804.286.1360.9","NMFS",1998,10,27,300,30,43.433333,-67.8,0,0,0,0,0,"AL",0.038
"12713",465,"199804.287.1360.10","NMFS",1998,10,27,300,30,43.566667,-67.6,0,0,0,0,0,"AL",0.038
"12714",465,"199804.288.1360.6","NMFS",1998,10,28,301,30,43.566667,-67.433333,0,0,0,0,0,"AL",0.038
"12715",465,"199804.289.1360.7","NMFS",1998,10,28,301,30,43.316667,-67.533333,0,0,0,0,0,"AL",0.038
"12716",465,"199804.290.1360.8","NMFS",1998,10,28,301,30,43.033333,-67.4,0,0,0,0,0,"AL",0.038
"12717",464,"199804.291.1360.4","NMFS",1998,10,28,301,30,42.883333,-67.6,0,0,0,0,0,"AL",0.038
"12718",515,"199804.292.1290.4","NMFS",1998,10,28,301,30,42.6,-67.75,0,0,0,0,0,"AL",0.038
"12719",515,"199804.293.1290.2","NMFS",1998,10,28,301,30,42.416667,-68.1,0,0,0,0,0,"AL",0.038
"12720",515,"199804.294.1290.6","NMFS",1998,10,28,301,30,42.566667,-68.4,0,0,0,0,0,"AL",0.038
"12721",515,"199804.295.1290.5","NMFS",1998,10,28,301,30,42.483333,-68.433333,0,0,0,0,0,"AL",0.038
"12722",515,"199804.296.1280.1","NMFS",1998,10,28,301,30,42.433333,-68.65,0,0,0,0,0,"AL",0.038
"12723",521,"199804.297.1240.4","NMFS",1998,10,29,302,30,42.15,-69.083333,0,0,0,0,0,"AL",0.038
"12724",521,"199804.298.1280.6","NMFS",1998,10,29,302,30,42.233333,-69.35,0,0,0,0,0,"AL",0.038
"12725",515,"199804.299.1280.3","NMFS",1998,10,29,302,30,42.6,-69.166667,2,1,1,2,0,"AL",0.038
"12726",515,"199804.300.1370.1","NMFS",1998,10,29,302,30,42.833333,-69.55,0,0,0,0,0,"AL",0.038
"12727",513,"199804.301.1280.2","NMFS",1998,10,29,302,30,42.9,-69.95,0,0,0,0,0,"AL",0.038
"12728",513,"199804.302.1270.2","NMFS",1998,10,29,302,30,42.85,-70.1,0,0,0,0,0,"AL",0.038
"12729",514,"199804.303.1270.1","NMFS",1998,10,29,302,30,42.75,-70,0,0,0,0,0,"AL",0.038
"12730",514,"199804.304.1280.7","NMFS",1998,10,29,302,30,42.683333,-69.783333,1,1,0,1,0,"AL",0.038
"12731",514,"199804.305.1270.5","NMFS",1998,10,29,302,30,42.6,-69.9,0,0,0,0,0,"AL",0.038
"12732",514,"199804.306.3580.1","NMFS",1998,11,3,307,30,41.816667,-70.233333,3,2,1,2,1,"AL",0.038
"12733",514,"199804.307.3600.1","NMFS",1998,11,3,307,30,41.9,-70.316667,24,9,15,23,1,"AL",0.038
"12734",514,"199804.308.3590.1","NMFS",1998,11,3,307,30,41.9,-70.483333,147,98,49,103,44,"AL",0.038
"12735",514,"199804.309.3600.2","NMFS",1998,11,3,307,30,41.966667,-70.466667,52,31,21,45,7,"AL",0.038
"12736",514,"199804.310.3610.2","NMFS",1998,11,3,307,30,42.066667,-70.366667,38,17,21,36,2,"AL",0.038
"12737",514,"199804.311.3610.1","NMFS",1998,11,3,307,30,42.15,-70.066667,0,0,0,0,0,"AL",0.038
"12738",514,"199804.312.1280.5","NMFS",1998,11,3,307,30,42.35,-69.916667,0,0,0,0,0,"AL",0.038
"12739",514,"199804.313.1270.3","NMFS",1998,11,3,307,30,42.483333,-69.933333,0,0,0,0,0,"AL",0.038
"12740",514,"199804.314.1260.3","NMFS",1998,11,3,307,30,42.366667,-70.183333,0,0,0,0,0,"AL",0.038
"12741",514,"199804.315.1260.5","NMFS",1998,11,3,307,30,42.25,-70.366667,19,5,14,19,0,"AL",0.038
"12742",514,"199804.316.3660.2","NMFS",1998,11,3,307,30,42.216667,-70.483333,10,6,4,9,1,"AL",0.038
"12743",514,"199804.318.1260.4","NMFS",1998,11,4,308,30,42.35,-70.533333,25,7,18,25,0,"AL",0.038
"12744",514,"199804.320.3640.1","NMFS",1998,11,4,308,24,42.283333,-70.666667,90,60,30,79,11,"AL",0.038
"12745",514,"199804.321.1260.6","NMFS",1998,11,4,308,30,42.3,-70.5,19,8,11,18,1,"AL",0.038
"12746",514,"199804.322.3630.1","NMFS",1998,11,4,308,23,42.466667,-70.8,38,18,20,34,4,"AL",0.038
"12747",514,"199804.323.3650.1","NMFS",1998,11,4,308,30,42.5,-70.75,93,44,49,91,2,"AL",0.038
"12748",514,"199804.324.1260.2","NMFS",1998,11,4,308,30,42.733333,-70.45,14,5,9,14,0,"AL",0.038
"12749",514,"199804.325.3660.1","NMFS",1998,11,4,308,30,42.816667,-70.65,16,14,2,14,2,"AL",0.038
"12750",513,"199804.326.1400.1","NMFS",1998,11,4,308,30,42.85,-70.55,10,2,8,10,0,"AL",0.038
"12751",513,"199804.327.1400.5","NMFS",1998,11,4,308,30,42.85,-70.516667,5,0,5,5,0,"AL",0.038
"12752",514,"199804.328.1260.7","NMFS",1998,11,4,308,30,42.816667,-70.333333,1,0,1,1,0,"AL",0.038
"12753",513,"199804.329.1400.6","NMFS",1998,11,5,309,30,43.033333,-70.4,11,5,6,11,0,"AL",0.038
"12754",513,"199804.331.1400.7","NMFS",1998,11,5,309,30,43.316667,-70.233333,29,14,15,28,1,"AL",0.038
"12755",513,"199804.332.1270.4","NMFS",1998,11,5,309,30,43.25,-70.033333,1,0,1,1,0,"AL",0.038
"12756",513,"199804.333.1380.5","NMFS",1998,11,5,309,30,43.3,-69.783333,1,1,0,1,0,"AL",0.038
"12757",513,"199804.334.1380.7","NMFS",1998,11,6,310,30,43.416667,-69.783333,0,0,0,0,0,"AL",0.038
"12758",513,"199804.335.1400.3","NMFS",1998,11,6,310,30,43.583333,-69.683333,1,0,1,1,0,"AL",0.038
"12759",513,"199804.337.1400.4","NMFS",1998,11,6,310,30,43.7,-69.466667,2,1,1,2,0,"AL",0.038
"12760",513,"199804.338.1380.9","NMFS",1998,11,6,310,23,43.6,-69.466667,0,0,0,0,0,"AL",0.038
"12761",513,"199804.339.1380.6","NMFS",1998,11,6,310,30,43.483333,-69.166667,0,0,0,0,0,"AL",0.038
"12762",512,"199804.340.1380.4","NMFS",1998,11,6,310,30,43.4,-68.866667,0,0,0,0,0,"AL",0.038
"12763",512,"199804.341.1380.8","NMFS",1998,11,6,310,30,43.383333,-68.983333,0,0,0,0,0,"AL",0.038
"12764",513,"199804.342.1380.3","NMFS",1998,11,6,310,30,43.3,-69.35,0,0,0,0,0,"AL",0.038
"12765",513,"199804.343.1370.4","NMFS",1998,11,6,310,30,43.216667,-69.266667,0,0,0,0,0,"AL",0.038
"12766",513,"199804.344.1370.5","NMFS",1998,11,7,311,30,43.083333,-69.366667,0,0,0,0,0,"AL",0.038
"12767",515,"199804.345.1370.2","NMFS",1998,11,7,311,30,42.983333,-69.083333,0,0,0,0,0,"AL",0.038
"12768",515,"199804.346.1370.3","NMFS",1998,11,7,311,30,43.1,-68.783333,0,0,0,0,0,"AL",0.038
"12769",526,"199902.179.1110.1","NMFS",1999,3,31,90,30,39.986333,-69.677833,2,0,2,2,0,"AL",0.038
"12770",526,"199902.180.1100.7","NMFS",1999,3,31,90,30,40.351333,-69.221833,0,0,0,0,0,"AL",0.038
"12771",526,"199902.181.1100.8","NMFS",1999,3,31,90,30,40.359,-69.278,0,0,0,0,0,"AL",0.038
"12772",526,"199902.182.1090.3","NMFS",1999,3,31,90,30,40.6175,-69.4395,0,0,0,0,0,"AL",0.038
"12773",526,"199902.184.1100.9","NMFS",1999,4,1,91,28,40.894,-69.200833,0,0,0,0,0,"AL",0.038
"12774",526,"199902.185.1090.5","NMFS",1999,4,1,91,30,40.8145,-69.497833,0,0,0,0,0,"AL",0.038
"12775",526,"199902.186.1090.4","NMFS",1999,4,1,91,30,40.849167,-69.621167,0,0,0,0,0,"AL",0.038
"12776",526,"199902.187.3550.4","NMFS",1999,4,1,91,30,40.895833,-69.5145,0,0,0,0,0,"AL",0.038
"12777",521,"199902.188.3550.2","NMFS",1999,4,1,91,30,41.035667,-69.488833,0,0,0,0,0,"AL",0.038
"12778",521,"199902.189.3550.3","NMFS",1999,4,1,91,30,41.105,-69.458833,0,0,0,0,0,"AL",0.038
"12779",521,"199902.190.3550.1","NMFS",1999,4,1,91,30,41.245,-69.5405,0,0,0,0,0,"AL",0.038
"12780",521,"199902.191.3550.5","NMFS",1999,4,1,91,30,41.256333,-69.486333,2,1,1,2,0,"AL",0.038
"12781",521,"199902.192.1230.3","NMFS",1999,4,1,91,30,41.345333,-69.276833,0,0,0,0,0,"AL",0.038
"12782",521,"199902.193.1250.3","NMFS",1999,4,6,96,30,41.480667,-69.573167,13,8,5,10,3,"AL",0.038
"12783",521,"199902.194.1250.2","NMFS",1999,4,6,96,25,41.653,-69.728833,6,3,3,6,0,"AL",0.038
"12784",521,"199902.195.1230.2","NMFS",1999,4,6,96,30,41.686167,-69.656333,0,0,0,0,0,"AL",0.038
"12785",521,"199902.196.1240.4","NMFS",1999,4,6,96,30,41.633,-69.2185,10,9,1,10,0,"AL",0.038
"12786",521,"199902.197.1250.4","NMFS",1999,4,6,96,30,41.1,-69.326833,0,0,0,0,0,"AL",0.038
"12787",521,"199902.198.1250.1","NMFS",1999,4,6,96,30,41.0155,-69.271833,1,1,0,1,0,"AL",0.038
"12788",521,"199902.199.1230.5","NMFS",1999,4,6,96,25,41.1425,-69.145167,0,0,0,0,0,"AL",0.038
"12789",521,"199902.200.1230.1","NMFS",1999,4,6,96,30,41.231167,-68.958833,0,0,0,0,0,"AL",0.038
"12790",521,"199902.201.1230.4","NMFS",1999,4,6,96,30,41.112333,-68.880167,1,0,1,1,0,"AL",0.038
"12791",522,"199902.202.1200.2","NMFS",1999,4,6,96,30,41.0705,-68.611167,0,0,0,0,0,"AL",0.038
"12792",525,"199902.203.1130.5","NMFS",1999,4,6,96,30,40.714667,-68.704833,0,0,0,0,0,"AL",0.038
"12793",525,"199902.204.1130.4","NMFS",1999,4,6,96,30,40.521167,-68.620667,0,0,0,0,0,"AL",0.038
"12794",525,"199902.205.1130.3","NMFS",1999,4,7,97,30,40.397833,-68.6535,0,0,0,0,0,"AL",0.038
"12795",525,"199902.206.1130.7","NMFS",1999,4,7,97,30,40.358667,-68.816667,0,0,0,0,0,"AL",0.038
"12796",525,"199902.207.1140.3","NMFS",1999,4,7,97,30,40.266333,-68.650333,0,0,0,0,0,"AL",0.038
"12797",525,"199902.209.1150.2","NMFS",1999,4,7,97,30,40.350167,-67.821833,0,0,0,0,0,"AL",0.038
"12798",525,"199902.210.1140.2","NMFS",1999,4,7,97,30,40.504,-67.778,0,0,0,0,0,"AL",0.038
"12799",525,"199902.211.1140.1","NMFS",1999,4,7,97,30,40.575833,-67.230833,0,0,0,0,0,"AL",0.038
"12800",521,"199902.213.1240.3","NMFS",1999,4,8,98,30,42.0655,-69.715167,0,0,0,0,0,"AL",0.038
"12801",521,"199902.214.1280.7","NMFS",1999,4,8,98,30,42.236167,-69.509667,0,0,0,0,0,"AL",0.038
"12802",522,"199902.215.1240.2","NMFS",1999,4,9,99,30,42.2125,-68.669833,0,0,0,0,0,"AL",0.038
"12803",522,"199902.216.1240.5","NMFS",1999,4,9,99,30,41.898333,-68.7025,0,0,0,0,0,"AL",0.038
"12804",522,"199902.217.1210.4","NMFS",1999,4,9,99,30,41.772833,-68.295167,0,0,0,0,0,"AL",0.038
"12805",522,"199902.218.1240.6","NMFS",1999,4,9,99,30,41.947667,-68.326833,0,0,0,0,0,"AL",0.038
"12806",522,"199902.219.1240.1","NMFS",1999,4,9,99,30,42.019333,-68.339167,0,0,0,0,0,"AL",0.038
"12807",522,"199902.220.1290.4","NMFS",1999,4,9,99,30,42.178167,-68.195667,0,0,0,0,0,"AL",0.038
"12808",522,"199902.221.1220.2","NMFS",1999,4,9,99,30,42.0915,-67.850333,0,0,0,0,0,"AL",0.038
"12809",522,"199902.222.1200.6","NMFS",1999,4,9,99,30,41.856333,-67.906167,0,0,0,0,0,"AL",0.038
"12810",522,"199902.223.1200.4","NMFS",1999,4,9,99,30,41.774333,-67.7265,4,3,1,2,2,"AL",0.038
"12811",562,"199902.224.1190.2","NMFS",1999,4,9,99,30,41.644833,-67.4505,1,1,0,1,0,"AL",0.038
"12812",562,"199902.225.1190.8","NMFS",1999,4,9,99,30,41.526167,-67.3775,0,0,0,0,0,"AL",0.038
"12813",562,"199902.226.1190.5","NMFS",1999,4,10,100,30,41.456833,-67.350167,0,0,0,0,0,"AL",0.038
"12814",562,"199902.227.1190.7","NMFS",1999,4,10,100,30,41.332167,-67.314667,0,0,0,0,0,"AL",0.038
"12815",562,"199902.228.1190.9","NMFS",1999,4,10,100,30,41.185167,-67.654167,0,0,0,0,0,"AL",0.038
"12816",522,"199902.229.1190.3","NMFS",1999,4,10,100,30,41.386167,-67.896833,0,0,0,0,0,"AL",0.038
"12817",522,"199902.230.1200.5","NMFS",1999,4,10,100,30,41.547333,-67.942833,0,0,0,0,0,"AL",0.038
"12818",522,"199902.231.1200.3","NMFS",1999,4,10,100,30,41.405,-68.083333,0,0,0,0,0,"AL",0.038
"12819",522,"199902.232.1190.1","NMFS",1999,4,10,100,30,41.366,-68.111667,0,0,0,0,0,"AL",0.038
"12820",525,"199902.233.1190.4","NMFS",1999,4,10,100,30,41.1365,-68.0285,0,0,0,0,0,"AL",0.038
"12821",525,"199902.234.1190.6","NMFS",1999,4,10,100,30,41.022167,-68.2485,0,0,0,0,0,"AL",0.038
"12822",525,"199902.235.1130.1","NMFS",1999,4,10,100,30,40.8455,-68.179833,0,0,0,0,0,"AL",0.038
"12823",525,"199902.236.1130.2","NMFS",1999,4,10,100,30,40.8305,-67.945333,0,0,0,0,0,"AL",0.038
"12824",525,"199902.237.1130.9","NMFS",1999,4,10,100,30,40.777333,-67.969833,0,0,0,0,0,"AL",0.038
"12825",525,"199902.238.1130.8","NMFS",1999,4,10,100,30,40.772,-67.846667,0,0,0,0,0,"AL",0.038
"12826",525,"199902.239.1130.6","NMFS",1999,4,11,101,30,40.720833,-67.521,0,0,0,0,0,"AL",0.038
"12827",562,"199902.240.1170.2","NMFS",1999,4,11,101,30,40.893333,-66.652667,0,0,0,0,0,"AL",0.038
"12828",562,"199902.241.1160.10","NMFS",1999,4,11,101,30,41.193667,-66.996,0,0,0,0,0,"AL",0.038
"12829",562,"199902.242.1160.9","NMFS",1999,4,11,101,30,41.217667,-66.778,0,0,0,0,0,"AL",0.038
"12830",562,"199902.243.1160.5","NMFS",1999,4,11,101,30,41.449,-67.001833,0,0,0,0,0,"AL",0.038
"12831",562,"199902.244.1160.3","NMFS",1999,4,11,101,30,41.5955,-66.78,0,0,0,0,0,"AL",0.038
"12832",561,"199902.245.1200.1","NMFS",1999,4,14,104,30,41.984833,-67.485167,0,0,0,0,0,"AL",0.038
"12833",561,"199902.246.1210.1","NMFS",1999,4,14,104,30,42.106833,-67.401167,0,0,0,0,0,"AL",0.038
"12834",561,"199902.247.1220.4","NMFS",1999,4,14,104,30,42.139,-67.615333,1,1,0,1,0,"AL",0.038
"12835",561,"199902.248.1290.2","NMFS",1999,4,14,104,30,42.216333,-67.4175,1,1,0,1,0,"AL",0.038
"12836",561,"199902.249.1300.1","NMFS",1999,4,14,104,30,42.311333,-67.365333,1,1,0,1,0,"AL",0.038
"12837",551,"199902.250.1290.6","NMFS",1999,4,14,104,30,42.306167,-67.2015,0,0,0,0,0,"AL",0.038
"12838",551,"199902.251.1290.3","NMFS",1999,4,14,104,30,42.280167,-67.169,0,0,0,0,0,"AL",0.038
"12839",551,"199902.252.1290.5","NMFS",1999,4,14,104,30,42.273833,-66.9275,1,1,0,1,0,"AL",0.038
"12840",551,"199902.254.1160.4","NMFS",1999,4,15,105,30,41.924333,-66.458667,0,0,0,0,0,"AL",0.038
"12841",551,"199902.255.1160.6","NMFS",1999,4,15,105,30,41.957,-66.229833,0,0,0,0,0,"AL",0.038
"12842",552,"199902.256.1160.7","NMFS",1999,4,15,105,30,41.7765,-66.329833,0,0,0,0,0,"AL",0.038
"12843",552,"199902.257.1160.2","NMFS",1999,4,15,105,30,41.652333,-66.352833,0,0,0,0,0,"AL",0.038
"12844",562,"199902.258.1160.1","NMFS",1999,4,15,105,30,41.4905,-66.615167,0,0,0,0,0,"AL",0.038
"12845",552,"199902.259.1160.8","NMFS",1999,4,15,105,30,41.350167,-66.286167,0,0,0,0,0,"AL",0.038
"12846",551,"199902.260.1180.1","NMFS",1999,4,15,105,30,41.845333,-65.729833,3,3,0,3,0,"AL",0.038
"12847",551,"199902.261.1170.3","NMFS",1999,4,15,105,30,41.850833,-65.842667,0,0,0,0,0,"AL",0.038
"12848",551,"199902.262.1170.1","NMFS",1999,4,16,106,30,42.020667,-65.953667,1,0,1,1,0,"AL",0.038
"12849",551,"199902.263.1220.3","NMFS",1999,4,16,106,30,42.138667,-66.108,0,0,0,0,0,"AL",0.038
"12850",551,"199902.264.1210.3","NMFS",1999,4,16,106,30,42.1145,-66.255167,0,0,0,0,0,"AL",0.038
"12851",551,"199902.265.1220.1","NMFS",1999,4,16,106,30,42.151667,-66.367833,0,0,0,0,0,"AL",0.038
"12852",551,"199902.266.1210.5","NMFS",1999,4,16,106,30,42.1325,-66.565667,0,0,0,0,0,"AL",0.038
"12853",464,"199902.267.1300.2","NMFS",1999,4,16,106,30,42.344667,-66.802333,0,0,0,0,0,"AL",0.038
"12854",464,"199902.268.1300.3","NMFS",1999,4,16,106,30,42.471333,-67.298333,0,0,0,0,0,"AL",0.038
"12855",464,"199902.269.1290.8","NMFS",1999,4,16,106,30,42.603,-66.9985,0,0,0,0,0,"AL",0.038
"12856",464,"199902.270.1290.7","NMFS",1999,4,16,106,30,42.693833,-67.2615,4,4,0,4,0,"AL",0.038
"12857",515,"199902.271.1290.1","NMFS",1999,4,16,106,30,42.6525,-67.915167,0,0,0,0,0,"AL",0.038
"12858",515,"199902.272.1360.2","NMFS",1999,4,17,107,30,43.147,-68.265833,0,0,0,0,0,"AL",0.038
"12859",515,"199902.273.1360.7","NMFS",1999,4,17,107,30,43.219333,-68.069333,0,0,0,0,0,"AL",0.038
"12860",515,"199902.274.1360.4","NMFS",1999,4,17,107,30,43.2525,-67.676667,0,0,0,0,0,"AL",0.038
"12861",465,"199902.275.1360.3","NMFS",1999,4,17,107,30,43.0255,-67.588833,0,0,0,0,0,"AL",0.038
"12862",464,"199902.276.1360.5","NMFS",1999,4,17,107,30,42.902667,-66.954667,1,1,0,1,0,"AL",0.038
"12863",465,"199902.277.1340.6","NMFS",1999,4,17,107,30,43.133833,-67.070333,1,1,0,1,0,"AL",0.038
"12864",465,"199902.278.1340.2","NMFS",1999,4,17,107,26,43.184833,-66.772167,0,0,0,0,0,"AL",0.038
"12865",465,"199902.279.1340.3","NMFS",1999,4,17,107,30,43.7285,-67.010167,1,1,0,1,0,"AL",0.038
"12866",511,"199902.280.1340.1","NMFS",1999,4,18,108,30,43.915333,-67.315333,0,0,0,0,0,"AL",0.038
"12867",465,"199902.281.1340.4","NMFS",1999,4,18,108,30,43.793667,-67.3535,0,0,0,0,0,"AL",0.038
"12868",512,"199902.282.1360.6","NMFS",1999,4,18,108,30,43.576833,-67.684833,0,0,0,0,0,"AL",0.038
"12869",512,"199902.283.1360.8","NMFS",1999,4,18,108,30,43.833167,-67.819833,1,1,0,1,0,"AL",0.038
"12870",511,"199902.284.1380.2","NMFS",1999,4,18,108,30,44.212167,-67.597667,0,0,0,0,0,"AL",0.038
"12871",511,"199902.285.1340.5","NMFS",1999,4,18,108,30,44.095167,-67.385167,0,0,0,0,0,"AL",0.038
"12872",511,"199902.286.1360.1","NMFS",1999,4,18,108,30,44.2165,-67.345167,1,1,0,1,0,"AL",0.038
"12873",511,"199902.287.1390.4","NMFS",1999,4,18,108,30,44.329167,-67.514,1,0,1,1,0,"AL",0.038
"12874",512,"199902.288.1390.1","NMFS",1999,4,18,108,30,44.228333,-67.937333,7,4,3,7,0,"AL",0.038
"12875",512,"199902.289.1390.5","NMFS",1999,4,18,108,30,44.125167,-67.9815,0,0,0,0,0,"AL",0.038
"12876",512,"199902.290.1390.2","NMFS",1999,4,19,109,30,43.914333,-68.405,2,1,1,2,0,"AL",0.038
"12877",512,"199902.291.1380.1","NMFS",1999,4,19,109,30,43.6695,-68.350333,1,1,0,1,0,"AL",0.038
"12878",512,"199902.292.1380.3","NMFS",1999,4,19,109,30,43.468833,-68.4455,0,0,0,0,0,"AL",0.038
"12879",512,"199902.293.1380.4","NMFS",1999,4,19,109,30,43.6,-68.5145,2,1,1,2,0,"AL",0.038
"12880",512,"199902.294.1390.3","NMFS",1999,4,19,109,30,43.674667,-68.914667,4,1,3,3,1,"AL",0.038
"12881",513,"199902.296.1380.5","NMFS",1999,4,19,109,30,43.353167,-69.0815,2,2,0,2,0,"AL",0.038
"12882",515,"199902.297.1370.2","NMFS",1999,4,19,109,30,42.987167,-69.048333,0,0,0,0,0,"AL",0.038
"12883",515,"199902.298.1370.3","NMFS",1999,4,20,110,30,42.906,-68.581833,0,0,0,0,0,"AL",0.038
"12884",515,"199902.299.1370.5","NMFS",1999,4,20,110,30,42.695667,-68.769333,0,0,0,0,0,"AL",0.038
"12885",515,"199902.300.1280.4","NMFS",1999,4,20,110,30,42.55,-68.769833,0,0,0,0,0,"AL",0.038
"12886",515,"199902.301.1280.3","NMFS",1999,4,20,110,30,42.632167,-69.180833,0,0,0,0,0,"AL",0.038
"12887",515,"199902.302.1280.1","NMFS",1999,4,20,110,30,42.657833,-69.3875,0,0,0,0,0,"AL",0.038
"12888",515,"199902.303.1280.5","NMFS",1999,4,20,110,30,42.568,-69.448667,0,0,0,0,0,"AL",0.038
"12889",515,"199902.304.1280.2","NMFS",1999,4,20,110,30,42.613667,-69.51,0,0,0,0,0,"AL",0.038
"12890",513,"199902.305.1370.1","NMFS",1999,4,20,110,30,42.965167,-69.628167,0,0,0,0,0,"AL",0.038
"12891",513,"199902.306.1370.4","NMFS",1999,4,20,110,30,43.092,-69.773833,0,0,0,0,0,"AL",0.038
"12892",513,"199902.307.1270.3","NMFS",1999,4,20,110,30,43.145,-70.220667,1,0,1,1,0,"AL",0.038
"12893",513,"199902.308.1270.4","NMFS",1999,4,21,111,30,42.9675,-70.220667,1,1,0,1,0,"AL",0.038
"12894",513,"199902.309.1400.2","NMFS",1999,4,21,111,30,43.056167,-70.449333,14,6,8,14,0,"AL",0.038
"12895",513,"199902.310.1400.1","NMFS",1999,4,21,111,30,42.888667,-70.4645,3,0,3,3,0,"AL",0.038
"12896",514,"199902.311.3660.1","NMFS",1999,4,21,111,30,42.682167,-70.410333,3,1,2,3,0,"AL",0.038
"12897",514,"199902.312.3660.2","NMFS",1999,4,21,111,30,42.493667,-70.723667,22,14,8,20,2,"AL",0.038
"12898",514,"199902.313.3630.1","NMFS",1999,4,21,111,30,42.4485,-70.862667,21,9,12,18,3,"AL",0.038
"12899",514,"199902.314.3640.1","NMFS",1999,4,21,111,30,42.338333,-70.785333,56,39,17,54,2,"AL",0.038
"12900",514,"199902.315.3650.1","NMFS",1999,4,21,111,30,42.3215,-70.696667,23,14,9,23,0,"AL",0.038
"12901",514,"199902.316.1260.2","NMFS",1999,4,21,111,30,42.4795,-70.426667,2,0,2,2,0,"AL",0.038
"12902",514,"199902.317.1260.4","NMFS",1999,4,21,111,30,42.509667,-70.208167,0,0,0,0,0,"AL",0.038
"12903",514,"199902.318.1270.1","NMFS",1999,4,21,111,30,42.533167,-70.057167,3,3,0,3,0,"AL",0.038
"12904",514,"199902.319.1260.3","NMFS",1999,4,21,111,30,42.4605,-70.176167,0,0,0,0,0,"AL",0.038
"12905",514,"199902.320.1260.1","NMFS",1999,4,22,112,30,42.372833,-70.175667,0,0,0,0,0,"AL",0.038
"12906",514,"199902.321.1280.6","NMFS",1999,4,22,112,30,42.358667,-69.911833,1,1,0,1,0,"AL",0.038
"12907",521,"199902.322.1270.2","NMFS",1999,4,22,112,30,42.187333,-69.859167,1,1,0,1,0,"AL",0.038
"12908",514,"199902.323.3610.1","NMFS",1999,4,22,112,30,42.130833,-70.03,0,0,0,0,0,"AL",0.038
"12909",514,"199902.324.1260.5","NMFS",1999,4,22,112,30,42.2255,-70.095833,1,1,0,1,0,"AL",0.038
"12910",514,"199902.325.3600.2","NMFS",1999,4,22,112,30,42.029167,-70.487167,28,16,12,26,2,"AL",0.038
"12911",514,"199902.326.3590.1","NMFS",1999,4,22,112,30,42.051,-70.561833,23,10,13,21,2,"AL",0.038
"12912",514,"199902.327.3600.1","NMFS",1999,4,22,112,30,41.911167,-70.456,99,52,47,90,9,"AL",0.038
"12913",514,"199902.328.3610.2","NMFS",1999,4,22,112,30,41.975,-70.326833,6,3,3,5,1,"AL",0.038
"12914",514,"199902.329.3580.1","NMFS",1999,4,22,112,30,41.880333,-70.141,2,1,1,2,0,"AL",0.038
"12915",526,"199908.170.1100.8","NMFS",1999,10,11,284,30,40.279333,-69.952,0,0,0,0,0,"AL",0.038
"12916",526,"199908.171.1100.1","NMFS",1999,10,11,284,30,40.099833,-69.793833,2,1,1,0,2,"AL",0.038
"12917",526,"199908.172.1110.1","NMFS",1999,10,11,284,30,40.017667,-69.5325,1,0,1,0,1,"AL",0.038
"12918",526,"199908.173.1110.2","NMFS",1999,10,11,284,30,40.106833,-69.2165,1,0,1,1,0,"AL",0.038
"12919",526,"199908.174.1120.1","NMFS",1999,10,12,285,25,40.114,-68.838833,2,1,1,2,0,"AL",0.038
"12920",525,"199908.175.1130.6","NMFS",1999,10,12,285,30,40.259333,-68.795,1,0,1,1,0,"AL",0.038
"12921",526,"199908.176.1100.6","NMFS",1999,10,12,285,30,40.322333,-69.031667,0,0,0,0,0,"AL",0.038
"12922",526,"199908.177.1090.4","NMFS",1999,10,12,285,30,40.634667,-69.363333,0,0,0,0,0,"AL",0.038
"12923",526,"199908.178.1090.5","NMFS",1999,10,12,285,30,40.729,-69.6165,0,0,0,0,0,"AL",0.038
"12924",526,"199908.179.3550.4","NMFS",1999,10,12,285,30,41.021833,-69.727333,0,0,0,0,0,"AL",0.038
"12925",526,"199908.180.3550.3","NMFS",1999,10,12,285,30,40.976,-69.622,1,0,1,0,1,"AL",0.038
"12926",526,"199908.181.3550.2","NMFS",1999,10,12,285,30,41.1005,-69.582833,1,0,1,1,0,"AL",0.038
"12927",526,"199908.182.3550.5","NMFS",1999,10,12,285,24,41.0325,-69.505833,1,1,0,1,0,"AL",0.038
"12928",526,"199908.183.1100.3","NMFS",1999,10,12,285,30,40.889833,-69.175,2,1,1,2,0,"AL",0.038
"12929",526,"199908.184.1100.5","NMFS",1999,10,12,285,30,40.724833,-69.011167,2,1,1,1,1,"AL",0.038
"12930",526,"199908.185.1130.8","NMFS",1999,10,13,286,30,40.635333,-68.852167,0,0,0,0,0,"AL",0.038
"12931",525,"199908.186.1190.1","NMFS",1999,10,13,286,30,40.868,-68.647833,1,0,1,1,0,"AL",0.038
"12932",525,"199908.187.1130.7","NMFS",1999,10,13,286,30,40.6535,-68.456333,0,0,0,0,0,"AL",0.038
"12933",525,"199908.188.1140.2","NMFS",1999,10,13,286,30,40.393167,-68.079667,0,0,0,0,0,"AL",0.038
"12934",525,"199908.189.1130.5","NMFS",1999,10,13,286,30,40.767167,-68.025333,0,0,0,0,0,"AL",0.038
"12935",525,"199908.190.1190.8","NMFS",1999,10,13,286,30,40.985333,-67.817333,0,0,0,0,0,"AL",0.038
"12936",525,"199908.191.1190.4","NMFS",1999,10,13,286,30,41.065,-68.220833,4,1,3,4,0,"AL",0.038
"12937",525,"199908.192.1190.7","NMFS",1999,10,13,286,30,41.137667,-68.194,2,0,2,2,0,"AL",0.038
"12938",522,"199908.193.1190.9","NMFS",1999,10,13,286,30,41.352667,-67.866333,0,0,0,0,0,"AL",0.038
"12939",522,"199908.194.1200.6","NMFS",1999,10,13,286,30,41.513833,-68.1755,3,0,3,3,0,"AL",0.038
"12940",522,"199908.195.1200.2","NMFS",1999,10,14,287,30,41.4955,-68.364333,0,0,0,0,0,"AL",0.038
"12941",522,"199908.196.1230.4","NMFS",1999,10,14,287,30,41.436167,-68.4655,1,1,0,1,0,"AL",0.038
"12942",522,"199908.197.1240.5","NMFS",1999,10,14,287,30,41.479,-68.809333,0,0,0,0,0,"AL",0.038
"12943",521,"199908.198.1240.3","NMFS",1999,10,14,287,30,41.635167,-69.1165,0,0,0,0,0,"AL",0.038
"12944",521,"199908.199.1240.6","NMFS",1999,10,14,287,30,41.441167,-69.170667,0,0,0,0,0,"AL",0.038
"12945",521,"199908.200.1250.2","NMFS",1999,10,19,292,30,41.5385,-69.668167,6,2,4,6,0,"AL",0.038
"12946",521,"199908.201.1230.5","NMFS",1999,10,19,292,30,41.6835,-69.620167,0,0,0,0,0,"AL",0.038
"12947",521,"199908.202.1250.3","NMFS",1999,10,20,293,29,41.536667,-69.602667,11,4,7,11,0,"AL",0.038
"12948",521,"199908.203.1250.1","NMFS",1999,10,20,293,30,41.4505,-69.584833,20,15,5,16,4,"AL",0.038
"12949",521,"199908.204.3550.1","NMFS",1999,10,20,293,30,41.269,-69.5285,1,0,1,1,0,"AL",0.038
"12950",521,"199908.205.1250.4","NMFS",1999,10,20,293,30,41.229833,-69.372667,1,0,1,1,0,"AL",0.038
"12951",521,"199908.206.1230.3","NMFS",1999,10,20,293,30,41.311,-69.331833,0,0,0,0,0,"AL",0.038
"12952",521,"199908.207.1230.2","NMFS",1999,10,20,293,30,41.234333,-69.177833,0,0,0,0,0,"AL",0.038
"12953",522,"199908.208.1240.4","NMFS",1999,10,20,293,30,41.768833,-68.527167,0,0,0,0,0,"AL",0.038
"12954",522,"199908.209.1210.4","NMFS",1999,10,20,293,30,41.766333,-68.249,0,0,0,0,0,"AL",0.038
"12955",522,"199908.210.1200.4","NMFS",1999,10,20,293,30,41.725333,-68.104167,27,10,17,26,1,"AL",0.038
"12956",522,"199908.211.1200.3","NMFS",1999,10,20,293,30,41.891,-67.848167,8,4,4,8,0,"AL",0.038
"12957",522,"199908.212.1210.2","NMFS",1999,10,20,293,30,41.938,-67.8725,3,3,0,3,0,"AL",0.038
"12958",522,"199908.213.1220.1","NMFS",1999,10,21,294,30,42.049667,-67.936167,1,1,0,1,0,"AL",0.038
"12959",522,"199908.214.1290.8","NMFS",1999,10,21,294,30,42.282667,-67.975167,0,0,0,0,0,"AL",0.038
"12960",522,"199908.215.1290.7","NMFS",1999,10,21,294,30,42.317333,-67.705333,1,1,0,1,0,"AL",0.038
"12961",464,"199908.216.1300.2","NMFS",1999,10,21,294,30,42.351833,-67.420333,0,0,0,0,0,"AL",0.038
"12962",561,"199908.217.1220.3","NMFS",1999,10,21,294,30,42.150667,-67.580833,0,0,0,0,0,"AL",0.038
"12963",561,"199908.218.1200.1","NMFS",1999,10,21,294,30,41.911833,-67.514333,2,0,2,2,0,"AL",0.038
"12964",561,"199908.219.1200.5","NMFS",1999,10,21,294,30,42.0535,-67.21,1,0,1,1,0,"AL",0.038
"12965",562,"199908.220.1190.2","NMFS",1999,10,21,294,30,41.774333,-67.117167,5,1,4,4,1,"AL",0.038
"12966",562,"199908.221.1190.5","NMFS",1999,10,21,294,26,41.702167,-67.278667,1,0,1,1,0,"AL",0.038
"12967",562,"199908.222.1190.3","NMFS",1999,10,21,294,30,41.318667,-67.15,1,0,1,1,0,"AL",0.038
"12968",525,"199908.223.1190.6","NMFS",1999,10,22,295,30,41.154167,-67.467833,0,0,0,0,0,"AL",0.038
"12969",525,"199908.224.1130.2","NMFS",1999,10,22,295,30,41.014667,-67.362,0,0,0,0,0,"AL",0.038
"12970",525,"199908.225.1130.4","NMFS",1999,10,22,295,30,40.9335,-67.477333,0,0,0,0,0,"AL",0.038
"12971",525,"199908.226.1130.3","NMFS",1999,10,22,295,30,40.735667,-67.653,0,0,0,0,0,"AL",0.038
"12972",525,"199908.227.1140.3","NMFS",1999,10,22,295,30,40.559333,-67.429167,0,0,0,0,0,"AL",0.038
"12973",525,"199908.228.1140.1","NMFS",1999,10,22,295,30,40.563,-67.1735,0,0,0,0,0,"AL",0.038
"12974",525,"199908.229.1150.1","NMFS",1999,10,22,295,30,40.532,-67.078667,1,1,0,1,0,"AL",0.038
"12975",525,"199908.230.1130.1","NMFS",1999,10,22,295,30,40.851167,-67.138167,1,0,1,1,0,"AL",0.038
"12976",525,"199908.231.1130.9","NMFS",1999,10,22,295,30,40.801167,-66.873,0,0,0,0,0,"AL",0.038
"12977",562,"199908.232.1160.8","NMFS",1999,10,22,295,30,41.0095,-66.792167,1,1,0,1,0,"AL",0.038
"12978",562,"199908.233.1160.5","NMFS",1999,10,23,296,30,41.448667,-66.787,0,0,0,0,0,"AL",0.038
"12979",562,"199908.234.1160.2","NMFS",1999,10,23,296,30,41.279,-66.5415,2,1,1,2,0,"AL",0.038
"12980",552,"199908.235.1160.1","NMFS",1999,10,23,296,30,41.334833,-66.389,4,4,0,4,0,"AL",0.038
"12981",552,"199908.236.1160.9","NMFS",1999,10,23,296,30,41.5625,-66.388167,1,1,0,1,0,"AL",0.038
"12982",552,"199908.237.1160.10","NMFS",1999,10,23,296,30,41.6375,-66.575167,1,1,0,1,0,"AL",0.038
"12983",552,"199908.238.1160.7","NMFS",1999,10,23,296,30,41.724,-66.3065,0,0,0,0,0,"AL",0.038
"12984",551,"199908.239.1160.6","NMFS",1999,10,24,297,30,41.894,-66.641167,0,0,0,0,0,"AL",0.038
"12985",551,"199908.240.1160.3","NMFS",1999,10,24,297,30,41.978333,-66.888167,0,0,0,0,0,"AL",0.038
"12986",551,"199908.241.1220.4","NMFS",1999,10,24,297,30,42.188333,-66.9885,1,0,1,1,0,"AL",0.038
"12987",551,"199908.242.1300.3","NMFS",1999,10,24,297,30,42.313,-66.871,0,0,0,0,0,"AL",0.038
"12988",551,"199908.243.1220.2","NMFS",1999,10,24,297,30,42.202833,-66.7815,0,0,0,0,0,"AL",0.038
"12989",551,"199908.244.1210.3","NMFS",1999,10,24,297,30,42.106833,-66.395667,0,0,0,0,0,"AL",0.038
"12990",551,"199908.245.1210.1","NMFS",1999,10,24,297,30,42.100667,-66.114,0,0,0,0,0,"AL",0.038
"12991",551,"199908.246.1160.4","NMFS",1999,10,24,297,30,41.9305,-66.2435,0,0,0,0,0,"AL",0.038
"12992",552,"199908.247.1170.2","NMFS",1999,10,24,297,30,41.5305,-66.035833,2,2,0,2,0,"AL",0.038
"12993",552,"199908.248.1170.3","NMFS",1999,10,25,298,30,41.7695,-65.79,1,1,0,1,0,"AL",0.038
"12994",551,"199908.249.1170.1","NMFS",1999,10,25,298,30,41.8525,-65.8585,1,1,0,1,0,"AL",0.038
"12995",551,"199908.250.1180.1","NMFS",1999,10,25,298,30,41.852333,-65.725,0,0,0,0,0,"AL",0.038
"12996",464,"199908.251.1290.3","NMFS",1999,10,25,298,30,42.016,-65.769667,0,0,0,0,0,"AL",0.038
"12997",464,"199908.252.1290.5","NMFS",1999,10,25,298,30,42.065167,-65.675833,0,0,0,0,0,"AL",0.038
"12998",464,"199908.253.1290.1","NMFS",1999,10,25,298,30,42.361667,-65.8415,2,1,1,2,0,"AL",0.038
"12999",464,"199908.255.1300.1","NMFS",1999,10,25,298,30,42.4325,-66.5945,0,0,0,0,0,"AL",0.038
"13000",464,"199908.256.1360.7","NMFS",1999,10,26,299,30,42.812,-66.947667,1,1,0,1,0,"AL",0.038
"13001",464,"199908.257.1290.6","NMFS",1999,10,26,299,30,42.731667,-67.266333,0,0,0,0,0,"AL",0.038
"13002",515,"199908.258.1290.2","NMFS",1999,10,26,299,30,42.7245,-67.847833,0,0,0,0,0,"AL",0.038
"13003",464,"199908.259.1360.6","NMFS",1999,10,26,299,30,42.978,-67.350667,1,1,0,1,0,"AL",0.038
"13004",465,"199908.260.1360.3","NMFS",1999,10,26,299,30,43.024,-67.614833,0,0,0,0,0,"AL",0.038
"13005",515,"199908.261.1360.2","NMFS",1999,10,26,299,30,43.281,-67.822333,0,0,0,0,0,"AL",0.038
"13006",465,"199908.262.1360.4","NMFS",1999,10,26,299,30,43.307333,-67.459333,0,0,0,0,0,"AL",0.038
"13007",465,"199908.263.1360.1","NMFS",1999,10,26,299,30,43.367833,-67.272667,0,0,0,0,0,"AL",0.038
"13008",465,"199908.264.1360.9","NMFS",1999,10,26,299,30,43.383667,-67.055167,1,1,0,1,0,"AL",0.038
"13009",465,"199908.265.1360.5","NMFS",1999,10,27,300,30,43.417833,-66.981833,1,0,1,1,0,"AL",0.038
"13010",465,"199908.266.1340.4","NMFS",1999,10,27,300,30,43.415333,-66.874667,0,0,0,0,0,"AL",0.038
"13011",465,"199908.268.1330.3","NMFS",1999,10,27,300,30,43.193,-66.369667,9,6,3,7,2,"AL",0.038
"13012",465,"199908.269.1330.2","NMFS",1999,10,27,300,30,43.373,-66.569,4,3,1,4,0,"AL",0.038
"13013",465,"199908.270.1340.6","NMFS",1999,10,27,300,30,43.654333,-66.524,18,7,11,18,0,"AL",0.038
"13014",465,"199908.271.1330.4","NMFS",1999,10,27,300,30,43.771,-66.600667,4,3,1,4,0,"AL",0.038
"13015",465,"199908.272.1340.2","NMFS",1999,10,27,300,30,43.8035,-66.906667,10,10,0,10,0,"AL",0.038
"13016",511,"199908.273.1340.3","NMFS",1999,10,27,300,30,43.888667,-66.926833,0,0,0,0,0,"AL",0.038
"13017",466,"199908.274.1330.1","NMFS",1999,10,28,301,20,44.214333,-66.587333,0,0,0,0,0,"AL",0.038
"13018",466,"199908.275.1351.2","NMFS",1999,10,28,301,30,44.3535,-66.7165,0,0,0,0,0,"AL",0.038
"13019",511,"199908.276.1351.1","NMFS",1999,10,28,301,30,44.2745,-67.084833,1,0,1,1,0,"AL",0.038
"13020",511,"199908.277.1390.3","NMFS",1999,10,28,301,30,44.312667,-67.538333,1,1,0,1,0,"AL",0.038
"13021",511,"199908.278.1340.1","NMFS",1999,10,28,301,30,44.050333,-67.439333,5,5,0,5,0,"AL",0.038
"13022",514,"199908.279.3580.1","NMFS",1999,11,2,306,30,41.761,-70.318833,10,4,6,6,4,"AL",0.038
"13023",514,"199908.280.3600.2","NMFS",1999,11,2,306,30,41.942,-70.415,195,123,72,170,25,"AL",0.038
"13024",514,"199908.281.3610.1","NMFS",1999,11,2,306,30,42.036167,-70.418833,86,43,43,84,2,"AL",0.038
"13025",514,"199908.282.3600.1","NMFS",1999,11,2,306,25,42.025333,-70.517167,124,77,47,114,10,"AL",0.038
"13026",514,"199908.283.3590.1","NMFS",1999,11,2,306,30,42.0415,-70.575833,55,31,24,52,3,"AL",0.038
"13027",514,"199908.284.1260.9","NMFS",1999,11,2,306,30,42.138,-70.194167,1,1,0,1,0,"AL",0.038
"13028",514,"199908.285.3610.2","NMFS",1999,11,2,306,30,42.148333,-70.1445,0,0,0,0,0,"AL",0.038
"13029",514,"199908.286.1260.1","NMFS",1999,11,2,306,30,42.138333,-70.0255,1,1,0,1,0,"AL",0.038
"13030",521,"199908.287.1280.5","NMFS",1999,11,2,306,30,42.2295,-69.788667,0,0,0,0,0,"AL",0.038
"13031",521,"199908.288.1270.5","NMFS",1999,11,2,306,30,42.151167,-69.808667,0,0,0,0,0,"AL",0.038
"13032",521,"199908.289.1230.1","NMFS",1999,11,2,306,30,42.04,-69.849833,1,1,0,1,0,"AL",0.038
"13033",521,"199908.290.3560.1","NMFS",1999,11,2,306,30,41.949333,-69.948333,0,0,0,0,0,"AL",0.038
"13034",521,"199908.291.1240.1","NMFS",1999,11,3,307,30,41.953167,-69.764667,0,0,0,0,0,"AL",0.038
"13035",514,"199908.292.3650.1","NMFS",1999,11,4,308,30,42.195333,-70.5565,126,69,57,120,6,"AL",0.038
"13036",514,"199908.293.3630.1","NMFS",1999,11,4,308,25,42.234667,-70.678167,17,13,4,14,3,"AL",0.038
"13037",514,"199908.294.3640.1","NMFS",1999,11,4,308,25,42.3435,-70.775,19,10,9,19,0,"AL",0.038
"13038",514,"199908.295.1260.7","NMFS",1999,11,4,308,30,42.297833,-70.491333,38,17,21,38,0,"AL",0.038
"13039",514,"199908.296.1260.6","NMFS",1999,11,4,308,30,42.3505,-70.317167,2,1,1,2,0,"AL",0.038
"13040",514,"199908.297.1260.4","NMFS",1999,11,4,308,30,42.366333,-70.161833,0,0,0,0,0,"AL",0.038
"13041",514,"199908.298.1260.2","NMFS",1999,11,5,309,30,42.2765,-70.084,0,0,0,0,0,"AL",0.038
"13042",521,"199908.299.1270.6","NMFS",1999,11,5,309,30,42.307,-69.934667,0,0,0,0,0,"AL",0.038
"13043",514,"199908.300.1280.3","NMFS",1999,11,5,309,30,42.4405,-69.859,0,0,0,0,0,"AL",0.038
"13044",514,"199908.301.1260.8","NMFS",1999,11,5,309,30,42.497833,-70.205167,0,0,0,0,0,"AL",0.038
"13045",514,"199908.302.1280.4","NMFS",1999,11,5,309,30,42.6515,-69.836667,0,0,0,0,0,"AL",0.038
"13046",514,"199908.303.1270.3","NMFS",1999,11,5,309,30,42.691167,-69.978833,0,0,0,0,0,"AL",0.038
"13047",514,"199908.304.1270.7","NMFS",1999,11,5,309,30,42.74,-69.985833,0,0,0,0,0,"AL",0.038
"13048",514,"199908.305.1270.4","NMFS",1999,11,5,309,30,42.8105,-70.090167,0,0,0,0,0,"AL",0.038
"13049",514,"199908.306.3660.1","NMFS",1999,11,6,310,30,42.602333,-70.506,28,9,19,28,0,"AL",0.038
"13050",514,"199908.307.3660.2","NMFS",1999,11,6,310,30,42.811667,-70.667333,91,45,46,78,13,"AL",0.038
"13051",513,"199908.308.1400.3","NMFS",1999,11,6,310,30,42.900833,-70.4765,1,0,1,1,0,"AL",0.038
"13052",513,"199908.309.1270.2","NMFS",1999,11,6,310,30,42.900167,-70.215833,0,0,0,0,0,"AL",0.038
"13053",513,"199908.310.1260.5","NMFS",1999,11,6,310,30,42.975667,-70.037833,0,0,0,0,0,"AL",0.038
"13054",513,"199908.311.1270.8","NMFS",1999,11,6,310,30,43.059833,-70.216167,0,0,0,0,0,"AL",0.038
"13055",513,"199908.312.1260.3","NMFS",1999,11,6,310,30,43.149667,-70.082833,0,0,0,0,0,"AL",0.038
"13056",513,"199908.313.1270.1","NMFS",1999,11,6,310,30,43.191833,-69.949,0,0,0,0,0,"AL",0.038
"13057",513,"199908.314.1370.3","NMFS",1999,11,6,310,30,43.191667,-69.8535,0,0,0,0,0,"AL",0.038
"13058",513,"199908.315.1370.2","NMFS",1999,11,6,310,30,42.973333,-69.703,1,1,0,1,0,"AL",0.038
"13059",513,"199908.316.1370.10","NMFS",1999,11,6,310,30,42.919167,-69.555333,0,0,0,0,0,"AL",0.038
"13060",513,"199908.317.1370.4","NMFS",1999,11,6,310,28,43.1785,-69.644167,0,0,0,0,0,"AL",0.038
"13061",513,"199908.318.1380.2","NMFS",1999,11,6,310,30,43.352,-69.813,1,1,0,1,0,"AL",0.038
"13062",513,"199908.319.1380.10","NMFS",1999,11,7,311,30,43.434833,-69.645833,0,0,0,0,0,"AL",0.038
"13063",513,"199908.320.1400.1","NMFS",1999,11,7,311,30,43.529167,-70.035333,62,30,32,58,4,"AL",0.038
"13064",513,"199908.321.1400.2","NMFS",1999,11,7,311,30,43.560167,-69.8725,14,11,3,14,0,"AL",0.038
"13065",513,"199908.323.1380.1","NMFS",1999,11,7,311,30,43.304833,-69.291167,0,0,0,0,0,"AL",0.038
"13066",513,"199908.324.1380.3","NMFS",1999,11,7,311,30,43.448333,-69.0875,0,0,0,0,0,"AL",0.038
"13067",513,"199908.325.1380.8","NMFS",1999,11,8,312,30,43.592167,-69.109167,2,2,0,2,0,"AL",0.038
"13068",512,"199908.326.1380.4","NMFS",1999,11,8,312,30,43.489667,-68.9195,6,6,0,6,0,"AL",0.038
"13069",512,"199908.327.1390.2","NMFS",1999,11,8,312,30,43.925167,-68.741833,66,30,36,66,0,"AL",0.038
"13070",512,"199908.328.1380.7","NMFS",1999,11,8,312,30,43.809333,-68.466,4,4,0,4,0,"AL",0.038
"13071",512,"199908.329.1390.4","NMFS",1999,11,8,312,30,43.936667,-68.338333,10,7,3,10,0,"AL",0.038
"13072",512,"199908.330.1390.5","NMFS",1999,11,8,312,30,43.990667,-68.287167,14,13,1,14,0,"AL",0.038
"13073",512,"199908.331.1390.1","NMFS",1999,11,8,312,30,44.1905,-67.978667,34,22,12,25,9,"AL",0.038
"13074",511,"199908.332.1360.8","NMFS",1999,11,8,312,30,43.9025,-67.550333,2,1,1,2,0,"AL",0.038
"13075",512,"199908.333.1380.6","NMFS",1999,11,9,313,30,43.479333,-68.327,0,0,0,0,0,"AL",0.038
"13076",512,"199908.334.1380.5","NMFS",1999,11,9,313,30,43.4265,-68.408333,0,0,0,0,0,"AL",0.038
"13077",515,"199908.335.1370.6","NMFS",1999,11,9,313,30,43.0655,-68.687,0,0,0,0,0,"AL",0.038
"13078",515,"199908.336.1370.1","NMFS",1999,11,9,313,30,43.031,-69.143167,0,0,0,0,0,"AL",0.038
"13079",515,"199908.337.1370.9","NMFS",1999,11,9,313,30,42.986333,-68.869833,0,0,0,0,0,"AL",0.038
"13080",515,"199908.338.1370.7","NMFS",1999,11,9,313,30,42.8855,-68.868833,0,0,0,0,0,"AL",0.038
"13081",515,"199908.339.1370.8","NMFS",1999,11,9,313,30,42.725667,-68.972833,0,0,0,0,0,"AL",0.038
"13082",515,"199908.340.1370.5","NMFS",1999,11,9,313,30,42.675667,-68.818667,0,0,0,0,0,"AL",0.038
"13083",521,"199908.342.1240.7","NMFS",1999,11,9,313,30,42.265667,-69.0195,0,0,0,0,0,"AL",0.038
"13084",515,"199908.343.1280.6","NMFS",1999,11,10,314,30,42.396333,-69.325833,0,0,0,0,0,"AL",0.038
"13085",521,"199908.344.1280.7","NMFS",1999,11,10,314,30,42.305667,-69.6105,0,0,0,0,0,"AL",0.038
"13086",521,"199908.345.1280.2","NMFS",1999,11,10,314,30,42.095,-69.416,0,0,0,0,0,"AL",0.038
"13087",521,"199908.346.1280.1","NMFS",1999,11,10,314,30,41.937667,-69.220333,0,0,0,0,0,"AL",0.038
"13088",526,"200002.175.1110.1","NMFS",2000,4,5,96,30,40.014833,-69.689833,0,0,0,0,0,"AL",0.038
"13089",526,"200002.176.1120.1","NMFS",2000,4,5,96,30,39.94,-69.399833,33,9,24,31,2,"AL",0.038
"13090",526,"200002.177.1090.2","NMFS",2000,4,6,97,30,40.615833,-69.423833,0,0,0,0,0,"AL",0.038
"13091",526,"200002.178.1090.3","NMFS",2000,4,6,97,30,40.6835,-69.481667,0,0,0,0,0,"AL",0.038
"13092",526,"200002.179.1100.7","NMFS",2000,4,6,97,30,40.609667,-69.573,0,0,0,0,0,"AL",0.038
"13093",526,"200002.180.1100.5","NMFS",2000,4,6,97,30,40.567333,-69.821,0,0,0,0,0,"AL",0.038
"13094",526,"200002.183.1100.1","NMFS",2000,4,7,98,30,40.197667,-69.698167,0,0,0,0,0,"AL",0.038
"13095",526,"200002.184.1100.6","NMFS",2000,4,7,98,30,40.1045,-69.618667,0,0,0,0,0,"AL",0.038
"13096",526,"200002.185.1100.3","NMFS",2000,4,7,98,30,40.3965,-68.938667,0,0,0,0,0,"AL",0.038
"13097",525,"200002.186.1130.8","NMFS",2000,4,7,98,30,40.441167,-68.700833,0,0,0,0,0,"AL",0.038
"13098",525,"200002.187.1130.5","NMFS",2000,4,7,98,30,40.633333,-68.652667,0,0,0,0,0,"AL",0.038
"13099",525,"200002.188.1130.1","NMFS",2000,4,7,98,30,40.641167,-68.101833,0,0,0,0,0,"AL",0.038
"13100",525,"200002.189.1130.9","NMFS",2000,4,7,98,30,40.5205,-68.208667,0,0,0,0,0,"AL",0.038
"13101",525,"200002.190.1150.1","NMFS",2000,4,8,99,30,40.412333,-68.1575,1,0,1,1,0,"AL",0.038
"13102",525,"200002.191.1140.2","NMFS",2000,4,8,99,30,40.3595,-67.937333,0,0,0,0,0,"AL",0.038
"13103",525,"200002.192.1140.1","NMFS",2000,4,8,99,30,40.504,-67.6185,0,0,0,0,0,"AL",0.038
"13104",525,"200002.193.1140.3","NMFS",2000,4,8,99,30,40.546167,-67.540667,0,0,0,0,0,"AL",0.038
"13105",521,"200002.194.1230.4","NMFS",2000,4,8,99,30,41.040667,-69.097667,0,0,0,0,0,"AL",0.038
"13106",521,"200002.195.1250.4","NMFS",2000,4,8,99,30,41.0875,-69.284333,0,0,0,0,0,"AL",0.038
"13107",521,"200002.196.3550.1","NMFS",2000,4,8,99,30,41.096333,-69.4715,0,0,0,0,0,"AL",0.038
"13108",526,"200002.197.3550.5","NMFS",2000,4,8,99,30,41.042167,-69.5665,0,0,0,0,0,"AL",0.038
"13109",526,"200002.198.3550.2","NMFS",2000,4,8,99,30,41.010833,-69.718,0,0,0,0,0,"AL",0.038
"13110",526,"200002.199.3550.3","NMFS",2000,4,8,99,30,41.089333,-69.7255,0,0,0,0,0,"AL",0.038
"13111",521,"200002.200.3550.4","NMFS",2000,4,10,101,20,41.513333,-69.775667,0,0,0,0,0,"AL",0.038
"13112",521,"200002.201.1250.1","NMFS",2000,4,10,101,30,41.590333,-69.7425,4,1,3,4,0,"AL",0.038
"13113",521,"200002.202.3560.1","NMFS",2000,4,11,102,30,41.714833,-69.878,5,1,4,4,1,"AL",0.038
"13114",521,"200002.203.1230.2","NMFS",2000,4,11,102,30,41.736667,-69.723833,1,0,1,0,1,"AL",0.038
"13115",521,"200002.204.1250.3","NMFS",2000,4,11,102,30,41.4495,-69.491833,2,2,0,2,0,"AL",0.038
"13116",521,"200002.205.1250.2","NMFS",2000,4,11,102,30,41.439,-69.407667,0,0,0,0,0,"AL",0.038
"13117",521,"200002.206.1240.2","NMFS",2000,4,11,102,30,41.513833,-69.243,0,0,0,0,0,"AL",0.038
"13118",521,"200002.207.1240.3","NMFS",2000,4,11,102,30,41.601,-69.136833,2,2,0,2,0,"AL",0.038
"13119",521,"200002.208.1240.5","NMFS",2000,4,11,102,30,41.320667,-68.906333,0,0,0,0,0,"AL",0.038
"13120",522,"200002.209.1230.5","NMFS",2000,4,11,102,30,41.2895,-68.549833,1,0,1,1,0,"AL",0.038
"13121",522,"200002.210.1190.1","NMFS",2000,4,11,102,30,41.208167,-68.243667,0,0,0,0,0,"AL",0.038
"13122",525,"200002.211.1190.8","NMFS",2000,4,11,102,30,41.067833,-68.145,0,0,0,0,0,"AL",0.038
"13123",525,"200002.212.1190.5","NMFS",2000,4,11,102,30,40.980167,-68.309,0,0,0,0,0,"AL",0.038
"13124",525,"200002.213.1190.3","NMFS",2000,4,11,102,30,40.939,-68.195167,0,0,0,0,0,"AL",0.038
"13125",525,"200002.214.1130.3","NMFS",2000,4,12,103,30,40.946,-67.617,0,0,0,0,0,"AL",0.038
"13126",525,"200002.215.1130.6","NMFS",2000,4,12,103,30,40.854167,-67.576667,0,0,0,0,0,"AL",0.038
"13127",525,"200002.216.1130.4","NMFS",2000,4,12,103,30,40.875,-67.412333,0,0,0,0,0,"AL",0.038
"13128",525,"200002.217.1130.2","NMFS",2000,4,12,103,30,41.059833,-67.365833,0,0,0,0,0,"AL",0.038
"13129",525,"200002.218.1130.7","NMFS",2000,4,12,103,30,40.943833,-67.188833,0,0,0,0,0,"AL",0.038
"13130",562,"200002.219.1160.10","NMFS",2000,4,12,103,30,40.848167,-66.8155,0,0,0,0,0,"AL",0.038
"13131",562,"200002.220.1170.3","NMFS",2000,4,12,103,30,40.88,-66.639,0,0,0,0,0,"AL",0.038
"13132",562,"200002.222.1180.2","NMFS",2000,4,12,103,30,40.922667,-66.532,0,0,0,0,0,"AL",0.038
"13133",562,"200002.223.1160.8","NMFS",2000,4,12,103,30,41.185167,-66.683167,0,0,0,0,0,"AL",0.038
"13134",562,"200002.224.1160.1","NMFS",2000,4,12,103,30,41.351333,-66.683833,0,0,0,0,0,"AL",0.038
"13135",562,"200002.225.1160.6","NMFS",2000,4,12,103,30,41.465833,-66.575333,0,0,0,0,0,"AL",0.038
"13136",552,"200002.226.1160.9","NMFS",2000,4,13,104,30,41.517833,-66.604667,0,0,0,0,0,"AL",0.038
"13137",562,"200002.227.1160.3","NMFS",2000,4,13,104,30,41.382833,-66.997,0,0,0,0,0,"AL",0.038
"13138",562,"200002.228.1160.7","NMFS",2000,4,13,104,30,41.516,-67.0425,0,0,0,0,0,"AL",0.038
"13139",562,"200002.229.1190.7","NMFS",2000,4,13,104,30,41.639833,-67.238167,0,0,0,0,0,"AL",0.038
"13140",562,"200002.230.1190.4","NMFS",2000,4,13,104,30,41.616333,-67.353,0,0,0,0,0,"AL",0.038
"13141",522,"200002.231.1190.9","NMFS",2000,4,13,104,30,41.357333,-67.735167,0,0,0,0,0,"AL",0.038
"13142",522,"200002.232.1190.6","NMFS",2000,4,13,104,30,41.3485,-67.867167,0,0,0,0,0,"AL",0.038
"13143",522,"200002.233.1200.1","NMFS",2000,4,13,104,30,41.617,-68.315833,0,0,0,0,0,"AL",0.038
"13144",522,"200002.234.1200.5","NMFS",2000,4,13,104,30,41.544667,-68.355833,0,0,0,0,0,"AL",0.038
"13145",522,"200002.235.1230.1","NMFS",2000,4,13,104,30,41.485167,-68.4005,0,0,0,0,0,"AL",0.038
"13146",514,"200002.236.3580.1","NMFS",2000,4,17,108,30,41.766833,-70.1885,3,1,2,2,1,"AL",0.038
"13147",514,"200002.237.3590.1","NMFS",2000,4,18,109,30,41.855333,-70.375833,254,115,139,189,65,"AL",0.038
"13148",514,"200002.238.3600.2","NMFS",2000,4,18,109,30,41.942,-70.318,20,7,13,18,2,"AL",0.038
"13149",514,"200002.239.3600.1","NMFS",2000,4,18,109,30,41.938833,-70.3495,18,4,14,16,2,"AL",0.038
"13150",514,"200002.240.3610.1","NMFS",2000,4,18,109,30,41.98,-70.4185,113,48,65,108,5,"AL",0.038
"13151",514,"200002.242.1260.4","NMFS",2000,4,18,109,27,42.316167,-70.551,11,2,9,11,0,"AL",0.038
"13152",514,"200002.243.3660.1","NMFS",2000,4,18,109,30,42.346667,-70.650667,49,12,37,49,0,"AL",0.038
"13153",514,"200002.244.3640.1","NMFS",2000,4,18,109,30,42.347833,-70.799,59,48,11,59,0,"AL",0.038
"13154",514,"200002.245.1260.1","NMFS",2000,4,18,109,30,42.472167,-70.518667,8,4,4,8,0,"AL",0.038
"13155",514,"200002.247.3630.1","NMFS",2000,4,19,110,30,42.748667,-70.764667,3,0,3,3,0,"AL",0.038
"13156",514,"200002.248.1260.5","NMFS",2000,4,19,110,30,42.603333,-70.226,0,0,0,0,0,"AL",0.038
"13157",514,"200002.249.1270.1","NMFS",2000,4,19,110,30,42.685333,-70.065833,4,4,0,4,0,"AL",0.038
"13158",514,"200002.250.1280.6","NMFS",2000,4,19,110,30,42.695333,-69.715,0,0,0,0,0,"AL",0.038
"13159",514,"200002.251.1280.1","NMFS",2000,4,19,110,30,42.479167,-69.821333,0,0,0,0,0,"AL",0.038
"13160",514,"200002.252.1280.4","NMFS",2000,4,19,110,30,42.437167,-69.894667,2,2,0,2,0,"AL",0.038
"13161",514,"200002.253.1260.2","NMFS",2000,4,19,110,30,42.358667,-70.1575,1,1,0,1,0,"AL",0.038
"13162",514,"200002.254.1260.3","NMFS",2000,4,19,110,30,42.118167,-70.283333,5,2,3,5,0,"AL",0.038
"13163",521,"200002.256.1280.8","NMFS",2000,4,20,111,30,42.196,-69.717833,0,0,0,0,0,"AL",0.038
"13164",521,"200002.257.1280.3","NMFS",2000,4,20,111,30,42.0125,-69.5655,0,0,0,0,0,"AL",0.038
"13165",521,"200002.258.1240.1","NMFS",2000,4,20,111,30,41.867667,-68.848833,0,0,0,0,0,"AL",0.038
"13166",522,"200002.259.1240.4","NMFS",2000,4,20,111,30,41.5645,-68.612167,0,0,0,0,0,"AL",0.038
"13167",522,"200002.260.1230.3","NMFS",2000,4,20,111,30,41.478833,-68.516667,0,0,0,0,0,"AL",0.038
"13168",522,"200002.261.1200.4","NMFS",2000,4,20,111,30,41.729,-67.931,1,1,0,0,1,"AL",0.038
"13169",522,"200002.262.1200.6","NMFS",2000,4,21,112,30,41.747,-67.767,1,0,1,1,0,"AL",0.038
"13170",522,"200002.263.1210.2","NMFS",2000,4,21,112,30,41.874833,-67.942,1,1,0,1,0,"AL",0.038
"13171",522,"200002.264.1220.1","NMFS",2000,4,21,112,30,42.035667,-67.8375,2,1,1,2,0,"AL",0.038
"13172",522,"200002.265.1290.5","NMFS",2000,4,21,112,30,42.225167,-68.076,1,0,1,1,0,"AL",0.038
"13173",515,"200002.266.1240.6","NMFS",2000,4,21,112,30,42.365833,-68.546667,0,0,0,0,0,"AL",0.038
"13174",515,"200002.267.1280.2","NMFS",2000,4,21,112,30,42.410167,-68.678833,0,0,0,0,0,"AL",0.038
"13175",515,"200002.268.1280.7","NMFS",2000,4,21,112,30,42.5625,-68.548,0,0,0,0,0,"AL",0.038
"13176",515,"200002.269.1290.6","NMFS",2000,4,21,112,30,42.476833,-67.9905,0,0,0,0,0,"AL",0.038
"13177",515,"200002.270.1290.3","NMFS",2000,4,21,112,30,42.475167,-67.758667,0,0,0,0,0,"AL",0.038
"13178",522,"200002.271.1220.3","NMFS",2000,4,22,113,30,42.128833,-67.749667,3,2,1,3,0,"AL",0.038
"13179",561,"200002.272.1200.3","NMFS",2000,4,22,113,30,41.872667,-67.447167,2,1,1,2,0,"AL",0.038
"13180",561,"200002.273.1190.2","NMFS",2000,4,22,113,30,41.882167,-67.250667,2,1,1,2,0,"AL",0.038
"13181",561,"200002.274.1200.2","NMFS",2000,4,22,113,30,41.961667,-67.3365,0,0,0,0,0,"AL",0.038
"13182",561,"200002.275.1210.1","NMFS",2000,4,22,113,30,42.1375,-67.353333,0,0,0,0,0,"AL",0.038
"13183",561,"200002.276.1210.4","NMFS",2000,4,22,113,30,42.107833,-67.192167,1,0,1,0,1,"AL",0.038
"13184",551,"200002.277.1220.2","NMFS",2000,4,22,113,30,42.1845,-67.145833,0,0,0,0,0,"AL",0.038
"13185",551,"200002.278.1160.4","NMFS",2000,4,22,113,30,42.025833,-66.935667,1,0,1,1,0,"AL",0.038
"13186",552,"200002.279.1160.2","NMFS",2000,4,22,113,30,41.7615,-66.401667,0,0,0,0,0,"AL",0.038
"13187",552,"200002.280.1160.5","NMFS",2000,4,23,114,30,41.5465,-66.471167,0,0,0,0,0,"AL",0.038
"13188",552,"200002.281.1170.1","NMFS",2000,4,23,114,30,41.406167,-66.139667,0,0,0,0,0,"AL",0.038
"13189",552,"200002.282.1170.2","NMFS",2000,4,23,114,30,41.794333,-65.823,1,0,1,1,0,"AL",0.038
"13190",464,"200002.283.1290.2","NMFS",2000,4,23,114,30,42.058333,-65.7325,1,1,0,1,0,"AL",0.038
"13191",551,"200002.284.1290.4","NMFS",2000,4,23,114,30,42.073833,-65.902667,1,1,0,1,0,"AL",0.038
"13192",551,"200002.285.1220.4","NMFS",2000,4,23,114,30,42.09,-66.031333,0,0,0,0,0,"AL",0.038
"13193",551,"200002.286.1210.3","NMFS",2000,4,23,114,30,42.131833,-66.175,0,0,0,0,0,"AL",0.038
"13194",464,"200002.287.1290.1","NMFS",2000,4,24,115,30,42.479,-66.471833,5,4,1,5,0,"AL",0.038
"13195",464,"200002.288.1290.7","NMFS",2000,4,24,115,30,42.5955,-66.670667,0,0,0,0,0,"AL",0.038
"13196",464,"200002.289.1300.2","NMFS",2000,4,24,115,30,42.351333,-67.096833,0,0,0,0,0,"AL",0.038
"13197",464,"200002.290.1300.3","NMFS",2000,4,24,115,30,42.490833,-67.2835,0,0,0,0,0,"AL",0.038
"13198",464,"200002.291.1300.1","NMFS",2000,4,24,115,30,42.550833,-67.067667,2,1,1,2,0,"AL",0.038
"13199",464,"200002.292.1360.3","NMFS",2000,4,24,115,30,42.971833,-67.401333,0,0,0,0,0,"AL",0.038
"13200",465,"200002.293.1360.8","NMFS",2000,4,24,115,30,43.060667,-67.607833,0,0,0,0,0,"AL",0.038
"13201",465,"200002.296.1340.5","NMFS",2000,4,25,116,30,43.401667,-66.6025,2,0,2,2,0,"AL",0.038
"13202",465,"200002.297.1360.2","NMFS",2000,4,25,116,30,43.301,-67.178667,2,2,0,2,0,"AL",0.038
"13203",465,"200002.298.1360.5","NMFS",2000,4,25,116,30,43.479667,-67.2555,0,0,0,0,0,"AL",0.038
"13204",465,"200002.299.1360.6","NMFS",2000,4,25,116,30,43.474,-67.0015,1,0,1,1,0,"AL",0.038
"13205",465,"200002.300.1340.3","NMFS",2000,4,25,116,30,43.563333,-66.612333,6,4,2,6,0,"AL",0.038
"13206",465,"200002.301.1340.6","NMFS",2000,4,25,116,30,43.611167,-66.595333,5,3,2,5,0,"AL",0.038
"13207",465,"200002.302.1330.3","NMFS",2000,4,25,116,30,43.633833,-66.367667,4,3,1,4,0,"AL",0.038
"13208",465,"200002.303.1330.4","NMFS",2000,4,25,116,30,43.747667,-66.486167,1,1,0,1,0,"AL",0.038
"13209",465,"200002.304.1330.1","NMFS",2000,4,26,117,30,43.8605,-66.637,5,1,4,5,0,"AL",0.038
"13210",511,"200002.305.1340.4","NMFS",2000,4,26,117,30,43.930667,-66.946167,0,0,0,0,0,"AL",0.038
"13211",511,"200002.306.1340.1","NMFS",2000,4,26,117,30,44.015667,-66.965167,1,0,1,1,0,"AL",0.038
"13212",511,"200002.307.1340.2","NMFS",2000,4,26,117,30,43.9425,-67.244833,0,0,0,0,0,"AL",0.038
"13213",467,"200002.308.1351.2","NMFS",2000,4,26,117,30,44.387167,-66.899667,13,7,6,13,0,"AL",0.038
"13214",511,"200002.309.1351.1","NMFS",2000,4,26,117,30,44.2835,-67.247667,1,1,0,1,0,"AL",0.038
"13215",511,"200002.310.1390.4","NMFS",2000,4,26,117,30,44.305667,-67.751167,17,9,8,10,7,"AL",0.038
"13216",511,"200002.311.1390.2","NMFS",2000,4,26,117,30,44.235333,-67.814,1,1,0,0,1,"AL",0.038
"13217",512,"200002.312.1390.1","NMFS",2000,4,27,118,30,44.092333,-68.022,0,0,0,0,0,"AL",0.038
"13218",512,"200002.313.1380.1","NMFS",2000,4,27,118,30,43.762667,-68.071667,0,0,0,0,0,"AL",0.038
"13219",512,"200002.314.1380.2","NMFS",2000,4,27,118,30,43.684333,-68.237667,0,0,0,0,0,"AL",0.038
"13220",512,"200002.315.1360.4","NMFS",2000,4,27,118,30,43.602833,-67.946,2,1,1,2,0,"AL",0.038
"13221",515,"200002.316.1360.7","NMFS",2000,4,27,118,30,43.135833,-68.140833,2,1,1,2,0,"AL",0.038
"13222",515,"200002.317.1370.1","NMFS",2000,4,27,118,30,42.992,-68.584,1,1,0,1,0,"AL",0.038
"13223",515,"200002.318.1370.3","NMFS",2000,4,27,118,30,42.9345,-68.7765,0,0,0,0,0,"AL",0.038
"13224",515,"200002.319.1370.2","NMFS",2000,4,27,118,30,42.792167,-68.7435,0,0,0,0,0,"AL",0.038
"13225",513,"200002.320.1400.3","NMFS",2000,5,2,123,30,42.984667,-70.428833,5,2,3,5,0,"AL",0.038
"13226",513,"200002.321.1270.2","NMFS",2000,5,2,123,30,43.057833,-70.240333,0,0,0,0,0,"AL",0.038
"13227",513,"200002.322.1400.2","NMFS",2000,5,2,123,30,43.193667,-70.3075,5,1,4,5,0,"AL",0.038
"13228",513,"200002.323.1270.3","NMFS",2000,5,2,123,30,43.319333,-70.039167,0,0,0,0,0,"AL",0.038
"13229",513,"200002.324.1270.4","NMFS",2000,5,2,123,30,43.369833,-70.032833,0,0,0,0,0,"AL",0.038
"13230",513,"200002.325.1400.1","NMFS",2000,5,2,123,30,43.6015,-69.869167,15,6,9,14,1,"AL",0.038
"13231",512,"200002.326.1390.5","NMFS",2000,5,2,123,30,43.867667,-68.926833,241,91,150,209,32,"AL",0.038
"13232",512,"200002.327.1390.3","NMFS",2000,5,3,124,30,43.910833,-68.577167,7,0,7,7,0,"AL",0.038
"13233",512,"200002.328.1380.4","NMFS",2000,5,3,124,30,43.429,-68.868,9,7,2,8,1,"AL",0.038
"13234",512,"200002.329.1380.3","NMFS",2000,5,3,124,30,43.486167,-68.632833,2,2,0,2,0,"AL",0.038
"13235",512,"200002.330.1380.5","NMFS",2000,5,3,124,30,43.361167,-68.682167,2,2,0,2,0,"AL",0.038
"13236",515,"200002.331.1360.1","NMFS",2000,5,3,124,30,43.1535,-68.542667,5,5,0,5,0,"AL",0.038
"13237",513,"200002.332.1370.5","NMFS",2000,5,3,124,30,43.0945,-69.3785,0,0,0,0,0,"AL",0.038
"13238",515,"200002.333.1370.4","NMFS",2000,5,3,124,30,42.924833,-69.242833,0,0,0,0,0,"AL",0.038
"13239",526,"200005.182.1110.1","NMFS",2000,9,24,268,30,40.064167,-69.845667,1,1,0,0,1,"AL",0.038
"13240",526,"200005.183.1100.4","NMFS",2000,9,24,268,30,40.103333,-69.535833,1,0,1,1,0,"AL",0.038
"13241",526,"200005.184.1100.3","NMFS",2000,9,25,269,30,40.115167,-69.4465,0,0,0,0,0,"AL",0.038
"13242",526,"200005.185.1100.8","NMFS",2000,9,25,269,30,40.2335,-69.3495,0,0,0,0,0,"AL",0.038
"13243",526,"200005.186.1100.7","NMFS",2000,9,25,269,30,40.391167,-69.3325,0,0,0,0,0,"AL",0.038
"13244",526,"200005.187.1120.1","NMFS",2000,9,25,269,30,40.049667,-68.956,2,2,0,2,0,"AL",0.038
"13245",525,"200005.188.1110.2","NMFS",2000,9,25,269,30,40.189667,-68.8195,1,1,0,0,1,"AL",0.038
"13246",525,"200005.189.1140.2","NMFS",2000,9,25,269,30,40.237,-68.4735,0,0,0,0,0,"AL",0.038
"13247",525,"200005.190.1140.3","NMFS",2000,9,25,269,30,40.317167,-68.307333,0,0,0,0,0,"AL",0.038
"13248",525,"200005.191.1150.1","NMFS",2000,9,25,269,30,40.402167,-68.164333,4,4,0,4,0,"AL",0.038
"13249",525,"200005.192.1130.3","NMFS",2000,9,25,269,30,40.600333,-68.014833,0,0,0,0,0,"AL",0.038
"13250",525,"200005.193.1130.9","NMFS",2000,9,25,269,30,40.602333,-67.594833,0,0,0,0,0,"AL",0.038
"13251",525,"200005.194.1140.1","NMFS",2000,9,25,269,30,40.6045,-67.109167,0,0,0,0,0,"AL",0.038
"13252",562,"200005.195.1160.3","NMFS",2000,9,26,270,30,40.934,-66.720667,0,0,0,0,0,"AL",0.038
"13253",562,"200005.196.1130.5","NMFS",2000,9,26,270,30,40.844167,-66.9165,0,0,0,0,0,"AL",0.038
"13254",525,"200005.197.1130.4","NMFS",2000,9,26,270,30,40.7245,-67.315,0,0,0,0,0,"AL",0.038
"13255",525,"200005.198.1130.8","NMFS",2000,9,26,270,30,40.849667,-67.284,0,0,0,0,0,"AL",0.038
"13256",525,"200005.199.1130.7","NMFS",2000,9,26,270,30,40.983667,-67.5885,0,0,0,0,0,"AL",0.038
"13257",525,"200005.200.1190.7","NMFS",2000,9,26,270,30,41.023333,-67.811167,0,0,0,0,0,"AL",0.038
"13258",525,"200005.201.1130.2","NMFS",2000,9,26,270,30,40.940333,-67.875833,0,0,0,0,0,"AL",0.038
"13259",525,"200005.202.1190.2","NMFS",2000,9,26,270,30,40.844833,-68.377,0,0,0,0,0,"AL",0.038
"13260",525,"200005.203.1190.4","NMFS",2000,9,26,270,30,40.770333,-68.412,0,0,0,0,0,"AL",0.038
"13261",525,"200005.204.1190.6","NMFS",2000,9,26,270,30,40.7635,-68.587,1,1,0,1,0,"AL",0.038
"13262",525,"200005.205.1130.1","NMFS",2000,9,27,271,30,40.647,-68.729,0,0,0,0,0,"AL",0.038
"13263",525,"200005.206.1130.6","NMFS",2000,9,27,271,30,40.568333,-68.706333,0,0,0,0,0,"AL",0.038
"13264",526,"200005.207.1100.5","NMFS",2000,9,27,271,30,40.6085,-69.083167,0,0,0,0,0,"AL",0.038
"13265",522,"200005.208.1230.3","NMFS",2000,9,27,271,30,41.201167,-68.701167,1,0,1,1,0,"AL",0.038
"13266",522,"200005.209.1230.4","NMFS",2000,9,27,271,30,41.387167,-68.669,0,0,0,0,0,"AL",0.038
"13267",521,"200005.210.1230.2","NMFS",2000,9,27,271,30,41.181667,-68.902,0,0,0,0,0,"AL",0.038
"13268",521,"200005.211.1240.4","NMFS",2000,9,27,271,30,41.2675,-68.984,0,0,0,0,0,"AL",0.038
"13269",521,"200005.212.1250.1","NMFS",2000,9,27,271,30,41.125167,-69.243,0,0,0,0,0,"AL",0.038
"13270",526,"200005.213.1090.5","NMFS",2000,9,28,272,30,40.929667,-69.677833,0,0,0,0,0,"AL",0.038
"13271",526,"200005.214.3550.3","NMFS",2000,9,28,272,30,41.087833,-69.6465,0,0,0,0,0,"AL",0.038
"13272",526,"200005.215.3550.2","NMFS",2000,9,28,272,30,41.1235,-69.61,0,0,0,0,0,"AL",0.038
"13273",521,"200005.216.3550.5","NMFS",2000,9,28,272,30,41.247667,-69.4835,8,4,4,8,0,"AL",0.038
"13274",521,"200005.217.3550.1","NMFS",2000,9,28,272,30,41.483833,-69.679,6,3,3,6,0,"AL",0.038
"13275",521,"200005.218.1250.3","NMFS",2000,9,28,272,30,41.436833,-69.377167,1,0,1,1,0,"AL",0.038
"13276",521,"200005.219.1240.2","NMFS",2000,9,28,272,30,41.684167,-69.305,0,0,0,0,0,"AL",0.038
"13277",521,"200005.220.1240.3","NMFS",2000,9,28,272,30,41.765833,-69.393,0,0,0,0,0,"AL",0.038
"13278",521,"200005.221.1240.5","NMFS",2000,9,28,272,30,41.844333,-69.667333,0,0,0,0,0,"AL",0.038
"13279",521,"200005.222.1230.1","NMFS",2000,9,28,272,30,41.763167,-69.772,0,0,0,0,0,"AL",0.038
"13280",521,"200005.223.3550.4","NMFS",2000,9,29,273,30,41.611833,-69.782333,17,10,7,17,0,"AL",0.038
"13281",521,"200005.225.1250.5","NMFS",2000,10,4,278,30,41.603333,-69.753167,9,5,4,8,1,"AL",0.038
"13282",522,"200005.226.1240.6","NMFS",2000,10,4,278,30,41.894667,-68.413667,0,0,0,0,0,"AL",0.038
"13283",522,"200005.227.1200.3","NMFS",2000,10,4,278,30,41.726,-68.1325,29,11,18,28,1,"AL",0.038
"13284",522,"200005.228.1240.1","NMFS",2000,10,4,278,30,41.6595,-68.463667,0,0,0,0,0,"AL",0.038
"13285",522,"200005.229.1200.5","NMFS",2000,10,4,278,30,41.565833,-68.322,13,7,6,12,1,"AL",0.038
"13286",522,"200005.230.1200.1","NMFS",2000,10,4,278,30,41.494,-68.166333,4,2,2,4,0,"AL",0.038
"13287",522,"200005.231.1200.2","NMFS",2000,10,4,278,30,41.564,-67.881167,1,1,0,1,0,"AL",0.038
"13288",562,"200005.232.1190.3","NMFS",2000,10,4,278,30,41.518167,-67.596667,0,0,0,0,0,"AL",0.038
"13289",562,"200005.233.1190.5","NMFS",2000,10,4,278,30,41.480333,-67.508333,4,2,2,4,0,"AL",0.038
"13290",562,"200005.234.1190.1","NMFS",2000,10,4,278,30,41.308667,-67.543333,3,1,2,3,0,"AL",0.038
"13291",562,"200005.235.1190.9","NMFS",2000,10,5,279,30,41.223667,-67.308,2,1,1,2,0,"AL",0.038
"13292",562,"200005.236.1160.5","NMFS",2000,10,5,279,30,41.320833,-66.968667,1,1,0,1,0,"AL",0.038
"13293",562,"200005.237.1160.2","NMFS",2000,10,5,279,30,41.398167,-67.049,2,2,0,2,0,"AL",0.038
"13294",562,"200005.238.1160.7","NMFS",2000,10,5,279,30,41.530667,-67.0825,2,2,0,2,0,"AL",0.038
"13295",562,"200005.239.1190.8","NMFS",2000,10,5,279,30,41.523,-67.309333,0,0,0,0,0,"AL",0.038
"13296",561,"200005.240.1200.6","NMFS",2000,10,5,279,30,41.928167,-67.360333,0,0,0,0,0,"AL",0.038
"13297",522,"200005.241.1200.4","NMFS",2000,10,5,279,30,41.857333,-67.685667,2,2,0,2,0,"AL",0.038
"13298",522,"200005.242.1210.1","NMFS",2000,10,5,279,30,41.978333,-67.813333,0,0,0,0,0,"AL",0.038
"13299",522,"200005.243.1290.1","NMFS",2000,10,5,279,30,42.191,-68.073,0,0,0,0,0,"AL",0.038
"13300",522,"200005.244.1290.7","NMFS",2000,10,5,279,30,42.2305,-67.976167,1,0,1,1,0,"AL",0.038
"13301",522,"200005.245.1220.1","NMFS",2000,10,5,279,30,42.190667,-67.738667,0,0,0,0,0,"AL",0.038
"13302",561,"200005.246.1290.8","NMFS",2000,10,6,280,30,42.187833,-67.479833,1,0,1,1,0,"AL",0.038
"13303",561,"200005.247.1210.4","NMFS",2000,10,6,280,30,42.144667,-67.270167,0,0,0,0,0,"AL",0.038
"13304",561,"200005.248.1220.3","NMFS",2000,10,6,280,30,42.188333,-67.309333,0,0,0,0,0,"AL",0.038
"13305",464,"200005.249.1300.2","NMFS",2000,10,6,280,30,42.394167,-67.041167,0,0,0,0,0,"AL",0.038
"13306",464,"200005.250.1300.1","NMFS",2000,10,6,280,30,42.3475,-67.019833,0,0,0,0,0,"AL",0.038
"13307",551,"200005.251.1220.2","NMFS",2000,10,6,280,30,42.187167,-67.002833,0,0,0,0,0,"AL",0.038
"13308",551,"200005.252.1210.2","NMFS",2000,10,6,280,30,42.1365,-66.942,1,1,0,1,0,"AL",0.038
"13309",551,"200005.253.1160.1","NMFS",2000,10,6,280,30,41.978833,-66.913,0,0,0,0,0,"AL",0.038
"13310",551,"200005.254.1160.4","NMFS",2000,10,6,280,30,41.9005,-66.819667,1,1,0,1,0,"AL",0.038
"13311",552,"200005.255.1160.6","NMFS",2000,10,6,280,30,41.776167,-66.748667,1,1,0,1,0,"AL",0.038
"13312",552,"200005.256.1160.10","NMFS",2000,10,6,280,30,41.812167,-66.199667,0,0,0,0,0,"AL",0.038
"13313",552,"200005.257.1170.2","NMFS",2000,10,7,281,30,41.637833,-65.889167,0,0,0,0,0,"AL",0.038
"13314",552,"200005.258.1170.1","NMFS",2000,10,7,281,30,41.8085,-65.818333,0,0,0,0,0,"AL",0.038
"13315",551,"200005.259.1170.3","NMFS",2000,10,7,281,30,41.852,-65.875,0,0,0,0,0,"AL",0.038
"13316",551,"200005.260.1180.1","NMFS",2000,10,7,281,30,42.050167,-65.911833,0,0,0,0,0,"AL",0.038
"13317",464,"200005.261.1290.3","NMFS",2000,10,7,281,30,42.262167,-65.986833,0,0,0,0,0,"AL",0.038
"13318",551,"200005.262.1160.8","NMFS",2000,10,7,281,30,42.055833,-66.130833,0,0,0,0,0,"AL",0.038
"13319",551,"200005.263.1160.9","NMFS",2000,10,7,281,30,41.979333,-66.243833,1,1,0,1,0,"AL",0.038
"13320",551,"200005.264.1210.3","NMFS",2000,10,7,281,30,42.098333,-66.273333,0,0,0,0,0,"AL",0.038
"13321",551,"200005.265.1290.2","NMFS",2000,10,7,281,30,42.228,-66.351167,0,0,0,0,0,"AL",0.038
"13322",551,"200005.266.1300.3","NMFS",2000,10,7,281,30,42.317167,-66.611,0,0,0,0,0,"AL",0.038
"13323",464,"200005.267.1290.5","NMFS",2000,10,7,281,30,42.4815,-66.394,1,0,1,1,0,"AL",0.038
"13324",464,"200005.268.1360.3","NMFS",2000,10,8,282,30,42.933,-67.098,0,0,0,0,0,"AL",0.038
"13325",465,"200005.269.1330.1","NMFS",2000,10,8,282,20.5,43.273333,-66.514167,2,0,2,2,0,"AL",0.038
"13326",465,"200005.270.1330.2","NMFS",2000,10,8,282,29.5,43.344667,-66.278667,223,125,98,221,2,"AL",0.038
"13327",465,"200005.271.1340.4","NMFS",2000,10,8,282,30,43.461167,-66.765833,4,4,0,4,0,"AL",0.038
"13328",465,"200005.272.1330.4","NMFS",2000,10,8,282,30,43.782833,-66.609333,14,11,3,14,0,"AL",0.038
"13329",465,"200005.273.1340.1","NMFS",2000,10,8,282,30,43.859,-66.809833,0,0,0,0,0,"AL",0.038
"13330",511,"200005.274.1340.5","NMFS",2000,10,9,283,30,43.939667,-66.905333,1,1,0,1,0,"AL",0.038
"13331",465,"200005.275.1340.2","NMFS",2000,10,9,283,30,43.98,-66.778833,0,0,0,0,0,"AL",0.038
"13332",466,"200005.276.1330.3","NMFS",2000,10,9,283,21,44.0925,-66.503333,11,7,4,11,0,"AL",0.038
"13333",466,"200005.277.1351.1","NMFS",2000,10,9,283,30,44.122,-66.765833,1,1,0,1,0,"AL",0.038
"13334",511,"200005.278.1351.2","NMFS",2000,10,9,283,30,44.108,-66.844667,6,6,0,6,0,"AL",0.038
"13335",511,"200005.279.1340.6","NMFS",2000,10,9,283,30,44.091667,-67.253,0,0,0,0,0,"AL",0.038
"13336",511,"200005.280.1340.3","NMFS",2000,10,9,283,30,43.930833,-67.335,1,1,0,1,0,"AL",0.038
"13337",465,"200005.281.1360.6","NMFS",2000,10,9,283,30,43.594333,-67.614,0,0,0,0,0,"AL",0.038
"13338",512,"200005.282.1360.1","NMFS",2000,10,10,284,30,43.691333,-67.768333,0,0,0,0,0,"AL",0.038
"13339",511,"200005.283.1380.5","NMFS",2000,10,10,284,30,44.131167,-67.781333,1,1,0,1,0,"AL",0.038
"13340",511,"200005.284.1390.3","NMFS",2000,10,10,284,30,44.181833,-67.824167,0,0,0,0,0,"AL",0.038
"13341",511,"200005.285.1390.2","NMFS",2000,10,10,284,30,44.274667,-67.8205,13,10,3,10,3,"AL",0.038
"13342",512,"200005.286.1390.4","NMFS",2000,10,10,284,30,44.254667,-67.894333,74,46,28,56,18,"AL",0.038
"13343",512,"200005.287.1390.5","NMFS",2000,10,10,284,30,44.158667,-68.083833,29,20,9,29,0,"AL",0.038
"13344",512,"200005.289.1390.6","NMFS",2000,10,10,284,23,43.761167,-68.896,92,48,44,61,31,"AL",0.038
"13345",512,"200005.290.1380.2","NMFS",2000,10,11,285,30,43.544833,-68.886333,0,0,0,0,0,"AL",0.038
"13346",513,"200005.291.1380.4","NMFS",2000,10,11,285,30,43.556833,-69.156333,0,0,0,0,0,"AL",0.038
"13347",513,"200005.292.1400.1","NMFS",2000,10,11,285,30,43.791667,-69.372667,61,23,38,54,7,"AL",0.038
"13348",514,"200005.293.3650.2","NMFS",2000,10,12,286,30,42.824833,-70.742167,25,11,14,22,3,"AL",0.038
"13349",514,"200005.294.3660.2","NMFS",2000,10,12,286,30,42.4805,-70.68,34,13,21,32,2,"AL",0.038
"13350",514,"200005.295.3640.1","NMFS",2000,10,12,286,21,42.451,-70.843833,129,78,51,109,20,"AL",0.038
"13351",514,"200005.296.3650.1","NMFS",2000,10,12,286,30,42.437167,-70.812333,51,28,23,49,2,"AL",0.038
"13352",514,"200005.297.3660.1","NMFS",2000,10,12,286,30,42.321833,-70.646833,35,15,20,34,1,"AL",0.038
"13353",514,"200005.298.1260.1","NMFS",2000,10,12,286,30,42.232833,-70.3575,4,2,2,4,0,"AL",0.038
"13354",514,"200005.299.3610.1","NMFS",2000,10,12,286,30,42.043667,-70.330167,108,52,56,107,1,"AL",0.038
"13355",514,"200005.300.3600.2","NMFS",2000,10,12,286,30,41.9795,-70.459667,64,33,31,50,14,"AL",0.038
"13356",521,"200005.301.1280.5","NMFS",2000,10,17,291,30,41.980667,-69.451667,0,0,0,0,0,"AL",0.038
"13357",521,"200005.304.1230.5","NMFS",2000,10,17,291,30,41.974167,-69.8755,0,0,0,0,0,"AL",0.038
"13358",514,"200005.305.3610.2","NMFS",2000,10,17,291,30,42.136667,-70.081167,5,4,1,5,0,"AL",0.038
"13359",514,"200005.306.3600.1","NMFS",2000,10,17,291,30,41.8945,-70.363167,86,38,48,74,12,"AL",0.038
"13360",514,"200005.307.3580.1","NMFS",2000,10,17,291,30,41.7725,-70.1865,7,6,1,5,2,"AL",0.038
"13361",514,"200005.308.3590.1","NMFS",2000,10,17,291,30,41.818167,-70.3725,33,17,16,25,8,"AL",0.038
"13362",521,"200005.309.1280.7","NMFS",2000,10,18,292,30,42.271833,-69.810333,0,0,0,0,0,"AL",0.038
"13363",521,"200005.310.1280.1","NMFS",2000,10,18,292,30,42.282667,-69.543667,0,0,0,0,0,"AL",0.038
"13364",521,"200005.311.1280.3","NMFS",2000,10,18,292,30,42.325,-69.478167,0,0,0,0,0,"AL",0.038
"13365",515,"200005.312.1370.5","NMFS",2000,10,18,292,30,42.618,-68.787,0,0,0,0,0,"AL",0.038
"13366",515,"200005.313.1280.2","NMFS",2000,10,18,292,30,42.528167,-68.654667,0,0,0,0,0,"AL",0.038
"13367",515,"200005.314.1290.6","NMFS",2000,10,18,292,30,42.682833,-68.417333,0,0,0,0,0,"AL",0.038
"13368",515,"200005.315.1290.4","NMFS",2000,10,18,292,30,42.612167,-68.286333,0,0,0,0,0,"AL",0.038
"13369",515,"200005.316.1360.4","NMFS",2000,10,18,292,30,42.793,-68.134167,0,0,0,0,0,"AL",0.038
"13370",515,"200005.317.1360.7","NMFS",2000,10,18,292,30,42.976833,-68.125,1,1,0,1,0,"AL",0.038
"13371",515,"200005.318.1360.2","NMFS",2000,10,18,292,30,43.108167,-67.949833,0,0,0,0,0,"AL",0.038
"13372",512,"200005.319.1360.5","NMFS",2000,10,19,293,30,43.358,-68.234333,0,0,0,0,0,"AL",0.038
"13373",512,"200005.320.1380.3","NMFS",2000,10,19,293,30,43.512667,-68.389833,0,0,0,0,0,"AL",0.038
"13374",515,"200005.321.1370.3","NMFS",2000,10,19,293,30,43.192,-68.908167,0,0,0,0,0,"AL",0.038
"13375",515,"200005.322.1370.1","NMFS",2000,10,19,293,30,43.028,-69.033333,0,0,0,0,0,"AL",0.038
"13376",513,"200005.323.1370.4","NMFS",2000,10,19,293,30,42.975833,-69.483,0,0,0,0,0,"AL",0.038
"13377",513,"200005.324.1370.2","NMFS",2000,10,19,293,30,43.214333,-69.655833,0,0,0,0,0,"AL",0.038
"13378",513,"200005.325.1380.1","NMFS",2000,10,19,293,30,43.4675,-69.833667,0,0,0,0,0,"AL",0.038
"13379",513,"200005.326.1400.2","NMFS",2000,10,19,293,28,43.4625,-70.060833,3,3,0,3,0,"AL",0.038
"13380",513,"200005.327.1270.2","NMFS",2000,10,20,294,30,43.3365,-70.069333,0,0,0,0,0,"AL",0.038
"13381",513,"200005.328.1270.3","NMFS",2000,10,20,294,30,43.011333,-70.192333,0,0,0,0,0,"AL",0.038
"13382",514,"200005.329.1400.3","NMFS",2000,10,20,294,30,42.821167,-70.550333,0,0,0,0,0,"AL",0.038
"13383",514,"200005.330.1260.5","NMFS",2000,10,20,294,30,42.6955,-70.319167,0,0,0,0,0,"AL",0.038
"13384",514,"200005.331.1270.1","NMFS",2000,10,20,294,30,42.726167,-70.091,0,0,0,0,0,"AL",0.038
"13385",514,"200005.332.1280.6","NMFS",2000,10,20,294,30,42.808333,-69.877,0,0,0,0,0,"AL",0.038
"13386",514,"200005.333.1280.4","NMFS",2000,10,20,294,30,42.667333,-69.668167,0,0,0,0,0,"AL",0.038
"13387",514,"200005.334.1270.4","NMFS",2000,10,20,294,30,42.533667,-70.014333,0,0,0,0,0,"AL",0.038
"13388",514,"200005.335.1260.4","NMFS",2000,10,20,294,30,42.401833,-70.072333,0,0,0,0,0,"AL",0.038
"13389",514,"200005.336.1260.2","NMFS",2000,10,20,294,30,42.524667,-70.387,12,4,8,12,0,"AL",0.038
"13390",514,"200005.337.1260.3","NMFS",2000,10,21,295,30,42.4905,-70.561667,31,10,21,31,0,"AL",0.038
"13391",526,"200102.161.1090.5","NMFS",2001,4,1,91,30.1,40.72868,-69.781158,0,0,0,0,0,"AL",0.038
"13392",526,"200102.162.1090.4","NMFS",2001,4,1,91,30.2,40.646832,-69.697877,0,0,0,0,0,"AL",0.038
"13393",526,"200102.163.1100.4","NMFS",2001,4,1,91,30.08,40.478467,-69.910522,0,0,0,0,0,"AL",0.038
"13394",526,"200102.167.1110.2","NMFS",2001,4,1,91,30.03,39.966918,-69.65126,9,3,6,8,1,"AL",0.038
"13395",526,"200102.168.1100.5","NMFS",2001,4,1,91,30.07,40.221278,-69.211457,0,0,0,0,0,"AL",0.038
"13396",526,"200102.169.1100.2","NMFS",2001,4,1,91,30.03,40.26265,-69.279,0,0,0,0,0,"AL",0.038
"13397",526,"200102.170.1100.6","NMFS",2001,4,2,92,30,40.474267,-69.413345,1,0,1,0,1,"AL",0.038
"13398",526,"200102.171.1100.8","NMFS",2001,4,2,92,30.02,40.29496,-69.164748,0,0,0,0,0,"AL",0.038
"13399",526,"200102.172.1110.1","NMFS",2001,4,2,92,29.88,40.191348,-68.851647,0,0,0,0,0,"AL",0.038
"13400",525,"200102.173.1140.1","NMFS",2001,4,2,92,29.95,40.256027,-68.652573,0,0,0,0,0,"AL",0.038
"13401",525,"200102.174.1130.2","NMFS",2001,4,2,92,30,40.34737,-68.667152,0,0,0,0,0,"AL",0.038
"13402",525,"200102.175.1130.5","NMFS",2001,4,2,92,29.98,40.443958,-68.541465,0,0,0,0,0,"AL",0.038
"13403",525,"200102.176.1130.8","NMFS",2001,4,2,92,30.05,40.555627,-68.419235,0,0,0,0,0,"AL",0.038
"13404",525,"200102.177.1140.3","NMFS",2001,4,2,92,29.9,40.358005,-68.370667,0,0,0,0,0,"AL",0.038
"13405",525,"200102.178.1130.9","NMFS",2001,4,3,93,30.13,40.555062,-68.109558,0,0,0,0,0,"AL",0.038
"13406",525,"200102.180.1150.2","NMFS",2001,4,3,93,30.02,40.353778,-67.829705,0,0,0,0,0,"AL",0.038
"13407",525,"200102.181.1140.2","NMFS",2001,4,3,93,30.05,40.479737,-67.552452,0,0,0,0,0,"AL",0.038
"13408",525,"200102.182.1130.1","NMFS",2001,4,3,93,30.03,40.938388,-67.745208,0,0,0,0,0,"AL",0.038
"13409",525,"200102.183.1130.6","NMFS",2001,4,3,93,30.07,41.044697,-67.539573,0,0,0,0,0,"AL",0.038
"13410",525,"200102.184.1130.4","NMFS",2001,4,3,93,30.07,40.93782,-67.415633,0,0,0,0,0,"AL",0.038
"13411",525,"200102.185.1130.7","NMFS",2001,4,3,93,29.97,40.893883,-67.286633,0,0,0,0,0,"AL",0.038
"13412",525,"200102.186.1130.3","NMFS",2001,4,3,93,30.02,40.779442,-66.939948,0,0,0,0,0,"AL",0.038
"13413",562,"200102.187.1160.6","NMFS",2001,4,4,94,30.08,40.930382,-66.845345,0,0,0,0,0,"AL",0.038
"13414",562,"200102.188.1160.3","NMFS",2001,4,4,94,29.87,41.098328,-66.67295,0,0,0,0,0,"AL",0.038
"13415",562,"200102.189.1160.1","NMFS",2001,4,4,94,30.07,41.270595,-66.987427,0,0,0,0,0,"AL",0.038
"13416",562,"200102.190.1190.2","NMFS",2001,4,4,94,30.22,41.385437,-67.151398,0,0,0,0,0,"AL",0.038
"13417",562,"200102.191.1160.10","NMFS",2001,4,4,94,29.97,41.349403,-66.856323,0,0,0,0,0,"AL",0.038
"13418",562,"200102.192.1160.5","NMFS",2001,4,4,94,30,41.220932,-66.407363,0,0,0,0,0,"AL",0.038
"13419",552,"200102.193.1170.2","NMFS",2001,4,4,94,30.08,41.427643,-66.141067,0,0,0,0,0,"AL",0.038
"13420",552,"200102.194.1160.9","NMFS",2001,4,4,94,30.1,41.600613,-66.449958,0,0,0,0,0,"AL",0.038
"13421",552,"200102.195.1160.8","NMFS",2001,4,4,94,29.97,41.566123,-66.234313,0,0,0,0,0,"AL",0.038
"13422",552,"200102.196.1170.1","NMFS",2001,4,4,94,29.93,41.550655,-66.018753,0,0,0,0,0,"AL",0.038
"13423",552,"200102.197.1160.2","NMFS",2001,4,5,95,30.08,41.654445,-65.944923,0,0,0,0,0,"AL",0.038
"13424",552,"200102.198.1170.3","NMFS",2001,4,5,95,30.03,41.655732,-65.90252,2,2,0,2,0,"AL",0.038
"13425",551,"200102.199.1180.1","NMFS",2001,4,5,95,30.17,41.839962,-65.727105,0,0,0,0,0,"AL",0.038
"13426",464,"200102.200.1290.5","NMFS",2001,4,5,95,30,42.0695,-65.678167,2,2,0,2,0,"AL",0.038
"13427",551,"200102.201.1290.4","NMFS",2001,4,5,95,30,42.293,-66.202323,1,1,0,1,0,"AL",0.038
"13428",521,"200102.202.1250.3","NMFS",2001,4,10,100,29.97,41.687817,-69.775117,11,7,4,11,0,"AL",0.038
"13429",521,"200102.203.1230.2","NMFS",2001,4,10,100,30.08,41.56744,-69.381133,0,0,0,0,0,"AL",0.038
"13430",521,"200102.204.1250.4","NMFS",2001,4,10,100,30.03,41.407097,-69.393318,0,0,0,0,0,"AL",0.038
"13431",521,"200102.205.1250.2","NMFS",2001,4,10,100,30.05,41.417995,-69.479095,6,3,3,5,1,"AL",0.038
"13432",521,"200102.206.3550.5","NMFS",2001,4,10,100,29.97,41.328975,-69.578567,0,0,0,0,0,"AL",0.038
"13433",521,"200102.207.3550.4","NMFS",2001,4,10,100,30.08,41.302285,-69.545738,0,0,0,0,0,"AL",0.038
"13434",526,"200102.208.3550.3","NMFS",2001,4,10,100,30.02,41.157025,-69.57206,0,0,0,0,0,"AL",0.038
"13435",526,"200102.209.3550.1","NMFS",2001,4,10,100,30.05,41.062958,-69.631172,0,0,0,0,0,"AL",0.038
"13436",521,"200102.210.3550.2","NMFS",2001,4,10,100,29.98,41.08247,-69.495782,0,0,0,0,0,"AL",0.038
"13437",521,"200102.211.1230.5","NMFS",2001,4,10,100,29.97,41.238102,-69.274682,1,0,1,1,0,"AL",0.038
"13438",521,"200102.212.1230.4","NMFS",2001,4,11,101,30.02,41.234345,-69.120368,0,0,0,0,0,"AL",0.038
"13439",521,"200102.213.1240.4","NMFS",2001,4,11,101,30.02,41.396518,-68.97303,0,0,0,0,0,"AL",0.038
"13440",521,"200102.215.1230.6","NMFS",2001,4,11,101,27.77,41.027358,-68.861588,0,0,0,0,0,"AL",0.038
"13441",526,"200102.216.1100.7","NMFS",2001,4,11,101,30,40.745917,-69.042083,0,0,0,0,0,"AL",0.038
"13442",525,"200102.217.1190.1","NMFS",2001,4,11,101,30.02,40.775967,-68.582367,0,0,0,0,0,"AL",0.038
"13443",525,"200102.218.1190.6","NMFS",2001,4,11,101,30.07,40.749187,-68.490997,0,0,0,0,0,"AL",0.038
"13444",525,"200102.219.1190.7","NMFS",2001,4,11,101,30.12,40.89016,-68.319947,0,0,0,0,0,"AL",0.038
"13445",522,"200102.220.1190.9","NMFS",2001,4,11,101,29.88,41.151482,-68.43489,1,1,0,0,1,"AL",0.038
"13446",522,"200102.221.1200.2","NMFS",2001,4,11,101,30.02,41.457813,-68.272102,0,0,0,0,0,"AL",0.038
"13447",522,"200102.222.1230.1","NMFS",2001,4,12,102,30.05,41.475972,-68.557007,0,0,0,0,0,"AL",0.038
"13448",522,"200102.223.1240.1","NMFS",2001,4,12,102,30,41.55833,-68.769935,0,0,0,0,0,"AL",0.038
"13449",522,"200102.224.1240.6","NMFS",2001,4,12,102,30.07,41.737587,-68.738907,0,0,0,0,0,"AL",0.038
"13450",522,"200102.225.1240.3","NMFS",2001,4,12,102,30.05,41.899633,-68.485917,1,1,0,1,0,"AL",0.038
"13451",522,"200102.226.1240.5","NMFS",2001,4,12,102,30.02,42.060813,-68.624702,0,0,0,0,0,"AL",0.038
"13452",522,"200102.227.1290.8","NMFS",2001,4,12,102,30.07,42.26551,-68.139175,0,0,0,0,0,"AL",0.038
"13453",522,"200102.228.1220.4","NMFS",2001,4,12,102,30.03,42.019662,-68.046677,7,6,1,7,0,"AL",0.038
"13454",522,"200102.229.1210.4","NMFS",2001,4,12,102,29.93,41.85989,-68.040375,0,0,0,0,0,"AL",0.038
"13455",522,"200102.230.1200.6","NMFS",2001,4,12,102,29.97,41.716038,-68.267387,0,0,0,0,0,"AL",0.038
"13456",522,"200102.231.1200.4","NMFS",2001,4,12,102,30.23,41.722843,-68.100762,30,19,11,30,0,"AL",0.038
"13457",522,"200102.232.1200.5","NMFS",2001,4,13,103,30,41.57275,-68.089408,0,0,0,0,0,"AL",0.038
"13458",522,"200102.233.1190.4","NMFS",2001,4,13,103,29.98,41.52865,-67.729017,0,0,0,0,0,"AL",0.038
"13459",562,"200102.234.1190.8","NMFS",2001,4,13,103,29.95,41.405367,-67.56925,0,0,0,0,0,"AL",0.038
"13460",562,"200102.235.1190.5","NMFS",2001,4,13,103,30.03,41.813728,-67.2482,0,0,0,0,0,"AL",0.038
"13461",561,"200102.236.1190.3","NMFS",2001,4,13,103,29.93,41.855278,-67.096115,1,0,1,1,0,"AL",0.038
"13462",551,"200102.237.1160.7","NMFS",2001,4,13,103,30.02,41.980148,-66.921653,0,0,0,0,0,"AL",0.038
"13463",551,"200102.238.1160.4","NMFS",2001,4,13,103,30.05,41.942577,-66.657295,1,0,1,1,0,"AL",0.038
"13464",551,"200102.239.1210.2","NMFS",2001,4,13,103,30.05,42.140128,-66.535195,0,0,0,0,0,"AL",0.038
"13465",551,"200102.240.1220.1","NMFS",2001,4,13,103,30,42.177658,-66.62326,0,0,0,0,0,"AL",0.038
"13466",551,"200102.241.1300.3","NMFS",2001,4,14,104,30,42.306507,-66.91079,2,1,1,2,0,"AL",0.038
"13467",551,"200102.242.1220.2","NMFS",2001,4,14,104,30.05,42.196367,-67.140167,7,6,1,7,0,"AL",0.038
"13468",561,"200102.243.1210.1","NMFS",2001,4,14,104,30.07,42.11848,-67.285187,7,5,2,7,0,"AL",0.038
"13469",561,"200102.244.1200.3","NMFS",2001,4,14,104,30.12,42.0181,-67.346793,1,0,1,1,0,"AL",0.038
"13470",561,"200102.245.1200.1","NMFS",2001,4,14,104,29.98,41.976883,-67.585197,2,1,1,2,0,"AL",0.038
"13471",522,"200102.246.1220.3","NMFS",2001,4,15,105,29.93,42.09525,-67.68731,10,9,1,10,0,"AL",0.038
"13472",561,"200102.247.1210.3","NMFS",2001,4,15,105,30.03,42.105465,-67.486213,1,1,0,1,0,"AL",0.038
"13473",561,"200102.248.1290.3","NMFS",2001,4,15,105,30.05,42.282508,-67.528267,25,21,4,25,0,"AL",0.038
"13474",561,"200102.249.1290.7","NMFS",2001,4,15,105,30.03,42.258735,-67.342712,4,3,1,4,0,"AL",0.038
"13475",464,"200102.250.1300.2","NMFS",2001,4,15,105,30.07,42.475563,-67.242035,3,3,0,3,0,"AL",0.038
"13476",464,"200102.251.1300.1","NMFS",2001,4,15,105,30.02,42.566742,-67.266998,0,0,0,0,0,"AL",0.038
"13477",464,"200102.252.1290.2","NMFS",2001,4,15,105,30,42.644828,-67.044975,2,1,1,2,0,"AL",0.038
"13478",464,"200102.253.1290.6","NMFS",2001,4,15,105,29.98,42.53355,-66.782982,0,0,0,0,0,"AL",0.038
"13479",464,"200102.254.1360.1","NMFS",2001,4,16,106,30.02,42.903107,-66.818123,0,0,0,0,0,"AL",0.038
"13480",465,"200102.255.1340.6","NMFS",2001,4,16,106,30.07,43.116822,-66.85495,1,1,0,1,0,"AL",0.038
"13481",465,"200102.256.1330.3","NMFS",2001,4,16,106,20.02,43.210903,-66.45626,3,1,2,2,1,"AL",0.038
"13482",465,"200102.257.1330.4","NMFS",2001,4,16,106,30.03,43.430033,-66.275733,6,5,1,6,0,"AL",0.038
"13483",465,"200102.258.1330.1","NMFS",2001,4,16,106,29.02,43.550777,-66.352058,22,10,12,22,0,"AL",0.038
"13484",465,"200102.259.1340.2","NMFS",2001,4,16,106,30.35,43.532982,-66.81263,1,1,0,1,0,"AL",0.038
"13485",465,"200102.260.1360.2","NMFS",2001,4,16,106,29.98,43.52124,-67.114495,0,0,0,0,0,"AL",0.038
"13486",465,"200102.261.1330.2","NMFS",2001,4,17,107,30.03,43.932713,-66.445107,37,25,12,34,3,"AL",0.038
"13487",466,"200102.262.1340.4","NMFS",2001,4,17,107,30.02,44.027225,-66.678748,7,5,2,7,0,"AL",0.038
"13488",511,"200102.263.1340.1","NMFS",2001,4,17,107,30.08,43.952808,-66.952667,1,1,0,1,0,"AL",0.038
"13489",511,"200102.264.1351.2","NMFS",2001,4,17,107,30,44.395035,-67.013252,0,0,0,0,0,"AL",0.038
"13490",511,"200102.265.1351.1","NMFS",2001,4,17,107,30,44.218072,-67.247863,1,1,0,1,0,"AL",0.038
"13491",511,"200102.266.1340.3","NMFS",2001,4,17,107,30.05,44.06242,-67.335495,0,0,0,0,0,"AL",0.038
"13492",521,"200102.267.1240.2","NMFS",2001,4,24,114,29.97,41.822567,-69.413575,0,0,0,0,0,"AL",0.038
"13493",521,"200102.268.1280.1","NMFS",2001,4,24,114,30.03,41.896507,-69.41079,0,0,0,0,0,"AL",0.038
"13494",521,"200102.269.1280.2","NMFS",2001,4,24,114,30.18,42.067167,-69.6795,0,0,0,0,0,"AL",0.038
"13495",521,"200102.270.1270.3","NMFS",2001,4,24,114,30.03,42.11325,-69.774048,7,7,0,7,0,"AL",0.038
"13496",521,"200102.271.1250.1","NMFS",2001,4,24,114,29.9,41.947517,-69.874932,0,0,0,0,0,"AL",0.038
"13497",521,"200102.273.3610.1","NMFS",2001,4,24,114,30.27,42.059487,-69.97789,0,0,0,0,0,"AL",0.038
"13498",514,"200102.275.1260.6","NMFS",2001,4,24,114,29.95,42.247558,-70.068047,6,3,3,6,0,"AL",0.038
"13499",521,"200102.276.1280.7","NMFS",2001,4,25,115,30.42,42.319465,-69.710663,1,1,0,1,0,"AL",0.038
"13500",521,"200102.277.1280.4","NMFS",2001,4,25,115,30.17,42.242665,-69.582032,0,0,0,0,0,"AL",0.038
"13501",515,"200102.278.1280.5","NMFS",2001,4,25,115,30.08,42.479373,-69.44683,0,0,0,0,0,"AL",0.038
"13502",515,"200102.279.1280.3","NMFS",2001,4,25,115,30.08,42.685928,-69.408135,0,0,0,0,0,"AL",0.038
"13503",515,"200102.280.1370.1","NMFS",2001,4,25,115,30.15,42.648323,-69.068313,0,0,0,0,0,"AL",0.038
"13504",515,"200102.281.1280.6","NMFS",2001,4,25,115,30,42.603367,-68.65184,0,0,0,0,0,"AL",0.038
"13505",515,"200102.282.1290.1","NMFS",2001,4,25,115,29.98,42.730198,-68.244622,0,0,0,0,0,"AL",0.038
"13506",515,"200102.283.1360.3","NMFS",2001,4,25,115,30.07,42.85405,-67.882722,2,2,0,2,0,"AL",0.038
"13507",515,"200102.284.1370.2","NMFS",2001,4,25,115,30.2,42.855033,-68.481003,0,0,0,0,0,"AL",0.038
"13508",515,"200102.285.1370.5","NMFS",2001,4,26,116,29.93,42.89706,-69.078095,0,0,0,0,0,"AL",0.038
"13509",513,"200102.286.1370.3","NMFS",2001,4,26,116,30.05,43.230843,-69.212342,0,0,0,0,0,"AL",0.038
"13510",513,"200102.287.1370.4","NMFS",2001,4,26,116,30.03,43.271042,-69.179322,0,0,0,0,0,"AL",0.038
"13511",512,"200102.288.1360.8","NMFS",2001,4,26,116,29.93,43.363033,-68.009475,0,0,0,0,0,"AL",0.038
"13512",512,"200102.289.1360.7","NMFS",2001,4,26,116,30.03,43.479122,-67.880532,0,0,0,0,0,"AL",0.038
"13513",465,"200102.290.1360.4","NMFS",2001,4,26,116,30.03,43.362333,-67.611333,0,0,0,0,0,"AL",0.038
"13514",465,"200102.291.1360.6","NMFS",2001,4,26,116,30.05,43.48264,-67.54551,0,0,0,0,0,"AL",0.038
"13515",465,"200102.292.1360.5","NMFS",2001,4,26,116,29.98,43.77518,-67.543075,0,0,0,0,0,"AL",0.038
"13516",511,"200102.293.1340.5","NMFS",2001,4,26,116,30.03,43.864273,-67.40921,0,0,0,0,0,"AL",0.038
"13517",512,"200102.294.1380.2","NMFS",2001,4,27,117,30.05,43.80772,-68.040825,3,3,0,3,0,"AL",0.038
"13518",511,"200102.295.1380.4","NMFS",2001,4,27,117,30.07,44.066563,-67.818183,2,2,0,2,0,"AL",0.038
"13519",512,"200102.296.1390.2","NMFS",2001,4,27,117,30.12,44.070087,-68.031327,0,0,0,0,0,"AL",0.038
"13520",512,"200102.297.1390.3","NMFS",2001,4,27,117,29.98,43.99879,-68.339553,0,0,0,0,0,"AL",0.038
"13521",512,"200102.298.1380.5","NMFS",2001,4,27,117,30.07,43.832195,-68.328332,4,4,0,4,0,"AL",0.038
"13522",512,"200102.299.1390.1","NMFS",2001,4,27,117,30.12,43.944888,-68.582725,7,3,4,7,0,"AL",0.038
"13523",512,"200102.300.1390.4","NMFS",2001,4,27,117,28.05,43.920265,-68.77903,18,6,12,17,1,"AL",0.038
"13524",513,"200102.301.1380.1","NMFS",2001,4,28,118,30.1,43.589017,-69.037492,2,2,0,2,0,"AL",0.038
"13525",513,"200102.302.1400.2","NMFS",2001,4,28,118,30.07,43.678733,-69.483482,2,1,1,2,0,"AL",0.038
"13526",513,"200102.304.1380.6","NMFS",2001,4,28,118,29.98,43.456013,-69.551682,0,0,0,0,0,"AL",0.038
"13527",513,"200102.305.1400.3","NMFS",2001,4,28,118,30.03,43.439247,-70.09681,11,5,6,11,0,"AL",0.038
"13528",513,"200102.306.1400.1","NMFS",2001,4,28,118,30.05,43.226803,-70.18032,1,1,0,1,0,"AL",0.038
"13529",513,"200102.307.1270.4","NMFS",2001,4,28,118,30.02,43.144387,-70.169845,1,0,1,1,0,"AL",0.038
"13530",513,"200102.308.1270.1","NMFS",2001,4,28,118,30.03,43.014862,-70.29309,0,0,0,0,0,"AL",0.038
"13531",513,"200102.309.1270.2","NMFS",2001,4,29,119,30.08,42.974953,-70.344703,8,6,2,8,0,"AL",0.038
"13532",514,"200102.312.1260.7","NMFS",2001,4,29,119,30.1,42.778145,-70.362823,1,1,0,1,0,"AL",0.038
"13533",513,"200102.313.3640.1","NMFS",2001,4,29,119,30.13,42.85101,-70.76535,4,2,2,4,0,"AL",0.038
"13534",514,"200102.314.3640.2","NMFS",2001,4,29,119,30.3,42.742955,-70.740913,4,3,1,4,0,"AL",0.038
"13535",514,"200102.315.3660.2","NMFS",2001,4,29,119,30.07,42.730453,-70.583535,25,6,19,24,1,"AL",0.038
"13536",514,"200102.316.1260.3","NMFS",2001,4,29,119,30.08,42.481652,-70.434418,2,1,1,2,0,"AL",0.038
"13537",514,"200102.317.3660.1","NMFS",2001,4,29,119,30.03,42.491535,-70.685372,10,8,2,10,0,"AL",0.038
"13538",514,"200102.318.3650.1","NMFS",2001,4,29,119,30.08,42.386037,-70.73764,12,7,5,12,0,"AL",0.038
"13539",514,"200102.319.1260.8","NMFS",2001,4,29,119,29.98,42.342078,-70.611412,17,7,10,17,0,"AL",0.038
"13540",514,"200102.320.1260.1","NMFS",2001,4,29,119,29.93,42.314373,-70.408843,12,2,10,12,0,"AL",0.038
"13541",514,"200102.321.3610.2","NMFS",2001,4,30,120,30.02,42.03511,-70.40519,68,27,41,64,4,"AL",0.038
"13542",514,"200102.322.3600.2","NMFS",2001,4,30,120,30.08,41.992485,-70.459213,23,9,14,20,3,"AL",0.038
"13543",514,"200102.323.3600.1","NMFS",2001,4,30,120,30.03,41.888077,-70.300865,15,5,10,15,0,"AL",0.038
"13544",514,"200102.324.3590.1","NMFS",2001,4,30,120,30,41.812347,-70.31102,12,6,6,8,4,"AL",0.038
"13545",514,"200102.325.3580.1","NMFS",2001,4,30,120,30.28,41.82782,-70.482033,7,4,3,2,5,"AL",0.038
"13546",526,"200109.178.1100.1","NMFS",2001,9,25,268,30.05,40.315117,-69.784167,1,0,1,1,0,"AL",0.038
"13547",526,"200109.179.1100.8","NMFS",2001,9,25,268,30.07,40.561372,-69.880218,0,0,0,0,0,"AL",0.038
"13548",526,"200109.180.1090.4","NMFS",2001,9,25,268,30.02,40.81276,-69.882903,0,0,0,0,0,"AL",0.038
"13549",526,"200109.181.1090.3","NMFS",2001,9,25,268,30.02,40.819207,-69.58921,0,0,0,0,0,"AL",0.038
"13550",526,"200109.182.3550.3","NMFS",2001,9,25,268,29.98,40.982578,-69.575928,2,2,0,2,0,"AL",0.038
"13551",526,"200109.183.1090.5","NMFS",2001,9,25,268,29.83,40.895295,-69.309265,0,0,0,0,0,"AL",0.038
"13552",521,"200109.184.1250.1","NMFS",2001,9,26,269,30.1,41.008987,-69.195373,1,1,0,1,0,"AL",0.038
"13553",526,"200109.185.1100.5","NMFS",2001,9,26,269,30.02,40.805977,-68.92717,0,0,0,0,0,"AL",0.038
"13554",526,"200109.186.1100.4","NMFS",2001,9,26,269,29.98,40.735405,-69.156448,0,0,0,0,0,"AL",0.038
"13555",526,"200109.187.1100.2","NMFS",2001,9,26,269,30.07,40.4001,-68.9118,0,0,0,0,0,"AL",0.038
"13556",526,"200109.188.1100.3","NMFS",2001,9,26,269,30.08,40.267513,-69.048225,0,0,0,0,0,"AL",0.038
"13557",526,"200109.189.1120.1","NMFS",2001,9,26,269,30.07,40.170333,-69.081333,30,12,18,30,0,"AL",0.038
"13558",526,"200109.190.1110.1","NMFS",2001,9,26,269,29.92,40.152367,-68.9734,0,0,0,0,0,"AL",0.038
"13559",525,"200109.191.1130.1","NMFS",2001,9,26,269,30.03,40.271347,-68.718025,0,0,0,0,0,"AL",0.038
"13560",525,"200109.192.1140.2","NMFS",2001,9,26,269,29,40.270562,-68.517028,0,0,0,0,0,"AL",0.038
"13561",525,"200109.193.1150.1","NMFS",2001,9,26,269,30.28,40.434952,-68.145348,3,1,2,2,1,"AL",0.038
"13562",525,"200109.194.1130.2","NMFS",2001,9,27,270,30.23,40.519553,-67.954697,1,1,0,1,0,"AL",0.038
"13563",525,"200109.195.1130.9","NMFS",2001,9,27,270,30,40.552982,-68.323685,0,0,0,0,0,"AL",0.038
"13564",525,"200109.196.1190.8","NMFS",2001,9,27,270,30,40.691448,-68.574127,0,0,0,0,0,"AL",0.038
"13565",525,"200109.197.1190.6","NMFS",2001,9,27,270,30.43,40.944512,-68.49234,1,1,0,1,0,"AL",0.038
"13566",522,"200109.198.1200.4","NMFS",2001,9,27,270,30.05,41.031437,-68.654145,3,2,1,3,0,"AL",0.038
"13567",522,"200109.199.1230.2","NMFS",2001,9,27,270,30.13,41.070042,-68.775733,0,0,0,0,0,"AL",0.038
"13568",521,"200109.200.1230.5","NMFS",2001,9,27,270,24.93,41.066552,-68.93869,0,0,0,0,0,"AL",0.038
"13569",521,"200109.201.1240.6","NMFS",2001,9,27,270,30.02,41.31311,-69.140838,0,0,0,0,0,"AL",0.038
"13570",521,"200109.202.1250.4","NMFS",2001,9,27,270,30.17,41.269058,-69.41568,1,1,0,1,0,"AL",0.038
"13571",521,"200109.203.1250.2","NMFS",2001,9,27,270,29.92,41.399467,-69.383367,0,0,0,0,0,"AL",0.038
"13572",521,"200109.204.1250.3","NMFS",2001,9,27,270,29.97,41.440792,-69.57962,6,5,1,6,0,"AL",0.038
"13573",521,"200109.205.3550.1","NMFS",2001,9,27,270,30.92,41.347145,-69.552368,34,21,13,34,0,"AL",0.038
"13574",521,"200109.206.3550.4","NMFS",2001,9,28,271,30.02,41.524532,-69.714958,2,2,0,2,0,"AL",0.038
"13575",522,"200109.207.1230.4","NMFS",2001,10,2,275,29.9,41.313855,-68.770668,0,0,0,0,0,"AL",0.038
"13576",522,"200109.208.1230.1","NMFS",2001,10,3,276,30,41.325225,-68.542892,3,3,0,3,0,"AL",0.038
"13577",522,"200109.209.1200.1","NMFS",2001,10,3,276,30.08,41.523517,-68.387467,5,2,3,5,0,"AL",0.038
"13578",522,"200109.210.1240.1","NMFS",2001,10,3,276,30.02,41.728607,-68.654518,1,1,0,1,0,"AL",0.038
"13579",521,"200109.211.1240.3","NMFS",2001,10,3,276,30.03,41.894372,-68.882355,0,0,0,0,0,"AL",0.038
"13580",521,"200109.212.1240.2","NMFS",2001,10,3,276,30.13,41.937627,-68.981637,0,0,0,0,0,"AL",0.038
"13581",521,"200109.213.1240.4","NMFS",2001,10,3,276,29.95,42.064705,-68.848747,0,0,0,0,0,"AL",0.038
"13582",522,"200109.214.1240.5","NMFS",2001,10,3,276,30,42.140267,-68.61785,0,0,0,0,0,"AL",0.038
"13583",522,"200109.215.1210.1","NMFS",2001,10,3,276,30.03,41.772018,-68.216858,0,0,0,0,0,"AL",0.038
"13584",522,"200109.216.1210.3","NMFS",2001,10,3,276,30.08,41.848678,-68.005455,16,12,4,16,0,"AL",0.038
"13585",522,"200109.217.1200.6","NMFS",2001,10,3,276,29.98,41.768433,-67.91758,21,13,8,17,4,"AL",0.038
"13586",522,"200109.218.1190.2","NMFS",2001,10,4,277,29.92,41.405655,-67.993233,1,0,1,1,0,"AL",0.038
"13587",525,"200109.219.1190.3","NMFS",2001,10,4,277,30.05,41.099422,-67.949792,0,0,0,0,0,"AL",0.038
"13588",525,"200109.220.1190.7","NMFS",2001,10,4,277,30,41.010582,-68.098862,0,0,0,0,0,"AL",0.038
"13589",525,"200109.221.1130.7","NMFS",2001,10,4,277,30.05,40.806542,-67.882675,0,0,0,0,0,"AL",0.038
"13590",525,"200109.222.1130.4","NMFS",2001,10,4,277,30.07,40.84814,-67.745788,0,0,0,0,0,"AL",0.038
"13591",525,"200109.223.1130.5","NMFS",2001,10,4,277,30.02,40.77171,-67.481377,0,0,0,0,0,"AL",0.038
"13592",525,"200109.224.1140.3","NMFS",2001,10,4,277,30.02,40.570347,-67.277557,0,0,0,0,0,"AL",0.038
"13593",525,"200109.225.1130.6","NMFS",2001,10,4,277,30.03,40.728485,-67.082938,1,1,0,1,0,"AL",0.038
"13594",525,"200109.226.1140.1","NMFS",2001,10,4,277,30.05,40.776047,-66.85199,2,2,0,2,0,"AL",0.038
"13595",562,"200109.227.1990.1","NMFS",2001,10,4,277,30.03,40.760407,-66.710785,0,0,0,0,0,"AL",0.038
"13596",562,"200109.228.1160.5","NMFS",2001,10,5,278,30,40.934632,-66.789245,0,0,0,0,0,"AL",0.038
"13597",525,"200109.229.1130.3","NMFS",2001,10,5,278,30.02,40.884342,-67.382027,0,0,0,0,0,"AL",0.038
"13598",525,"200109.230.1130.8","NMFS",2001,10,5,278,30.08,41.013385,-67.346177,2,2,0,2,0,"AL",0.038
"13599",562,"200109.231.1190.1","NMFS",2001,10,5,278,30.05,41.185067,-67.372552,0,0,0,0,0,"AL",0.038
"13600",562,"200109.232.1190.4","NMFS",2001,10,5,278,30.15,41.604252,-67.420372,9,5,4,9,0,"AL",0.038
"13601",522,"200109.233.1200.2","NMFS",2001,10,5,278,24.75,41.775117,-67.674995,0,0,0,0,0,"AL",0.038
"13602",561,"200109.234.1200.3","NMFS",2001,10,5,278,30.02,41.85646,-67.476265,3,3,0,3,0,"AL",0.038
"13603",522,"200109.235.1200.5","NMFS",2001,10,5,278,30.02,41.9268,-67.708847,3,1,2,3,0,"AL",0.038
"13604",522,"200109.236.1220.3","NMFS",2001,10,5,278,30.13,42.060153,-67.854325,0,0,0,0,0,"AL",0.038
"13605",522,"200109.237.1220.1","NMFS",2001,10,5,278,29.95,42.178932,-67.675225,0,0,0,0,0,"AL",0.038
"13606",561,"200109.238.1210.2","NMFS",2001,10,5,278,30.13,42.065552,-67.528983,3,3,0,3,0,"AL",0.038
"13607",561,"200109.239.1190.5","NMFS",2001,10,6,279,29.92,41.901432,-67.309128,6,5,1,6,0,"AL",0.038
"13608",562,"200109.240.1190.9","NMFS",2001,10,6,279,30.05,41.773152,-67.085122,0,0,0,0,0,"AL",0.038
"13609",562,"200109.241.1160.10","NMFS",2001,10,6,279,30.07,41.805813,-66.878258,5,5,0,5,0,"AL",0.038
"13610",562,"200109.242.1160.9","NMFS",2001,10,6,279,30.1,41.558723,-66.887398,2,2,0,2,0,"AL",0.038
"13611",562,"200109.243.1160.7","NMFS",2001,10,6,279,30.07,41.389802,-67.013428,2,2,0,2,0,"AL",0.038
"13612",562,"200109.244.1160.2","NMFS",2001,10,6,279,29.93,41.268063,-66.936837,5,5,0,5,0,"AL",0.038
"13613",562,"200109.245.1160.4","NMFS",2001,10,6,279,30,41.272495,-66.751068,1,1,0,1,0,"AL",0.038
"13614",552,"200109.246.1170.1","NMFS",2001,10,6,279,29.98,41.401887,-66.165527,7,5,2,7,0,"AL",0.038
"13615",552,"200109.247.1160.1","NMFS",2001,10,6,279,31.77,41.638878,-66.547173,2,2,0,2,0,"AL",0.038
"13616",552,"200109.248.1160.8","NMFS",2001,10,6,279,29.98,41.805085,-66.50695,5,5,0,5,0,"AL",0.038
"13617",551,"200109.249.1160.3","NMFS",2001,10,6,279,30.03,41.841275,-66.327507,0,0,0,0,0,"AL",0.038
"13618",552,"200109.250.1160.6","NMFS",2001,10,7,280,29.93,41.609367,-66.078628,1,1,0,1,0,"AL",0.038
"13619",552,"200109.251.1180.1","NMFS",2001,10,7,280,30.08,41.558093,-65.921692,0,0,0,0,0,"AL",0.038
"13620",552,"200109.253.1170.3","NMFS",2001,10,7,280,29.97,41.658603,-65.908798,1,1,0,1,0,"AL",0.038
"13621",551,"200109.254.1170.2","NMFS",2001,10,7,280,30.18,41.935742,-65.85122,0,0,0,0,0,"AL",0.038
"13622",551,"200109.255.1210.4","NMFS",2001,10,7,280,30.02,42.113068,-66.511437,0,0,0,0,0,"AL",0.038
"13623",551,"200109.256.1220.2","NMFS",2001,10,7,280,30.05,42.182412,-66.597687,1,1,0,1,0,"AL",0.038
"13624",551,"200109.257.1290.8","NMFS",2001,10,7,280,29.98,42.220493,-66.617965,0,0,0,0,0,"AL",0.038
"13625",551,"200109.258.1220.4","NMFS",2001,10,7,280,30.02,42.186168,-66.739517,2,1,1,2,0,"AL",0.038
"13626",551,"200109.259.1300.3","NMFS",2001,10,8,281,29.98,42.32679,-66.757645,0,0,0,0,0,"AL",0.038
"13627",464,"200109.260.1290.2","NMFS",2001,10,8,281,30.07,42.561272,-66.43106,0,0,0,0,0,"AL",0.038
"13628",551,"200109.261.1300.2","NMFS",2001,10,8,281,30.18,42.314797,-67.06829,1,0,1,1,0,"AL",0.038
"13629",551,"200109.262.1290.5","NMFS",2001,10,8,281,30,42.313362,-67.176735,0,0,0,0,0,"AL",0.038
"13630",464,"200109.263.1300.1","NMFS",2001,10,8,281,30.05,42.436588,-67.441543,1,1,0,1,0,"AL",0.038
"13631",515,"200109.264.1290.7","NMFS",2001,10,8,281,29.98,42.771965,-67.728242,0,0,0,0,0,"AL",0.038
"13632",465,"200109.265.1360.4","NMFS",2001,10,9,282,30.13,43.273333,-67.602167,0,0,0,0,0,"AL",0.038
"13633",465,"200109.267.1340.7","NMFS",2001,10,9,282,29.98,43.188935,-66.942025,1,1,0,1,0,"AL",0.038
"13634",465,"200109.268.1340.3","NMFS",2001,10,9,282,30.03,43.200283,-66.850883,0,0,0,0,0,"AL",0.038
"13635",465,"200109.270.1340.4","NMFS",2001,10,9,282,29.98,43.234245,-66.756088,0,0,0,0,0,"AL",0.038
"13636",465,"200109.271.1330.2","NMFS",2001,10,10,283,28.72,43.429645,-66.37941,5,4,1,3,2,"AL",0.038
"13637",465,"200109.272.1330.3","NMFS",2001,10,10,283,30.17,43.877492,-66.611427,8,4,4,8,0,"AL",0.038
"13638",465,"200109.273.1330.1","NMFS",2001,10,10,283,30.13,43.978725,-66.416778,20,14,6,20,0,"AL",0.038
"13639",466,"200109.274.1330.4","NMFS",2001,10,10,283,30,44.017998,-66.544723,4,2,2,4,0,"AL",0.038
"13640",466,"200109.275.1351.1","NMFS",2001,10,10,283,29.97,44.306323,-66.690552,0,0,0,0,0,"AL",0.038
"13641",511,"200109.276.1351.2","NMFS",2001,10,10,283,30.03,44.150315,-67.076172,1,1,0,1,0,"AL",0.038
"13642",511,"200109.277.1340.2","NMFS",2001,10,10,283,30.05,44.108348,-67.179443,0,0,0,0,0,"AL",0.038
"13643",511,"200109.278.1390.5","NMFS",2001,10,10,283,30,44.352715,-67.661087,65,44,21,63,2,"AL",0.038
"13644",512,"200109.279.1390.2","NMFS",2001,10,11,284,9.8,44.05817,-68.140273,3,2,1,3,0,"AL",0.038
"13645",512,"200109.280.1390.6","NMFS",2001,10,11,284,30.07,44.090782,-68.104995,5,3,2,5,0,"AL",0.038
"13646",521,"200109.282.1230.3","NMFS",2001,10,16,289,29.97,41.731412,-69.805207,1,0,1,1,0,"AL",0.038
"13647",521,"200109.284.3610.2","NMFS",2001,10,16,289,30.13,42.025452,-69.981667,4,2,2,4,0,"AL",0.038
"13648",521,"200109.285.1270.4","NMFS",2001,10,16,289,30.07,42.194107,-69.802597,0,0,0,0,0,"AL",0.038
"13649",521,"200109.286.1280.2","NMFS",2001,10,16,289,30.03,42.277095,-69.64434,0,0,0,0,0,"AL",0.038
"13650",515,"200109.287.1280.3","NMFS",2001,10,16,289,30,42.346088,-69.589005,0,0,0,0,0,"AL",0.038
"13651",515,"200109.288.1280.7","NMFS",2001,10,16,289,30.07,42.402343,-69.147445,0,0,0,0,0,"AL",0.038
"13652",515,"200109.289.1280.4","NMFS",2001,10,16,289,30.02,42.529018,-69.179527,0,0,0,0,0,"AL",0.038
"13653",515,"200109.290.1370.2","NMFS",2001,10,17,290,30,42.63325,-68.880933,0,0,0,0,0,"AL",0.038
"13654",515,"200109.291.1370.1","NMFS",2001,10,17,290,30,42.85117,-68.657318,0,0,0,0,0,"AL",0.038
"13655",515,"200109.292.1370.4","NMFS",2001,10,17,290,30.03,42.939155,-68.874832,0,0,0,0,0,"AL",0.038
"13656",515,"200109.293.1370.3","NMFS",2001,10,17,290,30.15,42.98436,-68.948128,0,0,0,0,0,"AL",0.038
"13657",515,"200109.294.1370.5","NMFS",2001,10,17,290,30.07,42.977055,-69.321397,0,0,0,0,0,"AL",0.038
"13658",513,"200109.295.1280.6","NMFS",2001,10,17,290,30.08,42.976192,-69.768013,1,1,0,1,0,"AL",0.038
"13659",513,"200109.296.1270.2","NMFS",2001,10,17,290,25.8,42.970245,-70.319068,0,0,0,0,0,"AL",0.038
"13660",514,"200109.297.1260.4","NMFS",2001,10,17,290,29.82,42.767738,-70.493432,7,4,3,7,0,"AL",0.038
"13661",514,"200109.298.3650.1","NMFS",2001,10,18,291,30.05,42.735847,-70.659828,37,23,14,34,3,"AL",0.038
"13662",514,"200109.299.3640.1","NMFS",2001,10,18,291,30.07,42.695572,-70.698502,23,15,8,16,7,"AL",0.038
"13663",514,"200109.300.3650.3","NMFS",2001,10,18,291,30.12,42.642105,-70.546852,173,106,67,119,54,"AL",0.038
"13664",514,"200109.301.3660.1","NMFS",2001,10,18,291,30.02,42.476307,-70.736533,10,1,9,9,1,"AL",0.038
"13665",514,"200109.303.3660.2","NMFS",2001,10,18,291,30.1,42.22871,-70.542023,1,0,1,1,0,"AL",0.038
"13666",514,"200109.304.3600.1","NMFS",2001,10,18,291,30.05,42.111962,-70.542275,13,7,6,12,1,"AL",0.038
"13667",514,"200109.305.3590.1","NMFS",2001,10,18,291,30.07,41.840065,-70.377525,18,6,12,14,4,"AL",0.038
"13668",514,"200109.306.3580.1","NMFS",2001,10,18,291,30.13,41.832203,-70.221893,41,21,20,38,3,"AL",0.038
"13669",514,"200109.307.3600.2","NMFS",2001,10,19,292,30.08,41.978508,-70.149552,5,4,1,5,0,"AL",0.038
"13670",514,"200109.308.3610.1","NMFS",2001,10,19,292,30.07,42.007512,-70.283905,12,6,6,12,0,"AL",0.038
"13671",514,"200109.309.1260.1","NMFS",2001,10,19,292,29.98,42.265693,-70.407837,2,0,2,2,0,"AL",0.038
"13672",514,"200109.310.1260.2","NMFS",2001,10,19,292,30,42.31432,-70.068542,1,1,0,1,0,"AL",0.038
"13673",514,"200109.311.1260.5","NMFS",2001,10,19,292,30.15,42.400288,-70.076432,0,0,0,0,0,"AL",0.038
"13674",514,"200109.312.1270.3","NMFS",2001,10,19,292,30.28,42.614102,-69.961655,1,1,0,1,0,"AL",0.038
"13675",514,"200109.313.1260.3","NMFS",2001,10,19,292,30.08,42.6478,-70.14856,0,0,0,0,0,"AL",0.038
"13676",514,"200109.314.1270.1","NMFS",2001,10,19,292,30.03,42.747948,-70.000175,0,0,0,0,0,"AL",0.038
"13677",514,"200109.315.1280.1","NMFS",2001,10,19,292,29.95,42.821433,-69.704972,0,0,0,0,0,"AL",0.038
"13678",515,"200109.316.1280.5","NMFS",2001,10,19,292,29.95,42.768238,-69.569672,0,0,0,0,0,"AL",0.038
"13679",515,"200109.317.1290.4","NMFS",2001,10,20,293,30.25,42.520412,-68.226333,0,0,0,0,0,"AL",0.038
"13680",522,"200109.318.1290.6","NMFS",2001,10,20,293,29.98,42.325425,-67.975792,1,1,0,1,0,"AL",0.038
"13681",515,"200109.319.1290.3","NMFS",2001,10,20,293,30.02,42.555527,-67.805908,0,0,0,0,0,"AL",0.038
"13682",515,"200109.320.1290.1","NMFS",2001,10,20,293,30.08,42.641087,-67.814255,0,0,0,0,0,"AL",0.038
"13683",515,"200109.321.1360.3","NMFS",2001,10,20,293,30.12,42.855607,-67.887817,0,0,0,0,0,"AL",0.038
"13684",515,"200109.322.1360.1","NMFS",2001,10,20,293,30.1,42.781178,-68.188918,0,0,0,0,0,"AL",0.038
"13685",515,"200109.323.1360.5","NMFS",2001,10,20,293,30.07,42.937503,-68.215187,0,0,0,0,0,"AL",0.038
"13686",512,"200109.324.1360.6","NMFS",2001,10,20,293,30.1,43.72744,-67.817123,0,0,0,0,0,"AL",0.038
"13687",465,"200109.325.1360.2","NMFS",2001,10,21,294,30.05,43.656845,-67.44545,0,0,0,0,0,"AL",0.038
"13688",465,"200109.326.1360.7","NMFS",2001,10,21,294,30.12,43.700923,-67.425057,2,1,1,2,0,"AL",0.038
"13689",465,"200109.327.1340.6","NMFS",2001,10,21,294,30.07,43.816638,-67.29541,0,0,0,0,0,"AL",0.038
"13690",511,"200109.328.1360.8","NMFS",2001,10,21,294,30.03,43.950088,-67.578217,0,0,0,0,0,"AL",0.038
"13691",511,"200109.329.1380.1","NMFS",2001,10,21,294,29.98,44.094982,-67.737527,0,0,0,0,0,"AL",0.038
"13692",512,"200109.330.1380.4","NMFS",2001,10,21,294,30.07,43.89603,-68.047967,0,0,0,0,0,"AL",0.038
"13693",512,"200109.331.1390.4","NMFS",2001,10,21,294,33.63,44.024662,-68.344597,30,18,12,25,5,"AL",0.038
"13694",512,"200109.332.1390.3","NMFS",2001,10,21,294,30.15,43.962857,-68.563568,40,30,10,40,0,"AL",0.038
"13695",512,"200109.333.1390.1","NMFS",2001,10,21,294,30.12,43.78878,-68.68061,4,1,3,4,0,"AL",0.038
"13696",512,"200109.334.1380.5","NMFS",2001,10,21,294,30.07,43.660358,-68.70771,0,0,0,0,0,"AL",0.038
"13697",512,"200109.335.1380.2","NMFS",2001,10,22,295,30.13,43.550362,-68.699272,0,0,0,0,0,"AL",0.038
"13698",512,"200109.336.1380.3","NMFS",2001,10,22,295,29.98,43.481365,-68.80423,0,0,0,0,0,"AL",0.038
"13699",512,"200109.337.1400.2","NMFS",2001,10,22,295,29.95,43.77303,-69.221947,52,24,28,46,6,"AL",0.038
"13700",513,"200109.338.1400.3","NMFS",2001,10,22,295,20.15,43.666553,-69.576553,13,5,8,10,3,"AL",0.038
"13701",513,"200109.339.1400.1","NMFS",2001,10,22,295,30,43.576067,-69.685783,0,0,0,0,0,"AL",0.038
"13702",514,"200202.167.3580.1","NMFS",2002,4,4,94,30.02,41.767333,-70.399333,1,0,1,0,1,"AL",0.038
"13703",514,"200202.168.3600.1","NMFS",2002,4,4,94,30.12,41.895333,-70.439167,68,33,35,39,29,"AL",0.038
"13704",514,"200202.169.3610.1","NMFS",2002,4,4,94,27.93,42.027833,-70.222167,3,0,3,2,1,"AL",0.038
"13705",514,"200202.170.1260.3","NMFS",2002,4,4,94,30.02,42.184833,-70.274833,0,0,0,0,0,"AL",0.038
"13706",514,"200202.171.1260.2","NMFS",2002,4,4,94,30.08,42.1905,-70.098833,0,0,0,0,0,"AL",0.038
"13707",521,"200202.172.1250.1","NMFS",2002,4,4,94,30.05,41.840167,-69.871333,0,0,0,0,0,"AL",0.038
"13708",521,"200202.173.1250.3","NMFS",2002,4,4,94,30.12,41.535333,-69.657667,1,1,0,1,0,"AL",0.038
"13709",521,"200202.174.1250.4","NMFS",2002,4,4,94,29.98,41.2745,-69.378833,1,1,0,1,0,"AL",0.038
"13710",521,"200202.175.1250.2","NMFS",2002,4,4,94,29.98,41.033,-69.212333,0,0,0,0,0,"AL",0.038
"13711",521,"200202.176.3550.1","NMFS",2002,4,4,94,30.95,41.060333,-69.482167,0,0,0,0,0,"AL",0.038
"13712",526,"200202.177.3550.5","NMFS",2002,4,5,95,30.1,41.0115,-69.752167,0,0,0,0,0,"AL",0.038
"13713",526,"200202.179.1100.4","NMFS",2002,4,5,95,29.93,40.555333,-69.72,0,0,0,0,0,"AL",0.038
"13714",526,"200202.180.1100.7","NMFS",2002,4,5,95,30.13,40.264167,-69.977333,0,0,0,0,0,"AL",0.038
"13715",526,"200202.181.1110.2","NMFS",2002,4,5,95,30.03,39.985,-69.680167,0,0,0,0,0,"AL",0.038
"13716",526,"200202.182.1110.1","NMFS",2002,4,5,95,30.02,39.968333,-69.448833,0,0,0,0,0,"AL",0.038
"13717",526,"200202.183.1100.1","NMFS",2002,4,5,95,30.03,40.225,-69.1915,0,0,0,0,0,"AL",0.038
"13718",525,"200202.184.1150.1","NMFS",2002,4,5,95,30.12,40.1115,-68.551333,7,6,1,7,0,"AL",0.038
"13719",525,"200202.185.1140.3","NMFS",2002,4,6,96,30.02,40.233833,-68.638833,0,0,0,0,0,"AL",0.038
"13720",525,"200202.186.1130.4","NMFS",2002,4,6,96,30.05,40.310167,-68.766167,0,0,0,0,0,"AL",0.038
"13721",525,"200202.187.1140.2","NMFS",2002,4,6,96,29.92,40.3495,-68.3385,0,0,0,0,0,"AL",0.038
"13722",525,"200202.188.1130.1","NMFS",2002,4,6,96,30.05,40.443333,-68.517833,0,0,0,0,0,"AL",0.038
"13723",526,"200202.189.1100.5","NMFS",2002,4,6,96,30.02,40.56,-68.9685,0,0,0,0,0,"AL",0.038
"13724",526,"200202.190.1090.2","NMFS",2002,4,6,96,29.97,40.643833,-69.376667,0,0,0,0,0,"AL",0.038
"13725",526,"200202.191.1090.4","NMFS",2002,4,6,96,30.05,40.690833,-69.373167,0,0,0,0,0,"AL",0.038
"13726",526,"200202.192.1100.8","NMFS",2002,4,6,96,29.73,40.7295,-69.053833,3,1,2,3,0,"AL",0.038
"13727",525,"200202.193.1130.2","NMFS",2002,4,6,96,29.98,40.767667,-68.714333,1,0,1,1,0,"AL",0.038
"13728",525,"200202.194.1190.8","NMFS",2002,4,6,96,30.03,40.911,-68.547667,2,1,1,2,0,"AL",0.038
"13729",522,"200202.195.1190.1","NMFS",2002,4,7,97,30.02,41.033333,-68.582167,0,0,0,0,0,"AL",0.038
"13730",522,"200202.196.1200.2","NMFS",2002,4,7,97,30.13,41.224167,-68.47,0,0,0,0,0,"AL",0.038
"13731",522,"200202.197.1230.3","NMFS",2002,4,7,97,30.05,41.314667,-68.524833,2,0,2,2,0,"AL",0.038
"13732",521,"200202.198.1230.5","NMFS",2002,4,7,97,30.03,41.348167,-69.245833,0,0,0,0,0,"AL",0.038
"13733",521,"200202.199.1230.4","NMFS",2002,4,7,97,30.02,41.268167,-69.2075,0,0,0,0,0,"AL",0.038
"13734",521,"200202.200.1230.2","NMFS",2002,4,7,97,30.03,41.066167,-68.942,1,1,0,1,0,"AL",0.038
"13735",522,"200202.201.1230.1","NMFS",2002,4,7,97,30.03,41.099833,-68.809,0,0,0,0,0,"AL",0.038
"13736",525,"200202.202.1130.5","NMFS",2002,4,7,97,30,40.693667,-68.4425,0,0,0,0,0,"AL",0.038
"13737",525,"200202.203.1130.6","NMFS",2002,4,7,97,30.02,40.5265,-67.814,0,0,0,0,0,"AL",0.038
"13738",525,"200202.204.1140.1","NMFS",2002,4,7,97,30.05,40.4845,-67.541333,0,0,0,0,0,"AL",0.038
"13739",525,"200202.205.1130.7","NMFS",2002,4,8,98,30.1,40.647333,-67.321333,0,0,0,0,0,"AL",0.038
"13740",525,"200202.206.1130.8","NMFS",2002,4,8,98,30.05,40.679833,-67.340833,0,0,0,0,0,"AL",0.038
"13741",525,"200202.207.1130.9","NMFS",2002,4,8,98,30.05,40.729833,-67.262,0,0,0,0,0,"AL",0.038
"13742",562,"200202.208.1170.1","NMFS",2002,4,8,98,30.13,40.856333,-66.714667,0,0,0,0,0,"AL",0.038
"13743",562,"200202.210.1160.6","NMFS",2002,4,8,98,30.03,41.015333,-66.7055,0,0,0,0,0,"AL",0.038
"13744",562,"200202.211.1160.4","NMFS",2002,4,8,98,30.02,41.059,-67.081833,0,0,0,0,0,"AL",0.038
"13745",525,"200202.212.1130.3","NMFS",2002,4,8,98,30.15,40.9285,-67.542833,0,0,0,0,0,"AL",0.038
"13746",525,"200202.213.1190.4","NMFS",2002,4,8,98,30.1,41.103333,-67.922833,0,0,0,0,0,"AL",0.038
"13747",522,"200202.214.1190.5","NMFS",2002,4,8,98,30.03,41.375333,-68.002167,0,0,0,0,0,"AL",0.038
"13748",522,"200202.215.1190.9","NMFS",2002,4,9,99,30.1,41.407,-67.861667,0,0,0,0,0,"AL",0.038
"13749",522,"200202.216.1190.2","NMFS",2002,4,9,99,30.12,41.513167,-67.724667,0,0,0,0,0,"AL",0.038
"13750",562,"200202.217.1190.6","NMFS",2002,4,9,99,30.03,41.398,-67.575667,0,0,0,0,0,"AL",0.038
"13751",562,"200202.218.1190.7","NMFS",2002,4,9,99,30,41.422833,-67.366833,0,0,0,0,0,"AL",0.038
"13752",562,"200202.219.1160.8","NMFS",2002,4,9,99,30.38,41.4765,-66.921167,0,0,0,0,0,"AL",0.038
"13753",562,"200202.220.1160.10","NMFS",2002,4,9,99,30.18,41.647333,-66.888333,0,0,0,0,0,"AL",0.038
"13754",562,"200202.221.1160.2","NMFS",2002,4,9,99,30.12,41.735667,-66.882833,0,0,0,0,0,"AL",0.038
"13755",551,"200202.222.1160.9","NMFS",2002,4,9,99,30.05,41.893,-66.704333,0,0,0,0,0,"AL",0.038
"13756",552,"200202.223.1160.7","NMFS",2002,4,9,99,30.05,41.769167,-66.645,0,0,0,0,0,"AL",0.038
"13757",551,"200202.224.1160.3","NMFS",2002,4,9,99,29.98,41.844833,-66.342833,0,0,0,0,0,"AL",0.038
"13758",552,"200202.225.1160.5","NMFS",2002,4,9,99,30.02,41.685,-66.352667,0,0,0,0,0,"AL",0.038
"13759",552,"200202.226.1160.1","NMFS",2002,4,9,99,30.08,41.636667,-66.224667,0,0,0,0,0,"AL",0.038
"13760",552,"200202.227.1170.3","NMFS",2002,4,9,99,30.17,41.688833,-65.8845,1,0,1,1,0,"AL",0.038
"13761",552,"200202.228.1170.2","NMFS",2002,4,10,100,30.15,41.764833,-65.8275,8,8,0,8,0,"AL",0.038
"13762",551,"200202.229.1180.1","NMFS",2002,4,10,100,30.1,41.948667,-65.736,3,3,0,3,0,"AL",0.038
"13763",551,"200202.230.1290.4","NMFS",2002,4,10,100,29.97,42.210167,-66.253333,6,6,0,6,0,"AL",0.038
"13764",551,"200202.231.1220.3","NMFS",2002,4,10,100,30.32,42.1495,-66.313333,0,0,0,0,0,"AL",0.038
"13765",551,"200202.233.1210.3","NMFS",2002,4,10,100,30,42.0955,-66.9725,1,1,0,1,0,"AL",0.038
"13766",561,"200202.234.1190.3","NMFS",2002,4,10,100,29.92,41.940833,-67.1015,4,1,3,4,0,"AL",0.038
"13767",522,"200202.235.1200.4","NMFS",2002,4,10,100,30.03,41.902,-67.7145,0,0,0,0,0,"AL",0.038
"13768",522,"200202.236.1200.3","NMFS",2002,4,11,101,29.98,41.704833,-67.7055,0,0,0,0,0,"AL",0.038
"13769",522,"200202.237.1210.4","NMFS",2002,4,11,101,30.12,41.855667,-67.965667,0,0,0,0,0,"AL",0.038
"13770",522,"200202.238.1200.6","NMFS",2002,4,11,101,29.98,41.771,-68.0675,0,0,0,0,0,"AL",0.038
"13771",522,"200202.239.1200.1","NMFS",2002,4,11,101,30.02,41.597167,-68.061833,2,2,0,2,0,"AL",0.038
"13772",522,"200202.240.1200.5","NMFS",2002,4,11,101,30.28,41.5715,-68.2255,3,2,1,3,0,"AL",0.038
"13773",522,"200202.241.1220.1","NMFS",2002,4,11,101,30.02,41.804167,-68.309833,11,8,3,11,0,"AL",0.038
"13774",522,"200202.242.1240.6","NMFS",2002,4,11,101,29.98,41.769333,-68.5215,3,1,2,3,0,"AL",0.038
"13775",522,"200202.243.1240.2","NMFS",2002,4,11,101,30.08,41.565333,-68.683167,0,0,0,0,0,"AL",0.038
"13776",521,"200202.244.1240.1","NMFS",2002,4,11,101,30,41.706167,-69.1135,0,0,0,0,0,"AL",0.038
"13777",521,"200202.245.1240.5","NMFS",2002,4,11,101,29.97,41.767833,-69.127833,0,0,0,0,0,"AL",0.038
"13778",521,"200202.246.1240.4","NMFS",2002,4,11,101,30.1,41.766667,-69.184167,1,1,0,1,0,"AL",0.038
"13779",521,"200202.247.3550.3","NMFS",2002,4,12,102,26.15,41.631167,-69.8415,1,1,0,1,0,"AL",0.038
"13780",521,"200202.248.3550.4","NMFS",2002,4,12,102,20.05,41.512833,-69.714667,3,1,2,2,1,"AL",0.038
"13781",521,"200202.249.3550.2","NMFS",2002,4,12,102,30.02,41.3845,-69.596333,1,1,0,0,1,"AL",0.038
"13782",521,"200202.250.3560.1","NMFS",2002,4,16,106,30.02,41.890167,-69.936667,0,0,0,0,0,"AL",0.038
"13783",521,"200202.251.1240.3","NMFS",2002,4,16,106,29.9,41.967333,-69.703333,0,0,0,0,0,"AL",0.038
"13784",521,"200202.252.1280.2","NMFS",2002,4,16,106,30.03,42.012833,-69.4725,0,0,0,0,0,"AL",0.038
"13785",521,"200202.253.1280.7","NMFS",2002,4,16,106,30.02,42.176667,-69.656667,0,0,0,0,0,"AL",0.038
"13786",521,"200202.254.1280.3","NMFS",2002,4,16,106,30.18,42.1605,-69.346833,0,0,0,0,0,"AL",0.038
"13787",515,"200202.255.1280.4","NMFS",2002,4,16,106,30.02,42.6105,-69.185667,0,0,0,0,0,"AL",0.038
"13788",515,"200202.256.1370.1","NMFS",2002,4,16,106,30.02,42.682667,-69.180167,0,0,0,0,0,"AL",0.038
"13789",513,"200202.257.1370.2","NMFS",2002,4,17,107,30.2,43.104,-69.279,0,0,0,0,0,"AL",0.038
"13790",513,"200202.258.1370.3","NMFS",2002,4,17,107,30.03,43.22,-69.074167,1,1,0,1,0,"AL",0.038
"13791",515,"200202.259.1370.4","NMFS",2002,4,17,107,29.98,42.980833,-68.874667,5,5,0,5,0,"AL",0.038
"13792",515,"200202.260.1370.5","NMFS",2002,4,17,107,30.08,42.846,-68.8645,0,0,0,0,0,"AL",0.038
"13793",522,"200202.261.1290.2","NMFS",2002,4,17,107,29.98,42.265,-68.3155,1,1,0,1,0,"AL",0.038
"13794",522,"200202.262.1220.2","NMFS",2002,4,17,107,30.03,42.1405,-67.739833,1,1,0,1,0,"AL",0.038
"13795",561,"200202.263.1210.2","NMFS",2002,4,17,107,29.95,42.1,-67.5195,0,0,0,0,0,"AL",0.038
"13796",561,"200202.264.1220.4","NMFS",2002,4,17,107,30.02,42.148,-67.422,3,2,1,3,0,"AL",0.038
"13797",561,"200202.265.1290.1","NMFS",2002,4,17,107,30.17,42.226,-67.3815,1,1,0,1,0,"AL",0.038
"13798",464,"200202.266.1300.3","NMFS",2002,4,18,108,30.12,42.460167,-67.385333,2,2,0,2,0,"AL",0.038
"13799",515,"200202.267.1290.6","NMFS",2002,4,18,108,30.03,42.612833,-67.748833,0,0,0,0,0,"AL",0.038
"13800",515,"200202.268.1290.5","NMFS",2002,4,18,108,30.12,42.647667,-67.686333,0,0,0,0,0,"AL",0.038
"13801",464,"200202.269.1300.1","NMFS",2002,4,18,108,30.03,42.559333,-67.2715,1,1,0,1,0,"AL",0.038
"13802",464,"200202.270.1300.2","NMFS",2002,4,18,108,30,42.363,-66.627333,4,4,0,4,0,"AL",0.038
"13803",464,"200202.271.1290.8","NMFS",2002,4,18,108,29.92,42.600333,-66.599,2,2,0,2,0,"AL",0.038
"13804",464,"200202.272.1290.3","NMFS",2002,4,18,108,30.02,42.480167,-66.374667,1,1,0,1,0,"AL",0.038
"13805",464,"200202.273.1290.7","NMFS",2002,4,18,108,30.05,42.477333,-66.139333,1,1,0,1,0,"AL",0.038
"13806",465,"200202.275.1330.3","NMFS",2002,4,19,109,29.97,43.344,-66.5315,15,5,10,15,0,"AL",0.038
"13807",465,"200202.276.1340.2","NMFS",2002,4,19,109,29.97,43.189333,-67.001833,1,0,1,1,0,"AL",0.038
"13808",515,"200202.277.1360.8","NMFS",2002,4,19,109,30,43.062333,-67.855833,0,0,0,0,0,"AL",0.038
"13809",515,"200202.278.1360.4","NMFS",2002,4,19,109,29.98,43.110833,-68.131667,1,1,0,1,0,"AL",0.038
"13810",512,"200202.279.1360.6","NMFS",2002,4,19,109,30.07,43.521167,-67.7485,0,0,0,0,0,"AL",0.038
"13811",465,"200202.280.1360.3","NMFS",2002,4,20,110,30.07,43.355167,-67.422,3,2,1,3,0,"AL",0.038
"13812",465,"200202.281.1360.1","NMFS",2002,4,20,110,30.07,43.5255,-66.968667,6,2,4,6,0,"AL",0.038
"13813",465,"200202.282.1340.6","NMFS",2002,4,20,110,29.95,43.6125,-66.68,6,5,1,6,0,"AL",0.038
"13814",465,"200202.283.1330.1","NMFS",2002,4,20,110,30.02,43.7435,-66.572667,8,5,3,8,0,"AL",0.038
"13815",465,"200202.284.1340.4","NMFS",2002,4,20,110,30.02,43.823167,-66.818,1,0,1,1,0,"AL",0.038
"13816",511,"200202.285.1340.1","NMFS",2002,4,20,110,30,43.894333,-66.918667,1,1,0,1,0,"AL",0.038
"13817",511,"200202.286.1340.5","NMFS",2002,4,20,110,29.97,43.990167,-66.986,1,1,0,1,0,"AL",0.038
"13818",466,"200202.287.1330.2","NMFS",2002,4,20,110,30.1,44.182667,-66.66,7,4,3,7,0,"AL",0.038
"13819",511,"200202.288.1340.3","NMFS",2002,4,20,110,29.95,44.022667,-67.304167,6,6,0,6,0,"AL",0.038
"13820",511,"200202.289.1351.2","NMFS",2002,4,21,111,30.2,44.187833,-67.211333,3,1,2,3,0,"AL",0.038
"13821",511,"200202.290.1351.1","NMFS",2002,4,21,111,21.98,44.398833,-67.169333,3,3,0,3,0,"AL",0.038
"13822",511,"200202.291.1390.2","NMFS",2002,4,21,111,29.97,44.360667,-67.662333,23,12,11,23,0,"AL",0.038
"13823",511,"200202.292.1380.2","NMFS",2002,4,21,111,30,44.222667,-67.529167,0,0,0,0,0,"AL",0.038
"13824",511,"200202.293.1360.7","NMFS",2002,4,21,111,30,44.184167,-67.3915,1,0,1,1,0,"AL",0.038
"13825",511,"200202.294.1360.2","NMFS",2002,4,21,111,29.97,43.979833,-67.524333,1,1,0,1,0,"AL",0.038
"13826",512,"200202.295.1380.1","NMFS",2002,4,21,111,30.03,43.974333,-67.7455,4,4,0,4,0,"AL",0.038
"13827",512,"200202.296.1360.5","NMFS",2002,4,21,111,30,43.897167,-67.917167,11,10,1,11,0,"AL",0.038
"13828",512,"200202.297.1390.1","NMFS",2002,4,21,111,30.1,44.149667,-67.8915,1,1,0,1,0,"AL",0.038
"13829",512,"200202.298.1390.3","NMFS",2002,4,21,111,30.05,44.186167,-68.031167,9,5,4,8,1,"AL",0.038
"13830",512,"200202.299.1380.4","NMFS",2002,4,22,112,30.17,43.964,-68.223,2,2,0,2,0,"AL",0.038
"13831",512,"200202.300.1380.3","NMFS",2002,4,22,112,30.07,43.9065,-68.2815,5,5,0,5,0,"AL",0.038
"13832",512,"200202.301.1390.5","NMFS",2002,4,22,112,24.1,43.789667,-68.680167,12,9,3,12,0,"AL",0.038
"13833",512,"200202.302.1390.4","NMFS",2002,4,22,112,30.08,43.925167,-68.793333,34,14,20,32,2,"AL",0.038
"13834",512,"200202.303.1380.5","NMFS",2002,4,22,112,29.95,43.479833,-68.509333,2,2,0,2,0,"AL",0.038
"13835",513,"200202.305.1400.2","NMFS",2002,4,22,112,30,43.376167,-70.107833,15,7,8,15,0,"AL",0.038
"13836",513,"200202.306.1400.4","NMFS",2002,4,22,112,30.23,43.363,-70.109,12,8,4,12,0,"AL",0.038
"13837",513,"200202.307.1270.4","NMFS",2002,4,23,113,30.2,43.264167,-70.143,2,1,1,2,0,"AL",0.038
"13838",513,"200202.308.1400.3","NMFS",2002,4,23,113,29.95,43.224833,-70.252167,7,4,3,7,0,"AL",0.038
"13839",513,"200202.309.1400.6","NMFS",2002,4,23,113,29.93,43.194,-70.298833,10,4,6,10,0,"AL",0.038
"13840",514,"200202.310.1280.5","NMFS",2002,4,23,113,29.95,42.811667,-69.8845,1,0,1,1,0,"AL",0.038
"13841",514,"200202.311.1270.1","NMFS",2002,4,23,113,30.18,42.807167,-70.073667,2,2,0,2,0,"AL",0.038
"13842",513,"200202.312.1270.3","NMFS",2002,4,23,113,30.05,43.063,-70.3275,2,1,1,2,0,"AL",0.038
"13843",513,"200202.313.1400.5","NMFS",2002,4,23,113,30.02,43.039833,-70.423,18,8,10,18,0,"AL",0.038
"13844",513,"200202.314.3650.1","NMFS",2002,4,23,113,30,42.855833,-70.708167,13,7,6,11,2,"AL",0.038
"13845",514,"200202.315.3660.2","NMFS",2002,4,23,113,30.07,42.658667,-70.446833,0,0,0,0,0,"AL",0.038
"13846",514,"200202.316.3660.1","NMFS",2002,4,23,113,29.97,42.564333,-70.605833,38,17,21,30,8,"AL",0.038
"13847",514,"200202.317.1260.1","NMFS",2002,4,24,114,30.12,42.562167,-70.139333,0,0,0,0,0,"AL",0.038
"13848",514,"200202.318.1280.6","NMFS",2002,4,24,114,30.07,42.562833,-69.8065,1,1,0,1,0,"AL",0.038
"13849",515,"200202.319.1280.1","NMFS",2002,4,24,114,29.98,42.619833,-69.589167,0,0,0,0,0,"AL",0.038
"13850",521,"200202.320.1270.2","NMFS",2002,4,24,114,30.12,42.268,-69.969,5,4,1,5,0,"AL",0.038
"13851",514,"200202.321.1260.4","NMFS",2002,4,24,114,30.15,42.362,-70.126333,4,4,0,4,0,"AL",0.038
"13852",514,"200202.322.1260.5","NMFS",2002,4,24,114,30.1,42.256833,-70.492167,38,24,14,38,0,"AL",0.038
"13853",514,"200202.324.3630.1","NMFS",2002,4,24,114,20,42.241167,-70.688833,13,5,8,12,1,"AL",0.038
"13854",514,"200202.325.3590.1","NMFS",2002,4,24,114,30.1,42.175667,-70.581,28,18,10,28,0,"AL",0.038
"13855",514,"200202.326.3600.2","NMFS",2002,4,24,114,30.28,42.121333,-70.512667,13,8,5,10,3,"AL",0.038
"13856",514,"200202.327.3610.2","NMFS",2002,4,25,115,30.23,42.056833,-70.460833,11,6,5,11,0,"AL",0.038
"13857",526,"200209.173.1100.4","NMFS",2002,10,3,276,30.02,40.232333,-69.609667,1,1,0,1,0,"AL",0.038
"13858",526,"200209.174.1100.2","NMFS",2002,10,3,276,30.07,40.321667,-69.78,0,0,0,0,0,"AL",0.038
"13859",526,"200209.175.1100.1","NMFS",2002,10,3,276,30.08,40.522167,-69.723167,0,0,0,0,0,"AL",0.038
"13860",526,"200209.176.1100.3","NMFS",2002,10,3,276,29.87,40.479333,-69.4145,0,0,0,0,0,"AL",0.038
"13861",526,"200209.177.1090.2","NMFS",2002,10,3,276,29.95,40.648,-69.7825,0,0,0,0,0,"AL",0.038
"13862",526,"200209.181.3550.3","NMFS",2002,10,4,277,29.9,41.112,-69.604833,1,1,0,1,0,"AL",0.038
"13863",526,"200209.182.3550.5","NMFS",2002,10,4,277,29.95,40.989333,-69.524833,0,0,0,0,0,"AL",0.038
"13864",521,"200209.184.1230.3","NMFS",2002,10,4,277,29.97,41.073,-68.911333,2,1,1,1,1,"AL",0.038
"13865",526,"200209.185.1090.3","NMFS",2002,10,4,277,29.98,40.813333,-69.245833,2,0,2,2,0,"AL",0.038
"13866",526,"200209.186.1100.7","NMFS",2002,10,4,277,30.02,40.738,-69.066167,0,0,0,0,0,"AL",0.038
"13867",526,"200209.187.1100.6","NMFS",2002,10,4,277,30.07,40.672833,-68.947167,0,0,0,0,0,"AL",0.038
"13868",526,"200209.188.1100.8","NMFS",2002,10,4,277,30.02,40.601667,-68.947333,0,0,0,0,0,"AL",0.038
"13869",525,"200209.189.1130.4","NMFS",2002,10,4,277,30.02,40.5195,-68.683667,0,0,0,0,0,"AL",0.038
"13870",526,"200209.190.1110.1","NMFS",2002,10,5,278,30,40.188167,-69.030833,0,0,0,0,0,"AL",0.038
"13871",525,"200209.191.1140.3","NMFS",2002,10,5,278,30.1,40.270667,-68.505,0,0,0,0,0,"AL",0.038
"13872",525,"200209.193.1130.10","NMFS",2002,10,5,278,30.1,40.437167,-68.520333,1,1,0,1,0,"AL",0.038
"13873",525,"200209.194.1140.2","NMFS",2002,10,5,278,29.98,40.356,-68.044333,1,1,0,1,0,"AL",0.038
"13874",525,"200209.195.1140.1","NMFS",2002,10,5,278,29.98,40.444333,-67.598167,1,1,0,1,0,"AL",0.038
"13875",525,"200209.196.1150.1","NMFS",2002,10,5,278,30.07,40.469833,-67.3255,2,1,1,2,0,"AL",0.038
"13876",525,"200209.197.1130.8","NMFS",2002,10,5,278,30.13,40.602667,-67.516333,1,1,0,1,0,"AL",0.038
"13877",525,"200209.198.1130.6","NMFS",2002,10,5,278,30.1,40.813667,-67.5425,0,0,0,0,0,"AL",0.038
"13878",525,"200209.199.1130.2","NMFS",2002,10,6,279,30,40.733333,-67.2095,0,0,0,0,0,"AL",0.038
"13879",525,"200209.200.1130.7","NMFS",2002,10,6,279,29.97,40.779667,-67.210833,1,0,1,1,0,"AL",0.038
"13880",525,"200209.201.1130.3","NMFS",2002,10,6,279,30.07,40.7745,-67.082833,4,3,1,4,0,"AL",0.038
"13881",525,"200209.202.1130.1","NMFS",2002,10,6,279,30.02,40.984,-67.335,4,3,1,4,0,"AL",0.038
"13882",562,"200209.203.1160.8","NMFS",2002,10,6,279,30.12,41.061,-66.751,5,5,0,5,0,"AL",0.038
"13883",562,"200209.204.1160.3","NMFS",2002,10,6,279,30.03,41.062167,-66.4825,3,3,0,3,0,"AL",0.038
"13884",562,"200209.205.1170.1","NMFS",2002,10,6,279,20.6,41.073,-66.440833,4,2,2,4,0,"AL",0.038
"13885",552,"200209.207.1170.4","NMFS",2002,10,6,279,30.05,41.395333,-66.1135,6,5,1,6,0,"AL",0.038
"13886",552,"200209.208.1160.7","NMFS",2002,10,6,279,30.2,41.515667,-66.109,2,2,0,2,0,"AL",0.038
"13887",552,"200209.209.1160.10","NMFS",2002,10,6,279,30,41.604833,-66.526,7,6,1,7,0,"AL",0.038
"13888",552,"200209.210.1160.9","NMFS",2002,10,7,280,29.95,41.771833,-66.0885,0,0,0,0,0,"AL",0.038
"13889",552,"200209.211.1170.2","NMFS",2002,10,7,280,30.07,41.729667,-65.889667,1,1,0,1,0,"AL",0.038
"13890",551,"200209.212.1180.1","NMFS",2002,10,7,280,30.05,41.843333,-65.734333,0,0,0,0,0,"AL",0.038
"13891",551,"200209.213.1160.4","NMFS",2002,10,7,280,30.23,41.9785,-66.044333,0,0,0,0,0,"AL",0.038
"13892",464,"200209.214.1290.2","NMFS",2002,10,7,280,30.2,42.151667,-65.68,0,0,0,0,0,"AL",0.038
"13893",464,"200209.215.1290.8","NMFS",2002,10,7,280,30.02,42.4285,-65.950167,0,0,0,0,0,"AL",0.038
"13894",551,"200209.216.1220.4","NMFS",2002,10,7,280,30.05,42.183,-66.6035,12,7,5,12,0,"AL",0.038
"13895",551,"200209.217.1210.3","NMFS",2002,10,7,280,29.97,42.098333,-66.585,0,0,0,0,0,"AL",0.038
"13896",551,"200209.218.1160.5","NMFS",2002,10,8,281,30,42.027167,-66.478167,3,1,2,3,0,"AL",0.038
"13897",551,"200209.219.1160.2","NMFS",2002,10,8,281,30,41.983333,-66.414333,4,2,2,4,0,"AL",0.038
"13898",551,"200209.220.1160.6","NMFS",2002,10,8,281,30.05,41.905667,-66.868333,4,1,3,4,0,"AL",0.038
"13899",562,"200209.221.1160.1","NMFS",2002,10,8,281,29.98,41.513333,-67.047,0,0,0,0,0,"AL",0.038
"13900",561,"200209.222.1190.9","NMFS",2002,10,8,281,30.02,41.870167,-67.186833,6,5,1,5,1,"AL",0.038
"13901",561,"200209.223.1190.6","NMFS",2002,10,8,281,30,41.948833,-67.245,5,5,0,5,0,"AL",0.038
"13902",561,"200209.224.1200.2","NMFS",2002,10,8,281,29.97,42.061667,-67.241833,2,2,0,2,0,"AL",0.038
"13903",551,"200209.225.1210.4","NMFS",2002,10,8,281,30.02,42.139833,-67.112833,6,6,0,6,0,"AL",0.038
"13904",551,"200209.226.1220.3","NMFS",2002,10,8,281,29.98,42.188667,-67.019333,2,2,0,2,0,"AL",0.038
"13905",561,"200209.227.1220.1","NMFS",2002,10,9,282,30.02,42.179833,-67.381833,1,1,0,1,0,"AL",0.038
"13906",561,"200209.228.1210.1","NMFS",2002,10,9,282,30,42.067833,-67.501833,19,15,4,19,0,"AL",0.038
"13907",522,"200209.229.1220.2","NMFS",2002,10,9,282,30.07,41.988333,-67.9385,0,0,0,0,0,"AL",0.038
"13908",522,"200209.230.1210.2","NMFS",2002,10,9,282,30,41.769667,-68.176333,7,6,1,7,0,"AL",0.038
"13909",522,"200209.231.1200.1","NMFS",2002,10,9,282,30.02,41.727667,-68.205,16,7,9,16,0,"AL",0.038
"13910",522,"200209.232.1200.6","NMFS",2002,10,9,282,29.97,41.727667,-68.152667,43,18,25,43,0,"AL",0.038
"13911",522,"200209.233.1200.4","NMFS",2002,10,9,282,30.02,41.69,-67.942,1,1,0,1,0,"AL",0.038
"13912",522,"200209.234.1200.3","NMFS",2002,10,9,282,30.02,41.626833,-68.075667,0,0,0,0,0,"AL",0.038
"13913",522,"200209.235.1200.5","NMFS",2002,10,9,282,30.02,41.5775,-68.201167,2,1,1,1,1,"AL",0.038
"13914",522,"200209.236.1190.4","NMFS",2002,10,9,282,30.02,41.357833,-67.8455,0,0,0,0,0,"AL",0.038
"13915",525,"200209.237.1190.7","NMFS",2002,10,9,282,29.97,41.219,-67.968333,5,4,1,5,0,"AL",0.038
"13916",525,"200209.238.1190.1","NMFS",2002,10,9,282,30.03,41.268,-68.076,0,0,0,0,0,"AL",0.038
"13917",522,"200209.239.1190.8","NMFS",2002,10,9,282,27.33,41.181833,-68.244333,2,1,1,1,1,"AL",0.038
"13918",525,"200209.240.1190.2","NMFS",2002,10,10,283,28.07,41.039167,-68.23,0,0,0,0,0,"AL",0.038
"13919",525,"200209.241.1130.9","NMFS",2002,10,10,283,30.15,40.908333,-68.152833,0,0,0,0,0,"AL",0.038
"13920",525,"200209.242.1190.3","NMFS",2002,10,10,283,30.07,40.816833,-68.218333,0,0,0,0,0,"AL",0.038
"13921",525,"200209.243.1190.5","NMFS",2002,10,10,283,30.08,41.018833,-68.2985,1,1,0,1,0,"AL",0.038
"13922",522,"200209.244.1230.1","NMFS",2002,10,10,283,29.98,41.185,-68.582,0,0,0,0,0,"AL",0.038
"13923",522,"200209.245.1230.4","NMFS",2002,10,10,283,30.02,41.307667,-68.610833,0,0,0,0,0,"AL",0.038
"13924",521,"200209.246.1230.2","NMFS",2002,10,10,283,30,41.363333,-69.2605,0,0,0,0,0,"AL",0.038
"13925",521,"200209.247.1250.5","NMFS",2002,10,10,283,30.12,41.344667,-69.421333,27,22,5,27,0,"AL",0.038
"13926",521,"200209.248.1250.1","NMFS",2002,10,10,283,30.07,41.441333,-69.4095,3,2,1,3,0,"AL",0.038
"13927",521,"200209.249.1230.5","NMFS",2002,10,10,283,29.52,41.518167,-69.442833,2,0,2,2,0,"AL",0.038
"13928",521,"200209.251.3550.4","NMFS",2002,10,10,283,30.1,41.303667,-69.547,0,0,0,0,0,"AL",0.038
"13929",521,"200209.252.1250.6","NMFS",2002,10,10,283,29.97,41.473333,-69.573667,37,17,20,34,3,"AL",0.038
"13930",521,"200209.253.3550.1","NMFS",2002,10,11,284,29.98,41.272333,-69.671,1,0,1,1,0,"AL",0.038
"13931",521,"200209.254.3550.2","NMFS",2002,10,11,284,29.93,41.198833,-69.673333,0,0,0,0,0,"AL",0.038
"13932",521,"200209.256.1250.7","NMFS",2002,10,16,289,30.02,41.686333,-69.773667,10,9,1,8,2,"AL",0.038
"13933",521,"200209.257.3560.1","NMFS",2002,10,16,289,30.03,41.767,-69.906,4,3,1,3,1,"AL",0.038
"13934",521,"200209.258.1270.4","NMFS",2002,10,16,289,30.03,42.109833,-69.7415,0,0,0,0,0,"AL",0.038
"13935",521,"200209.259.1280.5","NMFS",2002,10,16,289,30,42.11,-69.6325,0,0,0,0,0,"AL",0.038
"13936",521,"200209.260.1280.3","NMFS",2002,10,16,289,30.02,42.189167,-69.647,0,0,0,0,0,"AL",0.038
"13937",514,"200209.261.3610.1","NMFS",2002,10,16,289,30.02,42.061333,-70.2645,14,4,10,14,0,"AL",0.038
"13938",514,"200209.262.3580.1","NMFS",2002,10,17,290,20.05,41.864,-70.1715,1,1,0,1,0,"AL",0.038
"13939",514,"200209.263.3590.1","NMFS",2002,10,17,290,20.15,42.032,-70.566667,50,28,22,43,7,"AL",0.038
"13940",514,"200209.264.3610.2","NMFS",2002,10,17,290,30.08,42.098167,-70.459667,4,2,2,3,1,"AL",0.038
"13941",514,"200209.265.1260.4","NMFS",2002,10,17,290,30.03,42.127167,-70.301167,24,10,14,24,0,"AL",0.038
"13942",521,"200209.266.1280.6","NMFS",2002,10,17,290,29.98,42.310167,-69.911,0,0,0,0,0,"AL",0.038
"13943",521,"200209.267.1240.3","NMFS",2002,10,17,290,30.1,42.064333,-69.077667,0,0,0,0,0,"AL",0.038
"13944",521,"200209.268.1240.2","NMFS",2002,10,18,291,30.08,41.932833,-68.879167,0,0,0,0,0,"AL",0.038
"13945",521,"200209.269.1240.1","NMFS",2002,10,18,291,30,41.596667,-68.901667,0,0,0,0,0,"AL",0.038
"13946",522,"200209.270.1240.4","NMFS",2002,10,18,291,30.05,41.608167,-68.646333,0,0,0,0,0,"AL",0.038
"13947",522,"200209.271.1240.6","NMFS",2002,10,18,291,30.02,41.7835,-68.619833,0,0,0,0,0,"AL",0.038
"13948",522,"200209.272.1240.5","NMFS",2002,10,18,291,30.03,42.274833,-68.659167,0,0,0,0,0,"AL",0.038
"13949",515,"200209.273.1280.4","NMFS",2002,10,18,291,30,42.399167,-68.683333,0,0,0,0,0,"AL",0.038
"13950",515,"200209.274.1370.3","NMFS",2002,10,18,291,29.98,42.774167,-69.007167,0,0,0,0,0,"AL",0.038
"13951",515,"200209.275.1370.1","NMFS",2002,10,18,291,30.02,42.9295,-69.102,0,0,0,0,0,"AL",0.038
"13952",515,"200209.276.1370.5","NMFS",2002,10,18,291,30.03,43.103167,-69.1,0,0,0,0,0,"AL",0.038
"13953",515,"200209.277.1370.4","NMFS",2002,10,18,291,30.07,43.112333,-69.0025,0,0,0,0,0,"AL",0.038
"13954",512,"200209.279.1360.5","NMFS",2002,10,19,292,29.98,43.354333,-68.1065,0,0,0,0,0,"AL",0.038
"13955",515,"200209.280.1360.3","NMFS",2002,10,19,292,29.98,43.1745,-68.081833,0,0,0,0,0,"AL",0.038
"13956",515,"200209.281.1360.6","NMFS",2002,10,19,292,26.17,42.976,-68.262167,0,0,0,0,0,"AL",0.038
"13957",515,"200209.282.1290.7","NMFS",2002,10,19,292,30.08,42.611833,-68.043667,0,0,0,0,0,"AL",0.038
"13958",464,"200209.283.1360.8","NMFS",2002,10,19,292,30,42.995,-67.492833,0,0,0,0,0,"AL",0.038
"13959",464,"200209.284.1360.2","NMFS",2002,10,19,292,30.07,42.857667,-67.518,0,0,0,0,0,"AL",0.038
"13960",464,"200209.285.1290.4","NMFS",2002,10,19,292,30.07,42.567833,-67.576167,1,0,1,1,0,"AL",0.038
"13961",515,"200209.286.1290.3","NMFS",2002,10,20,293,30.13,42.519333,-67.677167,1,1,0,1,0,"AL",0.038
"13962",515,"200209.287.1290.6","NMFS",2002,10,20,293,30,42.361167,-67.716333,0,0,0,0,0,"AL",0.038
"13963",561,"200209.288.1290.5","NMFS",2002,10,20,293,30,42.321667,-67.496667,1,1,0,1,0,"AL",0.038
"13964",464,"200209.289.1300.1","NMFS",2002,10,20,293,30.07,42.431167,-67.3335,1,1,0,1,0,"AL",0.038
"13965",464,"200209.290.1300.2","NMFS",2002,10,20,293,30.07,42.568167,-67.2745,0,0,0,0,0,"AL",0.038
"13966",464,"200209.291.1300.3","NMFS",2002,10,20,293,29.98,42.489667,-66.819833,0,0,0,0,0,"AL",0.038
"13967",464,"200209.292.1290.1","NMFS",2002,10,20,293,30.08,42.558667,-66.8395,0,0,0,0,0,"AL",0.038
"13968",464,"200209.293.1360.1","NMFS",2002,10,20,293,30.07,42.967833,-66.7595,11,9,2,11,0,"AL",0.038
"13969",465,"200209.294.1340.4","NMFS",2002,10,21,294,20.65,43.070167,-66.563833,4,3,1,4,0,"AL",0.038
"13970",465,"200209.296.1330.1","NMFS",2002,10,21,294,19.93,43.284333,-66.498833,10,7,3,8,2,"AL",0.038
"13971",465,"200209.297.1340.2","NMFS",2002,10,21,294,30.08,43.1745,-66.764667,4,1,3,4,0,"AL",0.038
"13972",465,"200209.298.1340.6","NMFS",2002,10,21,294,30,43.441667,-66.818833,4,2,2,4,0,"AL",0.038
"13973",465,"200209.299.1360.4","NMFS",2002,10,21,294,30.03,43.454,-67.076,5,5,0,5,0,"AL",0.038
"13974",511,"200209.300.1340.1","NMFS",2002,10,21,294,29.95,43.884333,-67.090167,1,1,0,1,0,"AL",0.038
"13975",465,"200209.301.1340.3","NMFS",2002,10,21,294,30.03,43.715833,-66.686,11,2,9,11,0,"AL",0.038
"13976",465,"200209.302.1330.4","NMFS",2002,10,21,294,30.08,43.9335,-66.593167,14,8,6,14,0,"AL",0.038
"13977",466,"200209.303.1340.5","NMFS",2002,10,22,295,29.92,44.015167,-66.721667,3,0,3,3,0,"AL",0.038
"13978",466,"200209.304.1330.2","NMFS",2002,10,22,295,30,44.166667,-66.6795,8,3,5,2,6,"AL",0.038
"13979",466,"200209.305.1351.2","NMFS",2002,10,22,295,30.02,44.234,-66.800833,0,0,0,0,0,"AL",0.038
"13980",511,"200209.306.1351.1","NMFS",2002,10,22,295,30.08,44.330333,-67.167333,0,0,0,0,0,"AL",0.038
"13981",511,"200209.307.1360.7","NMFS",2002,10,22,295,30,44.191833,-67.446333,0,0,0,0,0,"AL",0.038
"13982",511,"200209.308.1390.1","NMFS",2002,10,22,295,29.98,44.2585,-67.6705,3,3,0,3,0,"AL",0.038
"13983",512,"200209.309.1390.2","NMFS",2002,10,22,295,21.68,44.133167,-67.940667,13,10,3,12,1,"AL",0.038
"13984",512,"200209.310.1390.4","NMFS",2002,10,22,295,20.67,44.188,-68.028,55,29,26,52,3,"AL",0.038
"13985",512,"200209.311.1390.3","NMFS",2002,10,22,295,30.1,44.0905,-68.093833,22,16,6,21,1,"AL",0.038
"13986",512,"200209.312.1380.1","NMFS",2002,10,23,296,30.13,43.925833,-68.253333,7,6,1,7,0,"AL",0.038
"13987",512,"200209.313.1380.2","NMFS",2002,10,23,296,30,43.6505,-68.649,3,3,0,3,0,"AL",0.038
"13988",512,"200209.314.1400.1","NMFS",2002,10,23,296,30.05,43.752833,-69.085333,79,46,33,79,0,"AL",0.038
"13989",513,"200209.315.1380.5","NMFS",2002,10,23,296,30.05,43.557833,-69.554167,0,0,0,0,0,"AL",0.038
"13990",513,"200209.316.1380.4","NMFS",2002,10,23,296,30,43.428,-69.395167,2,2,0,2,0,"AL",0.038
"13991",513,"200209.317.1370.2","NMFS",2002,10,23,296,30.08,43.206167,-69.821333,0,0,0,0,0,"AL",0.038
"13992",513,"200209.318.1280.7","NMFS",2002,10,23,296,30.12,43.059,-69.865667,0,0,0,0,0,"AL",0.038
"13993",513,"200209.319.1280.2","NMFS",2002,10,24,297,29.93,42.976333,-69.778833,0,0,0,0,0,"AL",0.038
"13994",514,"200209.320.1280.1","NMFS",2002,10,24,297,30,42.778667,-69.700833,0,0,0,0,0,"AL",0.038
"13995",514,"200209.321.1270.3","NMFS",2002,10,24,297,30.05,42.585333,-69.918667,0,0,0,0,0,"AL",0.038
"13996",514,"200209.324.1260.5","NMFS",2002,10,24,297,30.05,42.568333,-70.318,1,1,0,1,0,"AL",0.038
"13997",514,"200209.325.3660.2","NMFS",2002,10,24,297,30.02,42.730333,-70.582,44,15,29,27,17,"AL",0.038
"13998",513,"200209.326.1400.3","NMFS",2002,10,24,297,29.98,42.864167,-70.6195,12,6,6,8,4,"AL",0.038
"13999",513,"200209.327.1400.2","NMFS",2002,10,24,297,30.08,43.129833,-70.357333,6,3,3,6,0,"AL",0.038
"14000",513,"200209.328.1270.2","NMFS",2002,10,24,297,30.1,43.112333,-70.282333,2,1,1,2,0,"AL",0.038
"14001",513,"200209.329.1270.1","NMFS",2002,10,25,298,30.15,42.922,-70.2095,0,0,0,0,0,"AL",0.038
"14002",514,"200209.330.1260.2","NMFS",2002,10,25,298,30.02,42.718167,-70.352833,6,1,5,5,1,"AL",0.038
"14003",514,"200209.331.3640.1","NMFS",2002,10,25,298,20.18,42.327333,-70.782667,93,50,43,66,27,"AL",0.038
"14004",514,"200209.332.3660.3","NMFS",2002,10,25,298,30.07,42.181667,-70.557333,73,46,27,68,5,"AL",0.038
"14005",514,"200209.333.3660.1","NMFS",2002,10,25,298,30,42.1895,-70.477167,16,8,8,16,0,"AL",0.038
"14006",514,"200209.334.3600.1","NMFS",2002,10,25,298,25.02,42.096,-70.536,35,24,11,28,7,"AL",0.038
"14007",526,"200303.170.1100.1","NMFS",2003,4,2,92,29.92,40.054378,-69.377723,0,0,0,0,0,"DE",0.038
"14008",526,"200303.171.1110.1","NMFS",2003,4,2,92,29.93,40.145687,-69.146667,0,0,0,0,0,"DE",0.038
"14009",526,"200303.172.1120.1","NMFS",2003,4,2,92,30.12,40.141667,-69.066552,6,2,4,6,0,"DE",0.038
"14010",526,"200303.173.1100.3","NMFS",2003,4,2,92,30.03,40.278427,-69.582443,0,0,0,0,0,"DE",0.038
"14011",526,"200303.174.1100.2","NMFS",2003,4,3,93,29.95,40.32325,-69.515152,0,0,0,0,0,"DE",0.038
"14012",526,"200303.175.1100.4","NMFS",2003,4,3,93,29.97,40.398098,-69.379197,0,0,0,0,0,"DE",0.038
"14013",526,"200303.176.1100.7","NMFS",2003,4,3,93,29.92,40.44395,-69.446975,0,0,0,0,0,"DE",0.038
"14014",526,"200303.177.1100.5","NMFS",2003,4,3,93,30.12,40.521923,-69.485123,0,0,0,0,0,"DE",0.038
"14015",526,"200303.178.1100.6","NMFS",2003,4,3,93,30.12,40.476647,-69.781205,0,0,0,0,0,"DE",0.038
"14016",526,"200303.179.1090.3","NMFS",2003,4,3,93,29.95,40.71957,-69.498787,0,0,0,0,0,"DE",0.038
"14017",526,"200303.180.3550.4","NMFS",2003,4,3,93,29.93,40.968735,-69.787658,0,0,0,0,0,"DE",0.038
"14018",526,"200303.181.3550.3","NMFS",2003,4,3,93,29.95,41.120448,-69.68161,0,0,0,0,0,"DE",0.038
"14019",526,"200303.182.3550.5","NMFS",2003,4,3,93,20.08,41.031155,-69.58036,0,0,0,0,0,"DE",0.038
"14020",526,"200303.183.3550.2","NMFS",2003,4,3,93,30.07,40.982815,-69.429657,1,1,0,1,0,"DE",0.038
"14021",526,"200303.184.3550.1","NMFS",2003,4,3,93,30.15,40.942638,-69.359032,1,1,0,1,0,"DE",0.038
"14022",521,"200303.185.1250.3","NMFS",2003,4,3,93,29.97,41.016105,-69.31794,1,1,0,1,0,"DE",0.038
"14023",525,"200303.186.1130.8","NMFS",2003,4,4,94,29.97,40.898663,-68.73153,1,1,0,1,0,"DE",0.038
"14024",525,"200303.187.1190.7","NMFS",2003,4,4,94,29.92,40.742798,-68.582923,0,0,0,0,0,"DE",0.038
"14025",525,"200303.188.1130.1","NMFS",2003,4,4,94,30.12,40.612602,-68.647408,0,0,0,0,0,"DE",0.038
"14026",525,"200303.189.1140.2","NMFS",2003,4,4,94,29.95,40.314285,-68.306175,0,0,0,0,0,"DE",0.038
"14027",525,"200303.190.1140.3","NMFS",2003,4,4,94,29.95,40.55722,-67.673867,0,0,0,0,0,"DE",0.038
"14028",525,"200303.191.1140.1","NMFS",2003,4,4,94,30.12,40.56984,-67.285317,0,0,0,0,0,"DE",0.038
"14029",525,"200303.192.1150.1","NMFS",2003,4,4,94,29.9,40.532993,-67.166038,0,0,0,0,0,"DE",0.038
"14030",525,"200303.193.1130.3","NMFS",2003,4,4,94,29.98,40.720993,-67.261268,0,0,0,0,0,"DE",0.038
"14031",525,"200303.194.1130.9","NMFS",2003,4,5,95,30,40.74208,-67.447747,0,0,0,0,0,"DE",0.038
"14032",525,"200303.195.1130.6","NMFS",2003,4,5,95,29.82,40.76743,-67.413422,0,0,0,0,0,"DE",0.038
"14033",525,"200303.196.1130.4","NMFS",2003,4,5,95,30.1,40.981228,-67.473862,1,1,0,1,0,"DE",0.038
"14034",525,"200303.197.1130.7","NMFS",2003,4,5,95,30.15,40.89595,-67.51419,0,0,0,0,0,"DE",0.038
"14035",525,"200303.198.1130.5","NMFS",2003,4,5,95,29.93,40.749268,-67.708625,0,0,0,0,0,"DE",0.038
"14036",525,"200303.199.1130.2","NMFS",2003,4,5,95,29.95,40.819542,-67.805412,0,0,0,0,0,"DE",0.038
"14037",525,"200303.200.1190.9","NMFS",2003,4,5,95,30.12,40.854488,-68.245262,0,0,0,0,0,"DE",0.038
"14038",525,"200303.201.1190.1","NMFS",2003,4,5,95,30.13,41.019757,-68.045493,0,0,0,0,0,"DE",0.038
"14039",525,"200303.202.1190.3","NMFS",2003,4,5,95,29.95,41.179913,-68.012032,0,0,0,0,0,"DE",0.038
"14040",525,"200303.203.1190.2","NMFS",2003,4,5,95,29.95,41.103787,-67.916177,0,0,0,0,0,"DE",0.038
"14041",525,"200303.204.1190.4","NMFS",2003,4,6,96,29.93,41.189342,-67.806252,0,0,0,0,0,"DE",0.038
"14042",562,"200303.205.1190.5","NMFS",2003,4,6,96,30.13,41.691593,-67.405258,0,0,0,0,0,"DE",0.038
"14043",562,"200303.206.1190.6","NMFS",2003,4,6,96,30.12,41.60197,-67.272552,0,0,0,0,0,"DE",0.038
"14044",562,"200303.207.1160.3","NMFS",2003,4,6,96,29.97,41.590935,-66.976837,0,0,0,0,0,"DE",0.038
"14045",562,"200303.208.1160.7","NMFS",2003,4,6,96,29.97,41.309238,-66.807525,0,0,0,0,0,"DE",0.038
"14046",562,"200303.209.1160.8","NMFS",2003,4,6,96,29.82,41.264263,-66.883018,0,0,0,0,0,"DE",0.038
"14047",562,"200303.210.1160.10","NMFS",2003,4,6,96,30.15,41.03173,-67.065688,0,0,0,0,0,"DE",0.038
"14048",562,"200303.211.1160.1","NMFS",2003,4,7,97,29.93,41.1362,-66.78849,0,0,0,0,0,"DE",0.038
"14049",562,"200303.212.1170.2","NMFS",2003,4,7,97,29.92,41.11073,-66.45739,0,0,0,0,0,"DE",0.038
"14050",552,"200303.213.1180.1","NMFS",2003,4,7,97,30.12,41.213467,-66.25119,31,25,6,30,1,"DE",0.038
"14051",552,"200303.214.1170.1","NMFS",2003,4,7,97,29.95,41.431553,-66.113487,0,0,0,0,0,"DE",0.038
"14052",552,"200303.215.1160.6","NMFS",2003,4,7,97,29.92,41.488365,-66.468262,0,0,0,0,0,"DE",0.038
"14053",552,"200303.216.1160.4","NMFS",2003,4,7,97,29.95,41.738365,-66.750282,0,0,0,0,0,"DE",0.038
"14054",551,"200303.217.1160.9","NMFS",2003,4,7,97,30.12,41.904877,-66.830085,0,0,0,0,0,"DE",0.038
"14055",551,"200303.218.1160.2","NMFS",2003,4,7,97,29.98,41.980785,-66.546197,2,1,1,1,1,"DE",0.038
"14056",552,"200303.219.1160.5","NMFS",2003,4,8,98,29.95,41.678958,-66.015868,0,0,0,0,0,"DE",0.038
"14057",552,"200303.220.1170.3","NMFS",2003,4,8,98,29.98,41.820568,-65.760812,1,1,0,1,0,"DE",0.038
"14058",551,"200303.221.1290.4","NMFS",2003,4,8,98,29.95,42.07874,-65.867843,9,6,3,9,0,"DE",0.038
"14059",551,"200303.222.1290.3","NMFS",2003,4,8,98,29.98,42.262517,-66.013077,0,0,0,0,0,"DE",0.038
"14060",464,"200303.223.1290.2","NMFS",2003,4,8,98,29.95,42.480053,-66.548257,4,3,1,4,0,"DE",0.038
"14061",464,"200303.224.1300.1","NMFS",2003,4,8,98,30.12,42.500672,-67.320083,2,2,0,2,0,"DE",0.038
"14062",464,"200303.225.1300.3","NMFS",2003,4,9,99,29.92,42.436222,-67.290313,10,7,3,10,0,"DE",0.038
"14063",561,"200303.227.1300.4","NMFS",2003,4,9,99,30.13,42.307713,-67.384605,5,3,2,5,0,"DE",0.038
"14064",561,"200303.228.1290.1","NMFS",2003,4,9,99,30.15,42.27964,-67.478203,36,29,7,36,0,"DE",0.038
"14065",561,"200303.229.1220.1","NMFS",2003,4,9,99,29.93,42.145352,-67.534317,5,4,1,5,0,"DE",0.038
"14066",561,"200303.230.1220.2","NMFS",2003,4,9,99,29.93,42.153518,-67.405205,0,0,0,0,0,"DE",0.038
"14067",561,"200303.231.1220.3","NMFS",2003,4,9,99,29.93,42.182762,-67.19223,5,3,2,5,0,"DE",0.038
"14068",561,"200303.232.1210.1","NMFS",2003,4,9,99,30.12,42.104717,-67.212493,3,3,0,3,0,"DE",0.038
"14069",561,"200303.233.1200.6","NMFS",2003,4,9,99,30.13,41.983952,-67.305465,0,0,0,0,0,"DE",0.038
"14070",522,"200303.234.1210.2","NMFS",2003,4,9,99,29.92,42.022358,-67.667838,0,0,0,0,0,"DE",0.038
"14071",522,"200303.235.1220.4","NMFS",2003,4,10,100,29.97,42.062595,-67.844597,3,2,1,3,0,"DE",0.038
"14072",522,"200303.236.1210.3","NMFS",2003,4,10,100,29.92,41.895553,-68.016312,0,0,0,0,0,"DE",0.038
"14073",522,"200303.237.1210.4","NMFS",2003,4,10,100,29.97,41.855382,-68.047943,0,0,0,0,0,"DE",0.038
"14074",522,"200303.238.1200.3","NMFS",2003,4,10,100,30.12,41.724128,-68.042953,9,7,2,7,2,"DE",0.038
"14075",522,"200303.239.1200.4","NMFS",2003,4,10,100,29.97,41.690338,-68.259285,0,0,0,0,0,"DE",0.038
"14076",522,"200303.240.1190.8","NMFS",2003,4,10,100,29.95,41.396195,-68.024093,0,0,0,0,0,"DE",0.038
"14077",522,"200303.242.1200.1","NMFS",2003,4,10,100,29.95,41.26376,-68.303192,1,1,0,1,0,"DE",0.038
"14078",521,"200303.244.1230.3","NMFS",2003,4,11,101,29.93,41.30767,-69.348708,0,0,0,0,0,"DE",0.038
"14079",521,"200303.245.1250.4","NMFS",2003,4,11,101,30.12,41.47203,-69.516442,35,16,19,31,4,"DE",0.038
"14080",521,"200303.247.1250.5","NMFS",2003,4,15,105,30.05,41.573638,-69.588088,0,0,0,0,0,"DE",0.038
"14081",521,"200303.248.1240.1","NMFS",2003,4,16,106,29.95,41.892647,-69.522735,2,2,0,2,0,"DE",0.038
"14082",521,"200303.249.1280.4","NMFS",2003,4,16,106,30.12,41.896828,-69.271485,0,0,0,0,0,"DE",0.038
"14083",521,"200303.250.1280.6","NMFS",2003,4,16,106,30.12,41.904945,-69.142197,0,0,0,0,0,"DE",0.038
"14084",521,"200303.251.1240.4","NMFS",2003,4,16,106,30.02,41.859352,-68.878548,0,0,0,0,0,"DE",0.038
"14085",522,"200303.252.1240.5","NMFS",2003,4,16,106,29.92,41.612083,-68.74086,0,0,0,0,0,"DE",0.038
"14086",522,"200303.253.1240.2","NMFS",2003,4,16,106,30.1,41.371312,-68.764648,3,1,2,3,0,"DE",0.038
"14087",522,"200303.254.1230.4","NMFS",2003,4,16,106,30.2,41.317978,-68.797638,0,0,0,0,0,"DE",0.038
"14088",521,"200303.255.1230.1","NMFS",2003,4,16,106,30.03,41.100578,-68.888763,2,0,2,2,0,"DE",0.038
"14089",522,"200303.256.1230.2","NMFS",2003,4,16,106,30,41.146778,-68.799613,3,3,0,3,0,"DE",0.038
"14090",522,"200303.257.1230.5","NMFS",2003,4,16,106,29.97,41.117553,-68.665802,0,0,0,0,0,"DE",0.038
"14091",522,"200303.258.1240.6","NMFS",2003,4,17,107,30.1,41.649097,-68.64766,1,1,0,1,0,"DE",0.038
"14092",522,"200303.259.1240.3","NMFS",2003,4,17,107,29.95,42.137577,-68.416443,0,0,0,0,0,"DE",0.038
"14093",522,"200303.260.1290.7","NMFS",2003,4,17,107,29.95,42.148957,-68.059547,1,1,0,1,0,"DE",0.038
"14094",522,"200303.261.1290.8","NMFS",2003,4,17,107,30.13,42.264867,-68.023315,0,0,0,0,0,"DE",0.038
"14095",515,"200303.263.1290.9","NMFS",2003,4,17,107,30,42.415508,-68.218628,1,1,0,1,0,"DE",0.038
"14096",515,"200303.264.1280.2","NMFS",2003,4,18,108,29.93,42.573757,-68.607522,0,0,0,0,0,"DE",0.038
"14097",515,"200303.265.1290.6","NMFS",2003,4,18,108,30.12,42.713588,-68.331665,1,1,0,1,0,"DE",0.038
"14098",515,"200303.266.1360.5","NMFS",2003,4,18,108,30.03,42.881493,-67.934807,0,0,0,0,0,"DE",0.038
"14099",515,"200303.267.1360.8","NMFS",2003,4,18,108,29.97,43.283028,-67.973113,1,1,0,1,0,"DE",0.038
"14100",515,"200303.268.1360.6","NMFS",2003,4,18,108,29.95,43.324753,-67.852073,1,1,0,1,0,"DE",0.038
"14101",512,"200303.269.1360.4","NMFS",2003,4,18,108,30.13,43.367245,-67.951858,0,0,0,0,0,"DE",0.038
"14102",512,"200303.270.1360.3","NMFS",2003,4,18,108,30.23,43.521343,-67.914375,3,3,0,3,0,"DE",0.038
"14103",465,"200303.271.1360.2","NMFS",2003,4,18,108,30.02,43.60849,-67.630898,1,1,0,1,0,"DE",0.038
"14104",512,"200303.272.1360.1","NMFS",2003,4,19,109,29.95,43.814347,-67.673958,0,0,0,0,0,"DE",0.038
"14105",465,"200303.273.1340.6","NMFS",2003,4,19,109,30.15,43.682445,-67.223397,0,0,0,0,0,"DE",0.038
"14106",465,"200303.274.1360.7","NMFS",2003,4,19,109,30.02,43.268718,-67.20092,4,4,0,4,0,"DE",0.038
"14107",465,"200303.275.1340.2","NMFS",2003,4,19,109,29.93,43.107273,-66.7435,3,0,3,3,0,"DE",0.038
"14108",465,"200303.276.1340.5","NMFS",2003,4,19,109,30.1,43.159032,-66.712845,3,3,0,2,1,"DE",0.038
"14109",465,"200303.277.1340.4","NMFS",2003,4,19,109,30.02,43.263858,-66.791038,0,0,0,0,0,"DE",0.038
"14110",465,"200303.278.1340.1","NMFS",2003,4,19,109,30.02,43.362285,-66.633698,16,5,11,16,0,"DE",0.038
"14111",465,"200303.280.1330.2","NMFS",2003,4,20,110,30.1,43.357483,-66.296402,22,7,15,20,2,"DE",0.038
"14112",465,"200303.281.1330.4","NMFS",2003,4,20,110,20.02,43.485585,-66.304558,14,5,9,13,1,"DE",0.038
"14113",465,"200303.282.1340.3","NMFS",2003,4,20,110,29.93,43.615567,-66.598672,4,0,4,4,0,"DE",0.038
"14114",466,"200303.283.1330.3","NMFS",2003,4,20,110,30.1,44.079952,-66.692535,23,10,13,23,0,"DE",0.038
"14115",466,"200303.284.1330.5","NMFS",2003,4,20,110,30,44.15651,-66.64418,9,5,4,8,1,"DE",0.038
"14116",511,"200303.285.1351.2","NMFS",2003,4,20,110,30.28,44.096077,-66.915863,1,1,0,1,0,"DE",0.038
"14117",511,"200303.286.1351.1","NMFS",2003,4,21,111,29.95,44.361873,-67.089272,3,1,2,3,0,"DE",0.038
"14118",511,"200303.287.1390.4","NMFS",2003,4,21,111,30.05,44.376862,-67.564637,41,19,22,37,4,"DE",0.038
"14119",511,"200303.288.1390.1","NMFS",2003,4,21,111,30,44.227405,-67.760285,0,0,0,0,0,"DE",0.038
"14120",512,"200303.289.1380.3","NMFS",2003,4,21,111,29.95,43.919442,-68.080795,0,0,0,0,0,"DE",0.038
"14121",512,"200303.290.1380.2","NMFS",2003,4,21,111,29.92,43.930252,-68.126755,12,12,0,12,0,"DE",0.038
"14122",512,"200303.291.1380.1","NMFS",2003,4,21,111,30.12,43.730057,-68.153565,4,0,4,4,0,"DE",0.038
"14123",512,"200303.292.1380.4","NMFS",2003,4,21,111,30,43.731232,-68.19571,3,3,0,3,0,"DE",0.038
"14124",512,"200303.293.1390.3","NMFS",2003,4,21,111,22,43.799397,-68.650398,9,7,2,9,0,"DE",0.038
"14125",512,"200303.294.1390.2","NMFS",2003,4,22,112,30.02,43.922035,-68.780457,20,11,9,20,0,"DE",0.038
"14126",513,"200303.296.1400.2","NMFS",2003,4,23,113,30.02,43.374183,-70.097382,0,0,0,0,0,"DE",0.038
"14127",513,"200303.297.1400.1","NMFS",2003,4,24,114,29.92,43.191863,-70.279785,10,4,6,10,0,"DE",0.038
"14128",513,"200303.298.1270.3","NMFS",2003,4,24,114,30.12,43.011535,-70.19992,0,0,0,0,0,"DE",0.038
"14129",513,"200303.299.1270.2","NMFS",2003,4,24,114,30,42.851585,-70.417915,0,0,0,0,0,"DE",0.038
"14130",514,"200303.300.1400.3","NMFS",2003,4,24,114,30,42.810173,-70.506272,1,1,0,1,0,"DE",0.038
"14131",514,"200303.301.3640.1","NMFS",2003,4,24,114,29.97,42.820568,-70.750923,4,3,1,4,0,"DE",0.038
"14132",514,"200303.302.3660.3","NMFS",2003,4,24,114,29.97,42.727612,-70.613968,42,14,28,41,1,"DE",0.038
"14133",514,"200303.303.3660.1","NMFS",2003,4,24,114,30.12,42.660743,-70.415283,1,1,0,1,0,"DE",0.038
"14134",514,"200303.304.1260.2","NMFS",2003,4,24,114,31.62,42.448093,-70.513435,3,3,0,3,0,"DE",0.038
"14135",514,"200303.305.1260.5","NMFS",2003,4,24,114,30.07,42.433732,-70.447007,3,2,1,3,0,"DE",0.038
"14136",514,"200303.306.1260.4","NMFS",2003,4,24,114,29.93,42.654252,-70.320388,0,0,0,0,0,"DE",0.038
"14137",514,"200303.307.1270.1","NMFS",2003,4,25,115,29.92,42.645032,-70.042518,6,5,1,6,0,"DE",0.038
"14138",514,"200303.308.1270.4","NMFS",2003,4,25,115,30.1,42.810467,-70.04602,4,4,0,4,0,"DE",0.038
"14139",513,"200303.309.1370.2","NMFS",2003,4,25,115,30,42.939797,-69.495957,2,2,0,2,0,"DE",0.038
"14140",513,"200303.310.1370.5","NMFS",2003,4,25,115,29.9,43.23119,-69.374962,4,4,0,4,0,"DE",0.038
"14141",513,"200303.311.1380.5","NMFS",2003,4,25,115,29.93,43.308738,-69.349433,2,2,0,2,0,"DE",0.038
"14142",513,"200303.312.1370.1","NMFS",2003,4,25,115,30.15,43.10595,-69.306397,0,0,0,0,0,"DE",0.038
"14143",515,"200303.313.1370.3","NMFS",2003,4,25,115,30.02,42.837337,-69.244293,0,0,0,0,0,"DE",0.038
"14144",515,"200303.314.1370.4","NMFS",2003,4,25,115,30,42.723862,-68.964248,1,1,0,1,0,"DE",0.038
"14145",515,"200303.315.1280.3","NMFS",2003,4,26,116,29.95,42.390553,-69.252883,0,0,0,0,0,"DE",0.038
"14146",515,"200303.316.1280.7","NMFS",2003,4,26,116,30.08,42.361908,-69.346612,0,0,0,0,0,"DE",0.038
"14147",515,"200303.317.1280.5","NMFS",2003,4,26,116,30.12,42.503188,-69.406647,0,0,0,0,0,"DE",0.038
"14148",521,"200303.318.1280.1","NMFS",2003,4,26,116,30.02,42.255067,-69.708473,0,0,0,0,0,"DE",0.038
"14149",521,"200303.322.3560.1","NMFS",2003,4,26,116,20.03,42.001767,-69.99617,2,1,1,2,0,"DE",0.038
"14150",514,"200303.323.3610.3","NMFS",2003,4,26,116,30.08,42.099533,-70.254333,3,1,2,3,0,"DE",0.038
"14151",514,"200303.324.3610.1","NMFS",2003,4,26,116,30.03,42.036397,-70.269692,7,1,6,7,0,"DE",0.038
"14152",514,"200303.325.3600.1","NMFS",2003,4,26,116,30.05,41.978123,-70.157455,6,2,4,5,1,"DE",0.038
"14153",514,"200303.326.3600.2","NMFS",2003,4,27,117,29.93,41.892338,-70.272972,14,3,11,12,2,"DE",0.038
"14154",514,"200303.327.1260.1","NMFS",2003,4,27,117,26.23,42.22837,-70.099975,8,6,2,8,0,"DE",0.038
"14155",514,"200303.328.1260.3","NMFS",2003,4,27,117,30.07,42.265503,-70.152642,2,1,1,2,0,"DE",0.038
"14156",514,"200303.329.3660.2","NMFS",2003,4,27,117,30,42.187977,-70.472527,9,4,5,9,0,"DE",0.038
"14157",514,"200303.330.3630.1","NMFS",2003,4,27,117,20.53,42.238702,-70.696205,4,1,3,3,1,"DE",0.038
"14158",514,"200303.331.3580.1","NMFS",2003,4,27,117,23.93,42.140282,-70.614723,5,4,1,5,0,"DE",0.038
"14159",514,"200303.332.3590.1","NMFS",2003,4,27,117,30.08,41.841232,-70.463692,3,2,1,3,0,"DE",0.038
"14160",526,"200306.79.1090.3","NMFS",2003,9,21,264,30.02,40.687333,-69.921833,0,0,0,0,0,"AL",0.038
"14161",526,"200306.86.1110.1","NMFS",2003,9,21,264,30.02,40.0665,-69.972667,1,0,1,1,0,"AL",0.038
"14162",526,"200306.87.1110.2","NMFS",2003,9,21,264,30.03,39.990333,-69.861333,10,3,7,10,0,"AL",0.038
"14163",526,"200306.88.1120.1","NMFS",2003,9,22,265,30.05,39.934667,-69.3995,16,4,12,14,2,"AL",0.038
"14164",526,"200306.89.1100.3","NMFS",2003,9,22,265,29.98,40.2085,-69.6635,2,1,1,2,0,"AL",0.038
"14165",526,"200306.90.1100.8","NMFS",2003,9,22,265,30.03,40.2865,-69.716167,1,1,0,1,0,"AL",0.038
"14166",526,"200306.91.1100.7","NMFS",2003,9,22,265,30.03,40.316833,-69.578333,0,0,0,0,0,"AL",0.038
"14167",526,"200306.92.1090.1","NMFS",2003,9,22,265,30.08,40.647,-69.4135,0,0,0,0,0,"AL",0.038
"14168",526,"200306.93.1100.1","NMFS",2003,9,22,265,30.12,40.5325,-69.276667,0,0,0,0,0,"AL",0.038
"14169",526,"200306.94.1100.5","NMFS",2003,9,22,265,30.06,40.385667,-69.149667,0,0,0,0,0,"AL",0.038
"14170",526,"200306.95.1100.2","NMFS",2003,9,22,265,30.03,40.313833,-68.941667,0,0,0,0,0,"AL",0.038
"14171",525,"200306.96.1150.1","NMFS",2003,9,22,265,30.02,40.281333,-68.2605,1,1,0,1,0,"AL",0.038
"14172",525,"200306.97.1140.2","NMFS",2003,9,22,265,30.05,40.405833,-68.217667,0,0,0,0,0,"AL",0.038
"14173",525,"200306.98.1130.5","NMFS",2003,9,23,266,30.03,40.525167,-67.943,0,0,0,0,0,"AL",0.038
"14174",525,"200306.99.1130.7","NMFS",2003,9,23,266,30,40.649333,-67.7515,0,0,0,0,0,"AL",0.038
"14175",525,"200306.100.1140.3","NMFS",2003,9,23,266,29.98,40.442833,-67.607833,0,0,0,0,0,"AL",0.038
"14176",525,"200306.101.1140.1","NMFS",2003,9,23,266,30,40.4755,-67.542667,1,1,0,1,0,"AL",0.038
"14177",525,"200306.102.1130.8","NMFS",2003,9,23,266,30.02,40.804,-67.528167,0,0,0,0,0,"AL",0.038
"14178",525,"200306.103.1130.9","NMFS",2003,9,23,266,30.07,40.984,-67.2555,0,0,0,0,0,"AL",0.038
"14179",525,"200306.104.1130.1","NMFS",2003,9,23,266,30.05,40.8555,-67.083333,0,0,0,0,0,"AL",0.038
"14180",562,"200306.105.1160.2","NMFS",2003,9,23,266,30.02,41.064833,-66.755333,0,0,0,0,0,"AL",0.038
"14181",562,"200306.106.1160.11","NMFS",2003,9,23,266,30,41.144833,-66.426333,0,0,0,0,0,"AL",0.038
"14182",562,"200306.107.1160.6","NMFS",2003,9,23,266,30.02,41.270833,-66.805,0,0,0,0,0,"AL",0.038
"14183",562,"200306.108.1190.3","NMFS",2003,9,23,266,30.1,41.359,-67.164833,2,2,0,2,0,"AL",0.038
"14184",562,"200306.109.1160.3","NMFS",2003,9,24,267,30.07,41.185333,-67.1415,0,0,0,0,0,"AL",0.038
"14185",525,"200306.110.1130.6","NMFS",2003,9,24,267,30.03,41.149667,-67.367167,2,2,0,2,0,"AL",0.038
"14186",525,"200306.111.1190.1","NMFS",2003,9,24,267,30.03,40.894667,-68.272833,2,2,0,2,0,"AL",0.038
"14187",525,"200306.112.1190.6","NMFS",2003,9,24,267,30.05,40.8085,-68.627833,0,0,0,0,0,"AL",0.038
"14188",525,"200306.113.1130.3","NMFS",2003,9,24,267,30.03,40.813167,-68.693167,1,1,0,1,0,"AL",0.038
"14189",525,"200306.114.1130.4","NMFS",2003,9,24,267,30,40.836667,-68.779,5,5,0,5,0,"AL",0.038
"14190",525,"200306.115.1130.2","NMFS",2003,9,24,267,30.02,40.687167,-68.694333,0,0,0,0,0,"AL",0.038
"14191",526,"200306.116.3550.3","NMFS",2003,9,24,267,22.12,40.907833,-69.515167,1,1,0,1,0,"AL",0.038
"14192",521,"200306.117.1230.1","NMFS",2003,9,25,268,30.03,41.0735,-69.119,0,0,0,0,0,"AL",0.038
"14193",521,"200306.118.1250.2","NMFS",2003,9,25,268,30.02,41.123167,-69.240833,1,0,1,1,0,"AL",0.038
"14194",521,"200306.119.1250.4","NMFS",2003,9,25,268,23.82,41.197333,-69.2945,2,2,0,2,0,"AL",0.038
"14195",521,"200306.121.3550.1","NMFS",2003,9,25,268,30.02,41.351333,-69.566667,1,1,0,1,0,"AL",0.038
"14196",521,"200306.122.3550.5","NMFS",2003,9,25,268,21.58,41.318667,-69.5195,0,0,0,0,0,"AL",0.038
"14197",521,"200306.123.1250.1","NMFS",2003,9,25,268,30.03,41.425667,-69.4725,8,4,4,8,0,"AL",0.038
"14198",521,"200306.125.3550.6","NMFS",2003,9,25,268,21.92,41.506833,-69.740667,0,0,0,0,0,"AL",0.038
"14199",521,"200306.126.1250.3","NMFS",2003,9,25,268,30.03,41.557667,-69.568833,2,1,1,2,0,"AL",0.038
"14200",521,"200306.127.1230.5","NMFS",2003,9,25,268,30.02,41.689167,-69.629167,0,0,0,0,0,"AL",0.038
"14201",521,"200306.128.1230.2","NMFS",2003,9,25,268,30.12,41.8065,-69.7795,0,0,0,0,0,"AL",0.038
"14202",514,"200306.223.3600.2","NMFS",2003,10,15,288,30.03,41.898167,-70.4535,2,2,0,2,0,"AL",0.038
"14203",514,"200306.224.3600.1","NMFS",2003,10,16,289,30.1,42.0795,-70.522667,4,2,2,4,0,"AL",0.038
"14204",514,"200306.225.3640.2","NMFS",2003,10,16,289,30.08,42.222,-70.593,4,1,3,4,0,"AL",0.038
"14205",514,"200306.226.3610.1","NMFS",2003,10,16,289,30.02,42.1065,-70.442333,4,1,3,4,0,"AL",0.038
"14206",514,"200306.227.3610.2","NMFS",2003,10,16,289,30.02,42.109167,-70.219333,1,1,0,1,0,"AL",0.038
"14207",521,"200306.228.1270.4","NMFS",2003,10,16,289,30.03,42.186167,-69.873333,0,0,0,0,0,"AL",0.038
"14208",521,"200306.229.1270.1","NMFS",2003,10,16,289,30.03,42.116,-69.753667,0,0,0,0,0,"AL",0.038
"14209",521,"200306.230.1280.7","NMFS",2003,10,17,290,30.02,41.984167,-69.404833,0,0,0,0,0,"AL",0.038
"14210",521,"200306.231.1240.2","NMFS",2003,10,17,290,30.13,41.692333,-69.202833,0,0,0,0,0,"AL",0.038
"14211",521,"200306.232.1240.5","NMFS",2003,10,17,290,30.07,41.757833,-68.871333,0,0,0,0,0,"AL",0.038
"14212",521,"200306.233.1240.1","NMFS",2003,10,17,290,30.02,41.694,-68.8485,0,0,0,0,0,"AL",0.038
"14213",522,"200306.234.1230.3","NMFS",2003,10,17,290,30.02,41.482167,-68.644,0,0,0,0,0,"AL",0.038
"14214",522,"200306.235.1230.4","NMFS",2003,10,17,290,30.1,41.362333,-68.5865,2,1,1,2,0,"AL",0.038
"14215",522,"200306.236.1190.7","NMFS",2003,10,17,290,30.12,41.055667,-68.524167,0,0,0,0,0,"AL",0.038
"14216",522,"200306.237.1200.4","NMFS",2003,10,17,290,21.82,41.241167,-68.435333,0,0,0,0,0,"AL",0.038
"14217",522,"200306.238.1190.2","NMFS",2003,10,17,290,30.03,41.403167,-67.811,0,0,0,0,0,"AL",0.038
"14218",562,"200306.239.1190.8","NMFS",2003,10,17,290,29.93,41.299167,-67.634167,0,0,0,0,0,"AL",0.038
"14219",522,"200306.240.1190.9","NMFS",2003,10,17,290,30.07,41.411667,-67.728167,0,0,0,0,0,"AL",0.038
"14220",522,"200306.241.1200.3","NMFS",2003,10,18,291,30.05,41.722167,-67.735167,4,4,0,4,0,"AL",0.038
"14221",522,"200306.242.1200.2","NMFS",2003,10,18,291,30.05,41.6515,-67.879,0,0,0,0,0,"AL",0.038
"14222",522,"200306.243.1200.6","NMFS",2003,10,18,291,30.02,41.776833,-68.027333,4,3,1,4,0,"AL",0.038
"14223",522,"200306.244.1220.1","NMFS",2003,10,18,291,29.98,41.812667,-68.242,0,0,0,0,0,"AL",0.038
"14224",522,"200306.245.1220.3","NMFS",2003,10,18,291,30.03,41.887,-68.110333,0,0,0,0,0,"AL",0.038
"14225",522,"200306.246.1220.2","NMFS",2003,10,18,291,30.08,42.025167,-67.958333,0,0,0,0,0,"AL",0.038
"14226",561,"200306.247.1210.3","NMFS",2003,10,18,291,30.01,42.100333,-67.406167,6,6,0,6,0,"AL",0.038
"14227",561,"200306.248.1200.1","NMFS",2003,10,18,291,30.02,41.956,-67.337667,1,1,0,1,0,"AL",0.038
"14228",561,"200306.249.1200.5","NMFS",2003,10,18,291,30,41.889,-67.561667,0,0,0,0,0,"AL",0.038
"14229",562,"200306.250.1190.4","NMFS",2003,10,18,291,30.03,41.5955,-67.140667,18,11,7,16,2,"AL",0.038
"14230",562,"200306.251.1190.5","NMFS",2003,10,18,291,30.02,41.726667,-67.074667,2,2,0,2,0,"AL",0.038
"14231",552,"200306.252.1160.9","NMFS",2003,10,19,292,30.08,41.821,-66.747333,3,3,0,3,0,"AL",0.038
"14232",552,"200306.253.1160.10","NMFS",2003,10,19,292,30,41.604333,-66.2485,1,1,0,1,0,"AL",0.038
"14233",552,"200306.254.1160.1","NMFS",2003,10,19,292,30.02,41.4905,-66.107333,1,1,0,1,0,"AL",0.038
"14234",552,"200306.255.1170.1","NMFS",2003,10,19,292,30.02,41.455667,-66.1335,1,1,0,1,0,"AL",0.038
"14235",552,"200306.256.1170.2","NMFS",2003,10,19,292,30.08,41.370667,-66.134,1,1,0,1,0,"AL",0.038
"14236",552,"200306.257.1180.1","NMFS",2003,10,19,292,30.1,41.369,-66.045667,2,2,0,2,0,"AL",0.038
"14237",552,"200306.258.1160.5","NMFS",2003,10,19,292,30,41.754833,-65.948667,0,0,0,0,0,"AL",0.038
"14238",551,"200306.259.1160.4","NMFS",2003,10,19,292,30.05,41.893667,-66.114833,0,0,0,0,0,"AL",0.038
"14239",551,"200306.260.1160.7","NMFS",2003,10,19,292,30.03,41.845167,-66.220333,0,0,0,0,0,"AL",0.038
"14240",551,"200306.261.1210.1","NMFS",2003,10,19,292,30.02,42.099333,-66.27,0,0,0,0,0,"AL",0.038
"14241",551,"200306.262.1290.2","NMFS",2003,10,19,292,30.03,42.195333,-66.309167,0,0,0,0,0,"AL",0.038
"14242",464,"200306.264.1290.9","NMFS",2003,10,20,293,30.02,42.418167,-66.0635,0,0,0,0,0,"AL",0.038
"14243",464,"200306.265.1290.5","NMFS",2003,10,20,293,29.98,42.427833,-65.950167,1,1,0,1,0,"AL",0.038
"14244",464,"200306.266.1290.4","NMFS",2003,10,20,293,30.02,42.533833,-66.507833,0,0,0,0,0,"AL",0.038
"14245",464,"200306.267.1300.1","NMFS",2003,10,20,293,30,42.394667,-66.861,0,0,0,0,0,"AL",0.038
"14246",551,"200306.268.1290.8","NMFS",2003,10,20,293,29.97,42.287167,-66.894,1,1,0,1,0,"AL",0.038
"14247",551,"200306.269.1290.3","NMFS",2003,10,20,293,29.97,42.2715,-66.670833,3,2,1,3,0,"AL",0.038
"14248",551,"200306.270.1210.4","NMFS",2003,10,20,293,30.05,42.104333,-66.506833,2,0,2,2,0,"AL",0.038
"14249",551,"200306.271.1210.2","NMFS",2003,10,20,293,30,42.109667,-66.648167,0,0,0,0,0,"AL",0.038
"14250",551,"200306.272.1160.8","NMFS",2003,10,20,293,30.05,42.033,-66.966667,2,2,0,2,0,"AL",0.038
"14251",551,"200306.273.1220.4","NMFS",2003,10,20,293,30.05,42.223167,-67.0875,1,1,0,1,0,"AL",0.038
"14252",464,"200306.274.1300.2","NMFS",2003,10,21,294,30.07,42.402,-67.301833,1,1,0,1,0,"AL",0.038
"14253",464,"200306.275.1300.3","NMFS",2003,10,21,294,30.03,42.474,-67.249833,0,0,0,0,0,"AL",0.038
"14254",515,"200306.276.1290.7","NMFS",2003,10,21,294,30.05,42.494,-67.747167,0,0,0,0,0,"AL",0.038
"14255",464,"200306.278.1290.10","NMFS",2003,10,21,294,30.07,42.777833,-67.5435,0,0,0,0,0,"AL",0.038
"14256",514,"200306.280.1260.6","NMFS",2003,10,22,295,30,42.393833,-70.3015,1,0,1,1,0,"AL",0.038
"14257",514,"200306.281.3660.2","NMFS",2003,10,22,295,30.13,42.281,-70.5935,6,2,4,5,1,"AL",0.038
"14258",514,"200306.283.3640.1","NMFS",2003,10,22,295,30.03,42.345,-70.779833,8,7,1,8,0,"AL",0.038
"14259",514,"200306.285.1260.2","NMFS",2003,10,22,295,30.07,42.435667,-70.4745,0,0,0,0,0,"AL",0.038
"14260",514,"200306.286.1260.1","NMFS",2003,10,22,295,20.13,42.529333,-70.578833,11,3,8,11,0,"AL",0.038
"14261",514,"200306.287.1260.4","NMFS",2003,10,23,296,30.05,42.651833,-70.1865,0,0,0,0,0,"AL",0.038
"14262",514,"200306.288.1260.3","NMFS",2003,10,23,296,29.97,42.797333,-70.346833,0,0,0,0,0,"AL",0.038
"14263",513,"200306.289.1270.2","NMFS",2003,10,23,296,30.02,42.9025,-70.2455,0,0,0,0,0,"AL",0.038
"14264",513,"200306.290.1270.3","NMFS",2003,10,23,296,30.05,43.056833,-69.985333,0,0,0,0,0,"AL",0.038
"14265",513,"200306.291.1400.1","NMFS",2003,10,23,296,24.87,43.321833,-70.173333,3,1,2,3,0,"AL",0.038
"14266",513,"200306.292.1400.2","NMFS",2003,10,23,296,30.03,43.376333,-70.1535,1,0,1,1,0,"AL",0.038
"14267",513,"200306.293.1380.2","NMFS",2003,10,23,296,30.05,43.5205,-69.6685,0,0,0,0,0,"AL",0.038
"14268",513,"200306.294.1380.3","NMFS",2003,10,23,296,30.08,43.351833,-69.469333,0,0,0,0,0,"AL",0.038
"14269",513,"200306.295.1380.4","NMFS",2003,10,24,297,29.98,43.364333,-69.678167,0,0,0,0,0,"AL",0.038
"14270",513,"200306.296.1370.4","NMFS",2003,10,24,297,30.08,43.1325,-69.706,0,0,0,0,0,"AL",0.038
"14271",515,"200306.297.1370.5","NMFS",2003,10,24,297,30.03,42.814167,-69.536,0,0,0,0,0,"AL",0.038
"14272",515,"200306.298.1280.5","NMFS",2003,10,24,297,30,42.558,-69.578167,1,1,0,1,0,"AL",0.038
"14273",515,"200306.299.1280.6","NMFS",2003,10,24,297,30.05,42.532167,-69.128667,0,0,0,0,0,"AL",0.038
"14274",515,"200306.300.1280.1","NMFS",2003,10,24,297,30.03,42.562833,-68.9625,0,0,0,0,0,"AL",0.038
"14275",515,"200306.301.1280.4","NMFS",2003,10,24,297,30,42.527167,-68.641,0,0,0,0,0,"AL",0.038
"14276",515,"200306.302.1280.2","NMFS",2003,10,24,297,30.03,42.3535,-68.749833,0,0,0,0,0,"AL",0.038
"14277",522,"200306.303.1240.6","NMFS",2003,10,24,297,30.05,42.259667,-68.728833,0,0,0,0,0,"AL",0.038
"14278",522,"200306.304.1240.3","NMFS",2003,10,24,297,30.15,42.068,-68.535667,1,1,0,1,0,"AL",0.038
"14279",522,"200306.305.1240.4","NMFS",2003,10,24,297,30.08,42.019833,-68.571167,0,0,0,0,0,"AL",0.038
"14280",515,"200306.306.1280.3","NMFS",2003,10,28,301,29.98,42.476833,-69.015,1,1,0,1,0,"AL",0.038
"14281",515,"200306.307.1370.1","NMFS",2003,10,28,301,30.03,42.769833,-68.738667,1,1,0,1,0,"AL",0.038
"14282",515,"200306.308.1360.1","NMFS",2003,10,28,301,30.03,43.1165,-68.109833,0,0,0,0,0,"AL",0.038
"14283",465,"200306.309.1360.6","NMFS",2003,10,28,301,30.02,43.437667,-67.529333,0,0,0,0,0,"AL",0.038
"14284",465,"200306.310.1360.8","NMFS",2003,10,28,301,30.07,43.726,-67.406333,0,0,0,0,0,"AL",0.038
"14285",465,"200306.311.1340.2","NMFS",2003,10,28,301,30.02,43.602333,-67.111167,1,1,0,1,0,"AL",0.038
"14286",465,"200306.312.1360.4","NMFS",2003,10,29,302,30.08,43.5085,-67.178,0,0,0,0,0,"AL",0.038
"14287",465,"200306.313.1360.5","NMFS",2003,10,29,302,30.1,43.5115,-67.1065,1,1,0,1,0,"AL",0.038
"14288",465,"200306.315.1360.9","NMFS",2003,10,29,302,29.97,43.342833,-67.061333,0,0,0,0,0,"AL",0.038
"14289",465,"200306.316.1360.2","NMFS",2003,10,29,302,30.03,43.1895,-67.226167,0,0,0,0,0,"AL",0.038
"14290",465,"200306.317.1360.7","NMFS",2003,10,29,302,30,43.2665,-67.0155,0,0,0,0,0,"AL",0.038
"14291",465,"200306.318.1330.1","NMFS",2003,10,29,302,30.08,43.407333,-66.347333,72,39,33,70,2,"AL",0.038
"14292",465,"200306.319.1330.4","NMFS",2003,10,29,302,30.07,43.48,-66.4495,98,48,50,98,0,"AL",0.038
"14293",465,"200306.320.1330.2","NMFS",2003,10,29,302,30,43.556167,-66.321333,267,140,127,258,9,"AL",0.038
"14294",465,"200306.321.1340.4","NMFS",2003,10,29,302,30.07,43.614333,-66.841667,1,1,0,1,0,"AL",0.038
"14295",465,"200306.322.1340.5","NMFS",2003,10,30,303,30.03,43.634667,-66.85,0,0,0,0,0,"AL",0.038
"14296",465,"200306.323.1340.3","NMFS",2003,10,30,303,30,43.739167,-66.961833,2,2,0,2,0,"AL",0.038
"14297",511,"200306.324.1340.1","NMFS",2003,10,30,303,30.03,43.840667,-66.856,4,4,0,4,0,"AL",0.038
"14298",465,"200306.325.1330.3","NMFS",2003,10,30,303,30.02,43.9585,-66.634,20,15,5,20,0,"AL",0.038
"14299",465,"200306.326.1340.6","NMFS",2003,10,30,303,30.08,43.967333,-66.784667,1,1,0,1,0,"AL",0.038
"14300",511,"200306.327.1351.1","NMFS",2003,10,30,303,30.03,44.226833,-66.903833,1,1,0,1,0,"AL",0.038
"14301",511,"200306.328.1351.2","NMFS",2003,10,30,303,30.02,44.184833,-67.023167,0,0,0,0,0,"AL",0.038
"14302",511,"200306.329.1380.1","NMFS",2003,10,31,304,30.03,44.179333,-67.751667,0,0,0,0,0,"AL",0.038
"14303",512,"200306.330.1390.1","NMFS",2003,10,31,304,30.17,44.154333,-67.892333,4,2,2,4,0,"AL",0.038
"14304",512,"200306.331.1380.5","NMFS",2003,10,31,304,29.97,43.740167,-68.2285,0,0,0,0,0,"AL",0.038
"14305",512,"200306.332.1390.3","NMFS",2003,10,31,304,22.85,43.952167,-68.404,48,34,14,48,0,"AL",0.038
"14306",512,"200306.333.1390.4","NMFS",2003,10,31,304,30.05,43.843667,-68.445167,3,3,0,3,0,"AL",0.038
"14307",512,"200306.334.1390.2","NMFS",2003,10,31,304,30.03,43.9435,-68.578333,81,47,34,81,0,"AL",0.038
"14308",515,"200306.335.1370.2","NMFS",2003,10,31,304,30.03,42.957667,-69.087833,0,0,0,0,0,"AL",0.038
"14309",515,"200306.336.1370.3","NMFS",2003,10,31,304,30,42.95,-69.248,0,0,0,0,0,"AL",0.038
"14310",526,"200402.166.1100.3","NMFS",2004,3,25,85,30.07,40.196,-69.893167,0,0,0,0,0,"AL",0.038
"14311",526,"200402.178.1090.5","NMFS",2004,3,31,91,29.95,40.643,-69.924167,0,0,0,0,0,"AL",0.038
"14312",526,"200402.179.1090.4","NMFS",2004,3,31,91,30.07,40.759167,-69.966667,0,0,0,0,0,"AL",0.038
"14313",526,"200402.180.3550.4","NMFS",2004,3,31,91,30.03,41.132,-69.662333,0,0,0,0,0,"AL",0.038
"14314",521,"200402.181.3550.5","NMFS",2004,3,31,91,30.03,41.3235,-69.597333,0,0,0,0,0,"AL",0.038
"14315",521,"200402.182.3550.2","NMFS",2004,3,31,91,30,41.3445,-69.5565,2,1,1,2,0,"AL",0.038
"14316",521,"200402.183.1250.1","NMFS",2004,3,31,91,30.1,41.236667,-69.383833,1,1,0,1,0,"AL",0.038
"14317",521,"200402.184.3550.1","NMFS",2004,3,31,91,30.02,41.0395,-69.48,0,0,0,0,0,"AL",0.038
"14318",521,"200402.185.3550.3","NMFS",2004,3,31,91,30.02,41.019667,-69.425833,0,0,0,0,0,"AL",0.038
"14319",521,"200402.186.1250.4","NMFS",2004,3,31,91,30.02,41.120167,-69.304333,0,0,0,0,0,"AL",0.038
"14320",521,"200402.187.1250.2","NMFS",2004,3,31,91,30.03,41.069333,-69.256,0,0,0,0,0,"AL",0.038
"14321",521,"200402.188.1250.3","NMFS",2004,3,31,91,29.97,41.038,-69.209833,0,0,0,0,0,"AL",0.038
"14322",521,"200402.189.1230.1","NMFS",2004,3,31,91,30.02,41.031833,-68.935,0,0,0,0,0,"AL",0.038
"14323",522,"200402.190.1230.2","NMFS",2004,4,1,92,30.03,41.014667,-68.832333,0,0,0,0,0,"AL",0.038
"14324",526,"200402.191.1130.3","NMFS",2004,4,1,92,30.05,40.853667,-68.862833,4,3,1,4,0,"AL",0.038
"14325",526,"200402.192.1100.4","NMFS",2004,4,1,92,30.05,40.698333,-69.196333,0,0,0,0,0,"AL",0.038
"14326",525,"200402.193.1130.9","NMFS",2004,4,1,92,30.07,40.565167,-68.689833,0,0,0,0,0,"AL",0.038
"14327",526,"200402.194.1100.6","NMFS",2004,4,1,92,30.02,40.388333,-68.857167,0,0,0,0,0,"AL",0.038
"14328",526,"200402.195.1100.5","NMFS",2004,4,1,92,30.12,40.3665,-69.043167,0,0,0,0,0,"AL",0.038
"14329",526,"200402.196.1110.2","NMFS",2004,4,1,92,30.08,40.103667,-69.184833,0,0,0,0,0,"AL",0.038
"14330",525,"200402.197.1150.1","NMFS",2004,4,1,92,29.98,40.137167,-68.430667,3,3,0,3,0,"AL",0.038
"14331",525,"200402.198.1140.1","NMFS",2004,4,1,92,30.05,40.358333,-68.410167,0,0,0,0,0,"AL",0.038
"14332",525,"200402.199.1130.2","NMFS",2004,4,2,93,30.07,40.523167,-68.401833,0,0,0,0,0,"AL",0.038
"14333",525,"200402.200.1130.8","NMFS",2004,4,2,93,30.07,40.593,-68.078,0,0,0,0,0,"AL",0.038
"14334",525,"200402.201.1140.2","NMFS",2004,4,2,93,30.02,40.478333,-68.058167,0,0,0,0,0,"AL",0.038
"14335",525,"200402.202.1140.3","NMFS",2004,4,2,93,30,40.442333,-67.9135,0,0,0,0,0,"AL",0.038
"14336",525,"200402.203.1130.5","NMFS",2004,4,2,93,30.05,40.645333,-67.7085,0,0,0,0,0,"AL",0.038
"14337",525,"200402.204.1130.7","NMFS",2004,4,2,93,30.05,40.770167,-67.514,0,0,0,0,0,"AL",0.038
"14338",525,"200402.205.1130.1","NMFS",2004,4,2,93,30.07,40.7675,-67.980333,0,0,0,0,0,"AL",0.038
"14339",525,"200402.206.1190.7","NMFS",2004,4,2,93,30.03,40.929667,-68.259,1,0,1,1,0,"AL",0.038
"14340",525,"200402.207.1190.4","NMFS",2004,4,2,93,30.02,40.939167,-68.057167,0,0,0,0,0,"AL",0.038
"14341",525,"200402.208.1190.1","NMFS",2004,4,2,93,30.18,40.977667,-67.981167,0,0,0,0,0,"AL",0.038
"14342",525,"200402.209.1130.4","NMFS",2004,4,2,93,30.05,40.937833,-67.882167,0,0,0,0,0,"AL",0.038
"14343",525,"200402.210.1190.3","NMFS",2004,4,3,94,30.07,41.147667,-67.606333,0,0,0,0,0,"AL",0.038
"14344",562,"200402.211.1190.8","NMFS",2004,4,3,94,30.07,41.187333,-67.542333,0,0,0,0,0,"AL",0.038
"14345",525,"200402.212.1130.6","NMFS",2004,4,3,94,30.02,40.9355,-67.051,0,0,0,0,0,"AL",0.038
"14346",562,"200402.213.1160.9","NMFS",2004,4,3,94,30.07,40.979333,-66.986833,0,0,0,0,0,"AL",0.038
"14347",562,"200402.214.1160.6","NMFS",2004,4,3,94,30.02,40.8915,-66.760833,0,0,0,0,0,"AL",0.038
"14348",562,"200402.215.1160.7","NMFS",2004,4,3,94,30.05,41.190833,-66.5315,0,0,0,0,0,"AL",0.038
"14349",552,"200402.216.1170.1","NMFS",2004,4,3,94,30.05,41.3075,-66.215667,0,0,0,0,0,"AL",0.038
"14350",552,"200402.217.1170.2","NMFS",2004,4,3,94,30.1,41.504667,-66.063,0,0,0,0,0,"AL",0.038
"14351",552,"200402.218.1170.3","NMFS",2004,4,3,94,30,41.706833,-65.820833,3,3,0,3,0,"AL",0.038
"14352",552,"200402.219.1160.1","NMFS",2004,4,3,94,30.03,41.824,-66.0875,0,0,0,0,0,"AL",0.038
"14353",551,"200402.220.1160.10","NMFS",2004,4,4,95,30.37,41.9005,-66.203167,3,0,3,3,0,"AL",0.038
"14354",551,"200402.221.1180.1","NMFS",2004,4,4,95,30.05,42.049667,-65.924833,2,2,0,2,0,"AL",0.038
"14355",551,"200402.222.1210.2","NMFS",2004,4,4,95,30.03,42.095667,-66.169667,4,2,2,4,0,"AL",0.038
"14356",464,"200402.223.1290.8","NMFS",2004,4,4,95,30.23,42.4715,-66.3265,4,4,0,4,0,"AL",0.038
"14357",464,"200402.224.1300.3","NMFS",2004,4,4,95,30.03,42.474333,-66.623167,16,13,3,16,0,"AL",0.038
"14358",464,"200402.225.1300.1","NMFS",2004,4,4,95,30.03,42.433667,-66.980667,14,11,3,14,0,"AL",0.038
"14359",464,"200402.227.1300.4","NMFS",2004,4,4,95,30.08,42.3685,-67.290167,14,14,0,14,0,"AL",0.038
"14360",561,"200402.228.1200.1","NMFS",2004,4,4,95,30.05,42.0685,-67.1575,0,0,0,0,0,"AL",0.038
"14361",551,"200402.229.1210.4","NMFS",2004,4,4,95,30.05,42.143167,-66.941333,3,2,1,3,0,"AL",0.038
"14362",551,"200402.230.1210.3","NMFS",2004,4,5,96,29.97,42.1075,-66.789667,0,0,0,0,0,"AL",0.038
"14363",551,"200402.231.1220.2","NMFS",2004,4,5,96,30.08,42.186333,-66.65,2,1,1,2,0,"AL",0.038
"14364",552,"200402.232.1160.2","NMFS",2004,4,5,96,30.05,41.776167,-66.738833,0,0,0,0,0,"AL",0.038
"14365",552,"200402.233.1160.8","NMFS",2004,4,5,96,30.05,41.723,-66.7485,0,0,0,0,0,"AL",0.038
"14366",562,"200402.234.1160.5","NMFS",2004,4,5,96,30.05,41.613167,-66.912333,0,0,0,0,0,"AL",0.038
"14367",562,"200402.235.1160.3","NMFS",2004,4,5,96,30.07,41.684667,-66.916167,0,0,0,0,0,"AL",0.038
"14368",562,"200402.236.1160.4","NMFS",2004,4,5,96,29.97,41.692167,-66.9705,0,0,0,0,0,"AL",0.038
"14369",562,"200402.237.1190.6","NMFS",2004,4,5,96,26.32,41.691333,-67.1725,0,0,0,0,0,"AL",0.038
"14370",562,"200402.238.1190.5","NMFS",2004,4,5,96,30,41.709833,-67.525167,1,1,0,1,0,"AL",0.038
"14371",562,"200402.239.1190.9","NMFS",2004,4,5,96,30.02,41.630667,-67.634833,0,0,0,0,0,"AL",0.038
"14372",522,"200402.240.1200.6","NMFS",2004,4,5,96,30.03,41.834167,-67.690833,0,0,0,0,0,"AL",0.038
"14373",522,"200402.241.1210.1","NMFS",2004,4,5,96,30.05,41.984,-67.806333,0,0,0,0,0,"AL",0.038
"14374",522,"200402.242.1220.4","NMFS",2004,4,6,97,30.02,42.116,-67.6765,8,8,0,8,0,"AL",0.038
"14375",522,"200402.243.1290.2","NMFS",2004,4,6,97,30.08,42.187167,-67.9475,7,7,0,7,0,"AL",0.038
"14376",522,"200402.244.1290.3","NMFS",2004,4,6,97,30.1,42.150833,-67.992167,2,0,2,2,0,"AL",0.038
"14377",522,"200402.245.1220.1","NMFS",2004,4,6,97,30.02,41.903833,-68.205667,0,0,0,0,0,"AL",0.038
"14378",522,"200402.246.1220.3","NMFS",2004,4,6,97,30.02,41.781,-68.361667,0,0,0,0,0,"AL",0.038
"14379",522,"200402.247.1200.3","NMFS",2004,4,6,97,30,41.693,-68.037667,0,0,0,0,0,"AL",0.038
"14380",522,"200402.249.1190.10","NMFS",2004,4,7,98,30.08,41.336167,-67.939333,0,0,0,0,0,"AL",0.038
"14381",522,"200402.250.1200.5","NMFS",2004,4,7,98,30.23,41.3695,-68.156167,0,0,0,0,0,"AL",0.038
"14382",522,"200402.251.1200.2","NMFS",2004,4,7,98,29.98,41.477,-68.174833,0,0,0,0,0,"AL",0.038
"14383",522,"200402.252.1200.4","NMFS",2004,4,7,98,30,41.4145,-68.2945,0,0,0,0,0,"AL",0.038
"14384",522,"200402.253.1230.5","NMFS",2004,4,7,98,30.02,41.394333,-68.630667,0,0,0,0,0,"AL",0.038
"14385",522,"200402.254.1230.4","NMFS",2004,4,7,98,30.27,41.502833,-68.571167,0,0,0,0,0,"AL",0.038
"14386",522,"200402.255.1240.4","NMFS",2004,4,7,98,30.08,41.682333,-68.624167,0,0,0,0,0,"AL",0.038
"14387",522,"200402.256.1240.6","NMFS",2004,4,7,98,30,41.7875,-68.684167,0,0,0,0,0,"AL",0.038
"14388",521,"200402.257.1240.2","NMFS",2004,4,7,98,30.03,41.688333,-69.14,0,0,0,0,0,"AL",0.038
"14389",521,"200402.258.1280.6","NMFS",2004,4,7,98,30.03,41.965833,-69.3865,0,0,0,0,0,"AL",0.038
"14390",521,"200402.259.1280.2","NMFS",2004,4,7,98,30.03,42.044833,-69.205833,0,0,0,0,0,"AL",0.038
"14391",521,"200402.260.1280.4","NMFS",2004,4,8,99,30.08,42.003833,-69.159167,0,0,0,0,0,"AL",0.038
"14392",522,"200402.261.1240.5","NMFS",2004,4,8,99,30.02,42.035333,-68.814333,0,0,0,0,0,"AL",0.038
"14393",522,"200402.262.1240.1","NMFS",2004,4,8,99,30,42.189333,-68.7145,1,1,0,1,0,"AL",0.038
"14394",521,"200402.263.1240.3","NMFS",2004,4,8,99,30.02,42.222,-69.1195,0,0,0,0,0,"AL",0.038
"14395",515,"200402.264.1280.5","NMFS",2004,4,8,99,30,42.560833,-69.518833,0,0,0,0,0,"AL",0.038
"14396",515,"200402.265.1280.1","NMFS",2004,4,8,99,30.02,42.372,-69.6425,0,0,0,0,0,"AL",0.038
"14397",521,"200402.266.1280.3","NMFS",2004,4,8,99,30,42.231167,-69.461,0,0,0,0,0,"AL",0.038
"14398",521,"200402.269.1230.6","NMFS",2004,4,8,99,30,41.562833,-69.496667,2,1,1,2,0,"AL",0.038
"14399",515,"200402.270.1370.1","NMFS",2004,4,14,105,30.02,42.703292,-68.952858,1,1,0,1,0,"AL",0.038
"14400",515,"200402.271.1370.5","NMFS",2004,4,14,105,30.02,42.91144,-68.841077,1,1,0,1,0,"AL",0.038
"14401",515,"200402.272.1370.2","NMFS",2004,4,14,105,30.03,43.149498,-68.56838,3,3,0,3,0,"AL",0.038
"14402",515,"200402.273.1360.1","NMFS",2004,4,14,105,30.12,43.045647,-68.271932,11,11,0,11,0,"AL",0.038
"14403",515,"200402.274.1360.4","NMFS",2004,4,14,105,30.1,42.894003,-68.354093,1,1,0,1,0,"AL",0.038
"14404",515,"200402.275.1360.5","NMFS",2004,4,14,105,30.07,42.843733,-68.138823,0,0,0,0,0,"AL",0.038
"14405",515,"200402.276.1290.7","NMFS",2004,4,14,105,30.02,42.51958,-68.240143,2,2,0,2,0,"AL",0.038
"14406",515,"200402.277.1290.5","NMFS",2004,4,14,105,30.03,42.610732,-68.07975,2,2,0,2,0,"AL",0.038
"14407",464,"200402.278.1290.1","NMFS",2004,4,15,106,30,42.723648,-67.524197,3,3,0,3,0,"AL",0.038
"14408",464,"200402.279.1290.4","NMFS",2004,4,15,106,30.08,42.612923,-67.245463,2,2,0,2,0,"AL",0.038
"14409",464,"200402.280.1290.6","NMFS",2004,4,15,106,30.05,42.696645,-67.23065,1,1,0,1,0,"AL",0.038
"14410",464,"200402.281.1360.7","NMFS",2004,4,15,106,30.05,42.948125,-67.294327,7,3,4,7,0,"AL",0.038
"14411",465,"200402.282.1360.8","NMFS",2004,4,15,106,30.07,43.06808,-67.120985,3,3,0,3,0,"AL",0.038
"14412",465,"200402.283.1340.5","NMFS",2004,4,15,106,30.42,43.044435,-66.664618,1,0,1,1,0,"AL",0.038
"14413",465,"200402.284.1340.2","NMFS",2004,4,15,106,30.02,43.332978,-66.823192,14,7,7,14,0,"AL",0.038
"14414",465,"200402.285.1330.3","NMFS",2004,4,15,106,30,43.310163,-66.573688,6,3,3,6,0,"AL",0.038
"14415",465,"200402.286.1330.2","NMFS",2004,4,16,107,26.12,43.412543,-66.234683,31,13,18,26,5,"AL",0.038
"14416",465,"200402.287.1330.1","NMFS",2004,4,17,108,29.97,43.745095,-66.519107,14,5,9,14,0,"AL",0.038
"14417",465,"200402.288.1340.1","NMFS",2004,4,17,108,30.05,43.76199,-66.973313,2,2,0,2,0,"AL",0.038
"14418",465,"200402.289.1340.3","NMFS",2004,4,17,108,29.97,43.770055,-67.088938,6,6,0,6,0,"AL",0.038
"14419",465,"200402.290.1360.3","NMFS",2004,4,17,108,30,43.607372,-67.414538,2,2,0,2,0,"AL",0.038
"14420",465,"200402.291.1360.2","NMFS",2004,4,17,108,30.02,43.689703,-67.384145,3,3,0,3,0,"AL",0.038
"14421",511,"200402.292.1340.6","NMFS",2004,4,17,108,30.03,43.855133,-67.261268,1,1,0,1,0,"AL",0.038
"14422",466,"200402.293.1340.4","NMFS",2004,4,17,108,29.98,44.015122,-66.714877,5,2,3,5,0,"AL",0.038
"14423",466,"200402.294.1351.3","NMFS",2004,4,17,108,20.4,44.197998,-66.703922,2,1,1,2,0,"AL",0.038
"14424",511,"200402.295.1351.1","NMFS",2004,4,18,109,30,44.236068,-66.934423,7,5,2,7,0,"AL",0.038
"14425",467,"200402.296.1351.2","NMFS",2004,4,18,109,30.08,44.357448,-66.971973,7,3,4,7,0,"AL",0.038
"14426",511,"200402.297.1390.1","NMFS",2004,4,18,109,24.1,44.237935,-67.837822,1,1,0,1,0,"AL",0.038
"14427",511,"200402.298.1360.6","NMFS",2004,4,18,109,30.05,44.076477,-67.568573,1,1,0,1,0,"AL",0.038
"14428",512,"200402.299.1380.4","NMFS",2004,4,18,109,30.02,43.706572,-68.062137,1,0,1,1,0,"AL",0.038
"14429",512,"200402.300.1390.2","NMFS",2004,4,18,109,30.03,43.951218,-68.3512,6,5,1,6,0,"AL",0.038
"14430",512,"200402.301.1390.3","NMFS",2004,4,18,109,22.5,43.918737,-68.618055,8,5,3,8,0,"AL",0.038
"14431",512,"200402.302.1380.3","NMFS",2004,4,19,110,29.93,43.602575,-68.714918,1,0,1,1,0,"AL",0.038
"14432",513,"200402.303.1380.1","NMFS",2004,4,19,110,30.02,43.47114,-69.543883,1,1,0,1,0,"AL",0.038
"14433",513,"200402.304.1370.4","NMFS",2004,4,19,110,30.12,43.269985,-69.333735,1,1,0,1,0,"AL",0.038
"14434",513,"200402.305.1370.3","NMFS",2004,4,19,110,29.98,43.160217,-69.508222,10,10,0,10,0,"AL",0.038
"14435",513,"200402.306.1380.2","NMFS",2004,4,19,110,30.15,43.280972,-69.626668,4,4,0,4,0,"AL",0.038
"14436",513,"200402.307.1400.1","NMFS",2004,4,19,110,29.9,43.485002,-69.95019,1,1,0,1,0,"AL",0.038
"14437",513,"200402.308.1400.2","NMFS",2004,4,19,110,30.05,43.507023,-70.028463,3,1,2,3,0,"AL",0.038
"14438",513,"200402.309.1270.2","NMFS",2004,4,19,110,30.03,43.242608,-70.044968,5,4,1,5,0,"AL",0.038
"14439",513,"200402.310.1270.4","NMFS",2004,4,19,110,30.05,43.26172,-70.134267,4,1,3,4,0,"AL",0.038
"14440",513,"200402.311.1400.3","NMFS",2004,4,19,110,22.3,43.185982,-70.30626,6,2,4,6,0,"AL",0.038
"14441",513,"200402.312.3650.1","NMFS",2004,4,20,111,30,42.86142,-70.70544,20,10,10,16,4,"AL",0.038
"14442",513,"200402.313.1270.1","NMFS",2004,4,20,111,30.05,42.901015,-70.317453,1,0,1,1,0,"AL",0.038
"14443",513,"200402.314.1270.3","NMFS",2004,4,20,111,30.03,42.950938,-70.148002,3,3,0,3,0,"AL",0.038
"14444",513,"200402.315.1260.4","NMFS",2004,4,20,111,30.05,42.897828,-70.076198,1,1,0,1,0,"AL",0.038
"14445",514,"200402.316.1280.7","NMFS",2004,4,20,111,30.03,42.767347,-69.819085,0,0,0,0,0,"AL",0.038
"14446",514,"200402.317.1260.1","NMFS",2004,4,20,111,30.12,42.610528,-70.141427,0,0,0,0,0,"AL",0.038
"14447",514,"200402.318.1260.5","NMFS",2004,4,20,111,30.03,42.550368,-70.36176,5,2,3,5,0,"AL",0.038
"14448",514,"200402.319.1260.3","NMFS",2004,4,20,111,30.03,42.561848,-70.445005,2,2,0,2,0,"AL",0.038
"14449",514,"200402.320.3640.1","NMFS",2004,4,20,111,30.05,42.4441,-70.829458,6,4,2,6,0,"AL",0.038
"14450",514,"200402.321.3630.1","NMFS",2004,4,20,111,25.7,42.298717,-70.842245,13,8,5,9,4,"AL",0.038
"14451",514,"200402.322.3660.2","NMFS",2004,4,20,111,30.05,42.34099,-70.65812,6,4,2,6,0,"AL",0.038
"14452",514,"200402.323.1260.2","NMFS",2004,4,20,111,30.07,42.378557,-70.518953,3,0,3,3,0,"AL",0.038
"14453",514,"200402.324.3660.1","NMFS",2004,4,21,112,30,42.200703,-70.466432,7,3,4,7,0,"AL",0.038
"14454",514,"200402.325.3610.2","NMFS",2004,4,21,112,30.05,42.038247,-70.373488,26,5,21,24,2,"AL",0.038
"14455",514,"200402.326.3610.1","NMFS",2004,4,21,112,30.02,42.066068,-70.410285,12,5,7,9,3,"AL",0.038
"14456",514,"200402.327.3600.2","NMFS",2004,4,21,112,24.25,42.008372,-70.464568,13,12,1,12,1,"AL",0.038
"14457",514,"200402.328.3590.1","NMFS",2004,4,21,112,25.75,41.97209,-70.541157,36,19,17,33,3,"AL",0.038
"14458",514,"200402.329.3580.1","NMFS",2004,4,21,112,30.03,41.84732,-70.487697,16,3,13,12,4,"AL",0.038
"14459",514,"200402.330.3600.1","NMFS",2004,4,21,112,30.07,41.962422,-70.231888,9,2,7,9,0,"AL",0.038
"14460",526,"200407.159.1100.8","NMFS",2004,9,30,274,30.03,40.480768,-69.936015,1,0,1,1,0,"AL",0.038
"14461",521,"200407.164.3550.6","NMFS",2004,10,5,279,30.05,41.479188,-69.757073,3,3,0,3,0,"AL",0.038
"14462",521,"200407.165.3550.4","NMFS",2004,10,5,279,30.08,41.213397,-69.643017,2,1,1,2,0,"AL",0.038
"14463",526,"200407.167.3550.5","NMFS",2004,10,5,279,30.05,41.116117,-69.607885,7,7,0,7,0,"AL",0.038
"14464",526,"200407.168.1090.5","NMFS",2004,10,5,279,30.07,40.907462,-69.662745,1,1,0,1,0,"AL",0.038
"14465",526,"200407.169.1090.1","NMFS",2004,10,5,279,30,40.72891,-69.304877,0,0,0,0,0,"AL",0.038
"14466",526,"200407.170.1090.3","NMFS",2004,10,5,279,30.05,40.657452,-69.30603,0,0,0,0,0,"AL",0.038
"14467",526,"200407.171.1100.4","NMFS",2004,10,5,279,30,40.47465,-69.613745,0,0,0,0,0,"AL",0.038
"14468",526,"200407.172.1100.6","NMFS",2004,10,5,279,29.95,40.435385,-69.118157,0,0,0,0,0,"AL",0.038
"14469",526,"200407.173.1120.1","NMFS",2004,10,6,280,30.27,39.991333,-69.220998,3,1,2,3,0,"AL",0.038
"14470",526,"200407.174.1110.1","NMFS",2004,10,6,280,30.03,40.097577,-69.117963,0,0,0,0,0,"AL",0.038
"14471",526,"200407.175.1110.2","NMFS",2004,10,6,280,30.07,40.194698,-68.896665,0,0,0,0,0,"AL",0.038
"14472",525,"200407.176.1140.2","NMFS",2004,10,6,280,30.02,40.13729,-68.709067,1,0,1,1,0,"AL",0.038
"14473",525,"200407.177.1130.8","NMFS",2004,10,6,280,30.05,40.270588,-68.751307,0,0,0,0,0,"AL",0.038
"14474",525,"200407.178.1150.1","NMFS",2004,10,6,280,30.02,40.239542,-68.30115,1,0,1,1,0,"AL",0.038
"14475",525,"200407.179.1130.6","NMFS",2004,10,6,280,30.02,40.50252,-68.530182,1,0,1,1,0,"AL",0.038
"14476",525,"200407.180.1130.5","NMFS",2004,10,6,280,29.97,40.60305,-68.777442,1,0,1,1,0,"AL",0.038
"14477",526,"200407.181.1100.2","NMFS",2004,10,6,280,29.95,40.68757,-68.926325,0,0,0,0,0,"AL",0.038
"14478",525,"200407.182.1130.7","NMFS",2004,10,6,280,30.08,40.675237,-68.420852,1,1,0,1,0,"AL",0.038
"14479",525,"200407.183.1190.5","NMFS",2004,10,7,281,30.02,40.913418,-68.329523,0,0,0,0,0,"AL",0.038
"14480",525,"200407.184.1190.4","NMFS",2004,10,7,281,30.03,41.003705,-68.257817,0,0,0,0,0,"AL",0.038
"14481",525,"200407.185.1190.8","NMFS",2004,10,7,281,30.02,41.23335,-68.159972,1,1,0,1,0,"AL",0.038
"14482",525,"200407.186.1190.9","NMFS",2004,10,7,281,30.03,41.208867,-67.880525,1,1,0,1,0,"AL",0.038
"14483",525,"200407.187.1130.2","NMFS",2004,10,7,281,30.05,40.772293,-67.980778,3,3,0,3,0,"AL",0.038
"14484",525,"200407.188.1130.3","NMFS",2004,10,7,281,30.05,40.606875,-67.674918,1,1,0,1,0,"AL",0.038
"14485",525,"200407.189.1140.1","NMFS",2004,10,7,281,30.05,40.494458,-67.756722,0,0,0,0,0,"AL",0.038
"14486",525,"200407.190.1140.3","NMFS",2004,10,7,281,30,40.571288,-67.21721,1,1,0,1,0,"AL",0.038
"14487",525,"200407.191.1130.1","NMFS",2004,10,7,281,30.03,40.806337,-67.214873,0,0,0,0,0,"AL",0.038
"14488",525,"200407.192.1130.9","NMFS",2004,10,7,281,30,40.895162,-67.078733,0,0,0,0,0,"AL",0.038
"14489",562,"200407.193.1160.2","NMFS",2004,10,7,281,30.05,41.023925,-67.029037,1,1,0,1,0,"AL",0.038
"14490",562,"200407.194.1170.4","NMFS",2004,10,8,282,30.02,40.877018,-66.681408,0,0,0,0,0,"AL",0.038
"14491",562,"200407.195.1990.1","NMFS",2004,10,8,282,30.07,40.930995,-66.482515,0,0,0,0,0,"AL",0.038
"14492",562,"200407.196.1180.2","NMFS",2004,10,8,282,29.97,41.108542,-66.344267,1,1,0,1,0,"AL",0.038
"14493",562,"200407.197.1160.8","NMFS",2004,10,8,282,30.03,41.222677,-66.618822,0,0,0,0,0,"AL",0.038
"14494",562,"200407.198.1160.10","NMFS",2004,10,8,282,30.02,41.307378,-66.876165,0,0,0,0,0,"AL",0.038
"14495",562,"200407.199.1160.6","NMFS",2004,10,8,282,30.03,41.550257,-67.012865,1,1,0,1,0,"AL",0.038
"14496",552,"200407.200.1160.3","NMFS",2004,10,8,282,30.12,41.628688,-66.586598,1,1,0,1,0,"AL",0.038
"14497",552,"200407.201.1160.9","NMFS",2004,10,8,282,30.13,41.820103,-66.39119,0,0,0,0,0,"AL",0.038
"14498",552,"200407.202.1160.1","NMFS",2004,10,8,282,30.02,41.56108,-66.317395,0,0,0,0,0,"AL",0.038
"14499",552,"200407.203.1170.2","NMFS",2004,10,8,282,30.02,41.605558,-65.94315,3,1,2,3,0,"AL",0.038
"14500",552,"200407.204.1160.7","NMFS",2004,10,8,282,30,41.655097,-65.939933,0,0,0,0,0,"AL",0.038
"14501",552,"200407.205.1160.4","NMFS",2004,10,9,283,30.02,41.748948,-65.909018,1,1,0,1,0,"AL",0.038
"14502",552,"200407.206.1170.3","NMFS",2004,10,9,283,30.03,41.767253,-65.768937,0,0,0,0,0,"AL",0.038
"14503",551,"200407.207.1180.1","NMFS",2004,10,9,283,30.03,41.959943,-65.75025,0,0,0,0,0,"AL",0.038
"14504",551,"200407.208.1170.1","NMFS",2004,10,9,283,30.02,41.971295,-65.950668,0,0,0,0,0,"AL",0.038
"14505",551,"200407.209.1160.5","NMFS",2004,10,9,283,30.02,42.047955,-66.262852,1,1,0,1,0,"AL",0.038
"14506",551,"200407.210.1220.1","NMFS",2004,10,9,283,30.03,42.153427,-66.361973,4,2,2,4,0,"AL",0.038
"14507",551,"200407.211.1210.4","NMFS",2004,10,9,283,30.03,42.138737,-66.524112,0,0,0,0,0,"AL",0.038
"14508",464,"200407.212.1300.3","NMFS",2004,10,9,283,30.02,42.393277,-66.512427,0,0,0,0,0,"AL",0.038
"14509",464,"200407.213.1290.3","NMFS",2004,10,9,283,30.02,42.522812,-66.527838,2,1,1,2,0,"AL",0.038
"14510",464,"200407.214.1300.2","NMFS",2004,10,9,283,30.03,42.435095,-66.757892,0,0,0,0,0,"AL",0.038
"14511",551,"200407.215.1300.1","NMFS",2004,10,9,283,30.05,42.308957,-66.924365,2,1,1,2,0,"AL",0.038
"14512",551,"200407.216.1210.2","NMFS",2004,10,10,284,30.12,42.124132,-66.947927,2,2,0,2,0,"AL",0.038
"14513",561,"200407.217.1210.1","NMFS",2004,10,10,284,29.97,42.146318,-67.26594,0,0,0,0,0,"AL",0.038
"14514",561,"200407.218.1200.5","NMFS",2004,10,10,284,30,42.043268,-67.277017,2,2,0,2,0,"AL",0.038
"14515",561,"200407.219.1190.7","NMFS",2004,10,10,284,29.93,41.899045,-67.09754,0,0,0,0,0,"AL",0.038
"14516",561,"200407.220.1190.3","NMFS",2004,10,10,284,30.05,41.835805,-67.297318,18,17,1,18,0,"AL",0.038
"14517",562,"200407.221.1190.1","NMFS",2004,10,10,284,30.07,41.717857,-67.227285,10,8,2,10,0,"AL",0.038
"14518",562,"200407.222.1190.2","NMFS",2004,10,10,284,30.02,41.397528,-67.409405,2,2,0,2,0,"AL",0.038
"14519",522,"200407.224.1200.7","NMFS",2004,10,10,284,29.93,41.582178,-67.883158,0,0,0,0,0,"AL",0.038
"14520",522,"200407.225.1200.6","NMFS",2004,10,10,284,30.02,41.515123,-68.172873,7,4,3,7,0,"AL",0.038
"14521",522,"200407.226.1200.1","NMFS",2004,10,10,284,30.02,41.631283,-68.227538,3,2,1,3,0,"AL",0.038
"14522",522,"200407.227.1200.3","NMFS",2004,10,11,285,29.95,41.682553,-67.930828,2,2,0,2,0,"AL",0.038
"14523",562,"200407.228.1200.2","NMFS",2004,10,11,285,30.02,41.72566,-67.626702,0,0,0,0,0,"AL",0.038
"14524",522,"200407.229.1210.3","NMFS",2004,10,11,285,30.05,42.015845,-67.736838,1,1,0,1,0,"AL",0.038
"14525",561,"200407.230.1220.3","NMFS",2004,10,11,285,30,42.181085,-67.603603,1,1,0,1,0,"AL",0.038
"14526",522,"200407.231.1290.5","NMFS",2004,10,11,285,30.05,42.153517,-67.89259,5,5,0,5,0,"AL",0.038
"14527",522,"200407.232.1220.4","NMFS",2004,10,11,285,30.03,42.042345,-68.031328,0,0,0,0,0,"AL",0.038
"14528",514,"200407.233.3580.1","NMFS",2004,10,12,286,30.08,41.770455,-70.356273,13,5,8,13,0,"AL",0.038
"14529",514,"200407.234.3590.1","NMFS",2004,10,12,286,30,41.874732,-70.195903,5,2,3,4,1,"AL",0.038
"14530",514,"200407.235.3600.1","NMFS",2004,10,12,286,30.02,41.890602,-70.34217,2,1,1,2,0,"AL",0.038
"14531",514,"200407.236.3610.2","NMFS",2004,10,12,286,30,42.104725,-70.223275,0,0,0,0,0,"AL",0.038
"14532",521,"200407.237.1230.1","NMFS",2004,10,13,287,30.12,41.95843,-69.80665,0,0,0,0,0,"AL",0.038
"14533",521,"200407.238.1250.3","NMFS",2004,10,13,287,29.92,41.596143,-69.746857,19,11,8,19,0,"AL",0.038
"14534",521,"200407.239.1250.2","NMFS",2004,10,13,287,25.97,41.47093,-69.45481,11,5,6,11,0,"AL",0.038
"14535",521,"200407.240.1250.1","NMFS",2004,10,13,287,21.82,41.434065,-69.609408,1,1,0,1,0,"AL",0.038
"14536",521,"200407.241.3550.3","NMFS",2004,10,13,287,30.08,41.38271,-69.579193,10,8,2,10,0,"AL",0.038
"14537",521,"200407.242.1250.4","NMFS",2004,10,13,287,30,41.070337,-69.383807,1,0,1,1,0,"AL",0.038
"14538",521,"200407.243.1230.3","NMFS",2004,10,13,287,30,41.100288,-69.12214,0,0,0,0,0,"AL",0.038
"14539",521,"200407.244.1230.5","NMFS",2004,10,13,287,29.98,41.020678,-68.875927,5,5,0,5,0,"AL",0.038
"14540",522,"200407.245.1230.4","NMFS",2004,10,13,287,30.03,41.076862,-68.752832,0,0,0,0,0,"AL",0.038
"14541",525,"200407.246.1130.4","NMFS",2004,10,14,288,30.05,40.963142,-68.735897,1,1,0,1,0,"AL",0.038
"14542",522,"200407.247.1190.6","NMFS",2004,10,14,288,30.03,41.09815,-68.59071,1,1,0,1,0,"AL",0.038
"14543",522,"200407.248.1230.2","NMFS",2004,10,14,288,30.02,41.256413,-68.588173,5,5,0,5,0,"AL",0.038
"14544",521,"200407.249.1240.3","NMFS",2004,10,14,288,29.95,41.42159,-68.860797,0,0,0,0,0,"AL",0.038
"14545",522,"200407.250.1240.5","NMFS",2004,10,14,288,30.02,41.604648,-68.778988,0,0,0,0,0,"AL",0.038
"14546",522,"200407.251.1220.2","NMFS",2004,10,14,288,30.03,41.726658,-68.41419,0,0,0,0,0,"AL",0.038
"14547",522,"200407.252.1290.8","NMFS",2004,10,14,288,30.02,41.877508,-68.321233,1,1,0,1,0,"AL",0.038
"14548",522,"200407.253.1240.4","NMFS",2004,10,14,288,30.03,41.935058,-68.741507,0,0,0,0,0,"AL",0.038
"14549",521,"200407.254.1240.1","NMFS",2004,10,14,288,30.03,41.885143,-69.110007,0,0,0,0,0,"AL",0.038
"14550",521,"200407.255.1280.5","NMFS",2004,10,14,288,30.03,41.901983,-69.27823,0,0,0,0,0,"AL",0.038
"14551",521,"200407.256.1280.1","NMFS",2004,10,15,289,30.07,42.036317,-69.4193,0,0,0,0,0,"AL",0.038
"14552",521,"200407.257.1240.6","NMFS",2004,10,15,289,30.02,41.738408,-69.360597,0,0,0,0,0,"AL",0.038
"14553",515,"200407.258.1290.1","NMFS",2004,10,19,293,29.93,42.69251,-68.417308,0,0,0,0,0,"AL",0.038
"14554",515,"200407.259.1290.4","NMFS",2004,10,19,293,29.98,42.355657,-68.016865,0,0,0,0,0,"AL",0.038
"14555",515,"200407.260.1290.7","NMFS",2004,10,19,293,30.02,42.60592,-67.948103,0,0,0,0,0,"AL",0.038
"14556",515,"200407.261.1290.6","NMFS",2004,10,19,293,30.05,42.683437,-67.914363,0,0,0,0,0,"AL",0.038
"14557",515,"200407.262.1360.5","NMFS",2004,10,19,293,29.97,43.099918,-68.01191,0,0,0,0,0,"AL",0.038
"14558",465,"200407.263.1360.8","NMFS",2004,10,19,293,30.08,43.18521,-67.343578,0,0,0,0,0,"AL",0.038
"14559",465,"200407.264.1360.4","NMFS",2004,10,20,294,29.98,43.057687,-67.248655,0,0,0,0,0,"AL",0.038
"14560",464,"200407.265.1360.2","NMFS",2004,10,20,294,30,42.816407,-67.217605,1,1,0,1,0,"AL",0.038
"14561",464,"200407.266.1290.2","NMFS",2004,10,20,294,30.02,42.731367,-67.176315,0,0,0,0,0,"AL",0.038
"14562",465,"200407.267.1340.6","NMFS",2004,10,20,294,30.02,43.059965,-66.915978,1,0,1,1,0,"AL",0.038
"14563",465,"200407.268.1360.6","NMFS",2004,10,20,294,30,43.351482,-66.988375,0,0,0,0,0,"AL",0.038
"14564",465,"200407.269.1340.4","NMFS",2004,10,20,294,30.02,43.558527,-66.84904,0,0,0,0,0,"AL",0.038
"14565",465,"200407.270.1340.1","NMFS",2004,10,20,294,30.07,43.610428,-66.652017,0,0,0,0,0,"AL",0.038
"14566",465,"200407.271.1340.3","NMFS",2004,10,20,294,30.07,43.530148,-66.64919,0,0,0,0,0,"AL",0.038
"14567",465,"200407.273.1330.4","NMFS",2004,10,20,294,29.97,43.374988,-66.269705,55,33,22,47,8,"AL",0.038
"14568",465,"200407.274.1330.3","NMFS",2004,10,21,295,30.07,43.533547,-66.286223,156,68,88,153,3,"AL",0.038
"14569",465,"200407.275.1330.2","NMFS",2004,10,21,295,30.45,43.697207,-66.469255,14,5,9,14,0,"AL",0.038
"14570",465,"200407.276.1340.2","NMFS",2004,10,21,295,30,43.792357,-67.013158,0,0,0,0,0,"AL",0.038
"14571",511,"200407.277.1340.5","NMFS",2004,10,21,295,30.03,43.857945,-66.951303,0,0,0,0,0,"AL",0.038
"14572",511,"200407.278.1351.1","NMFS",2004,10,21,295,27.42,44.205765,-66.935257,2,0,2,2,0,"AL",0.038
"14573",511,"200407.279.1351.2","NMFS",2004,10,21,295,30.07,44.313643,-67.254555,0,0,0,0,0,"AL",0.038
"14574",511,"200407.280.1360.3","NMFS",2004,10,21,295,30.1,44.197562,-67.3032,0,0,0,0,0,"AL",0.038
"14575",512,"200407.281.1390.3","NMFS",2004,10,22,296,26.77,44.238062,-67.896387,72,31,41,63,9,"AL",0.038
"14576",511,"200407.282.1380.1","NMFS",2004,10,22,296,30.05,44.024505,-67.707478,0,0,0,0,0,"AL",0.038
"14577",465,"200407.283.1360.1","NMFS",2004,10,22,296,30.03,43.507668,-67.618623,0,0,0,0,0,"AL",0.038
"14578",512,"200407.284.1360.7","NMFS",2004,10,22,296,29.97,43.630098,-68.002185,0,0,0,0,0,"AL",0.038
"14579",512,"200407.285.1390.2","NMFS",2004,10,22,296,30.02,43.919487,-68.420168,0,0,0,0,0,"AL",0.038
"14580",512,"200407.286.1390.1","NMFS",2004,10,22,296,30.05,43.927917,-68.800282,214,89,125,205,9,"AL",0.038
"14581",512,"200407.287.1380.4","NMFS",2004,10,23,297,30,43.398405,-68.582278,0,0,0,0,0,"AL",0.038
"14582",515,"200407.288.1370.4","NMFS",2004,10,23,297,29.97,43.181235,-68.589172,0,0,0,0,0,"AL",0.038
"14583",515,"200407.289.1370.2","NMFS",2004,10,23,297,30.03,43.177038,-68.77098,0,0,0,0,0,"AL",0.038
"14584",513,"200407.290.1380.3","NMFS",2004,10,23,297,30.02,43.426623,-69.24736,0,0,0,0,0,"AL",0.038
"14585",513,"200407.294.1380.2","NMFS",2004,10,24,298,29.98,43.367512,-69.675542,0,0,0,0,0,"AL",0.038
"14586",513,"200407.295.1370.3","NMFS",2004,10,24,298,30.12,43.105373,-69.474472,0,0,0,0,0,"AL",0.038
"14587",513,"200407.296.1270.3","NMFS",2004,10,24,298,29.95,43.252495,-70.050385,0,0,0,0,0,"AL",0.038
"14588",513,"200407.297.1400.1","NMFS",2004,10,24,298,29.97,43.233373,-70.252982,6,2,4,6,0,"AL",0.038
"14589",513,"200407.298.1260.2","NMFS",2004,10,24,298,30.08,43.008102,-70.03604,2,1,1,2,0,"AL",0.038
"14590",513,"200407.299.1270.4","NMFS",2004,10,24,298,30,42.981307,-70.19532,0,0,0,0,0,"AL",0.038
"14591",513,"200407.300.1270.2","NMFS",2004,10,24,298,30.05,42.883743,-70.057187,0,0,0,0,0,"AL",0.038
"14592",514,"200407.301.1270.1","NMFS",2004,10,25,299,30.27,42.824918,-70.017922,0,0,0,0,0,"AL",0.038
"14593",513,"200407.302.1280.4","NMFS",2004,10,25,299,30.12,42.851767,-69.840943,0,0,0,0,0,"AL",0.038
"14594",514,"200407.303.1260.1","NMFS",2004,10,25,299,30,42.772117,-70.26845,0,0,0,0,0,"AL",0.038
"14595",514,"200407.304.3660.1","NMFS",2004,10,25,299,30.02,42.739168,-70.589527,22,11,11,22,0,"AL",0.038
"14596",514,"200407.305.3660.2","NMFS",2004,10,25,299,30,42.483915,-70.647647,9,4,5,9,0,"AL",0.038
"14597",514,"200407.307.3610.1","NMFS",2004,10,25,299,30.08,42.03952,-70.468953,43,30,13,39,4,"AL",0.038
"14598",514,"200407.308.3600.2","NMFS",2004,10,26,300,29.98,41.9602,-70.428037,38,22,16,34,4,"AL",0.038
"14599",514,"200407.309.1260.3","NMFS",2004,10,26,300,32.65,42.393038,-70.334598,0,0,0,0,0,"AL",0.038
"14600",514,"200407.310.1260.4","NMFS",2004,10,26,300,30.02,42.584752,-70.19857,0,0,0,0,0,"AL",0.038
"14601",514,"200407.311.1260.5","NMFS",2004,10,26,300,29.97,42.52737,-70.076263,1,0,1,1,0,"AL",0.038
"14602",521,"200407.312.1280.2","NMFS",2004,10,26,300,29.98,42.300132,-69.809757,1,0,1,1,0,"AL",0.038
"14603",521,"200407.313.1280.3","NMFS",2004,10,26,300,30.03,42.1948,-69.60087,0,0,0,0,0,"AL",0.038
"14604",521,"200407.314.1280.6","NMFS",2004,10,26,300,30.07,42.217373,-69.52143,0,0,0,0,0,"AL",0.038
"14605",515,"200407.315.1280.7","NMFS",2004,10,26,300,29.95,42.476412,-69.160502,0,0,0,0,0,"AL",0.038
"14606",515,"200407.316.1370.1","NMFS",2004,10,27,301,30,42.654187,-69.11285,0,0,0,0,0,"AL",0.038
"14607",515,"200407.317.1370.5","NMFS",2004,10,27,301,30.57,42.696732,-68.948968,0,0,0,0,0,"AL",0.038
"14608",522,"200407.318.1240.2","NMFS",2004,10,27,301,30.02,42.23294,-68.678928,0,0,0,0,0,"AL",0.038
"14609",521,"200407.319.3560.1","NMFS",2004,10,27,301,25.32,41.9948,-69.984777,3,3,0,3,0,"AL",0.038
"14610",526,"200503.174.1090.5","NMFS",2005,3,30,89,30.02,40.691483,-69.965057,0,0,0,0,0,"AL",0.038
"14611",526,"200503.175.1100.4","NMFS",2005,3,30,89,30.02,40.513475,-69.807143,0,0,0,0,0,"AL",0.038
"14612",526,"200503.176.1100.1","NMFS",2005,3,30,89,29.97,40.2179,-69.706113,0,0,0,0,0,"AL",0.038
"14613",526,"200503.177.1100.5","NMFS",2005,3,30,89,29.93,40.250522,-69.94494,0,0,0,0,0,"AL",0.038
"14614",526,"200503.180.1120.1","NMFS",2005,3,31,90,30,39.920158,-69.558207,0,0,0,0,0,"AL",0.038
"14615",526,"200503.181.1110.2","NMFS",2005,3,31,90,30.05,40.011553,-69.263893,0,0,0,0,0,"AL",0.038
"14616",526,"200503.182.1100.3","NMFS",2005,3,31,90,29.95,40.262935,-69.520345,0,0,0,0,0,"AL",0.038
"14617",526,"200503.183.1100.2","NMFS",2005,3,31,90,30.1,40.469578,-69.328562,0,0,0,0,0,"AL",0.038
"14618",526,"200503.184.1100.7","NMFS",2005,3,31,90,30.02,40.601938,-69.555908,0,0,0,0,0,"AL",0.038
"14619",526,"200503.186.1100.9","NMFS",2005,3,31,90,30.03,40.677947,-69.200292,0,0,0,0,0,"AL",0.038
"14620",526,"200503.187.3550.1","NMFS",2005,3,31,90,29.95,40.940057,-69.508907,0,0,0,0,0,"AL",0.038
"14621",526,"200503.188.3550.3","NMFS",2005,4,1,91,29.98,41.03594,-69.599282,0,0,0,0,0,"AL",0.038
"14622",526,"200503.189.3550.4","NMFS",2005,4,1,91,30,40.970483,-69.497797,0,0,0,0,0,"AL",0.038
"14623",526,"200503.190.1090.4","NMFS",2005,4,1,91,30.02,40.9794,-69.326423,9,5,4,3,6,"AL",0.038
"14624",521,"200503.191.1250.1","NMFS",2005,4,1,91,30.03,41.036898,-69.225612,3,0,3,3,0,"AL",0.038
"14625",526,"200503.192.1130.1","NMFS",2005,4,1,91,30.02,40.944938,-68.843157,1,1,0,1,0,"AL",0.038
"14626",522,"200503.193.1190.1","NMFS",2005,4,1,91,30.03,41.082035,-68.422012,0,0,0,0,0,"AL",0.038
"14627",525,"200503.194.1190.7","NMFS",2005,4,1,91,30.03,41.028502,-68.207337,0,0,0,0,0,"AL",0.038
"14628",525,"200503.195.1190.2","NMFS",2005,4,1,91,30.05,40.723203,-68.488735,0,0,0,0,0,"AL",0.038
"14629",525,"200503.196.1130.2","NMFS",2005,4,1,91,30.02,40.569783,-68.481413,0,0,0,0,0,"AL",0.038
"14630",525,"200503.197.1140.3","NMFS",2005,4,1,91,30.02,40.294028,-68.361975,0,0,0,0,0,"AL",0.038
"14631",525,"200503.198.1130.6","NMFS",2005,4,2,92,30,40.518708,-68.199052,0,0,0,0,0,"AL",0.038
"14632",525,"200503.199.1130.4","NMFS",2005,4,2,92,30.07,40.5188,-68.051487,0,0,0,0,0,"AL",0.038
"14633",525,"200503.200.1140.1","NMFS",2005,4,2,92,30.02,40.401585,-68.020658,1,1,0,1,0,"AL",0.038
"14634",525,"200503.201.1150.1","NMFS",2005,4,2,92,30,40.407752,-67.481403,0,0,0,0,0,"AL",0.038
"14635",525,"200503.202.1990.1","NMFS",2005,4,2,92,29.98,40.42995,-67.317893,6,6,0,6,0,"AL",0.038
"14636",525,"200503.203.1140.2","NMFS",2005,4,2,92,30,40.56148,-67.151698,0,0,0,0,0,"AL",0.038
"14637",525,"200503.204.1130.9","NMFS",2005,4,2,92,30.02,40.777982,-67.279548,0,0,0,0,0,"AL",0.038
"14638",525,"200503.205.1130.8","NMFS",2005,4,2,92,30.05,40.644923,-67.380298,0,0,0,0,0,"AL",0.038
"14639",525,"200503.206.1130.3","NMFS",2005,4,2,92,30.05,40.725495,-67.536025,0,0,0,0,0,"AL",0.038
"14640",525,"200503.207.1130.7","NMFS",2005,4,3,93,30,40.891038,-67.745017,0,0,0,0,0,"AL",0.038
"14641",525,"200503.208.1190.3","NMFS",2005,4,3,93,29.92,41.149892,-67.95067,0,0,0,0,0,"AL",0.038
"14642",522,"200503.209.1190.8","NMFS",2005,4,3,93,30.03,41.351913,-67.960122,0,0,0,0,0,"AL",0.038
"14643",562,"200503.210.1190.4","NMFS",2005,4,3,93,29.98,41.56912,-67.520417,0,0,0,0,0,"AL",0.038
"14644",562,"200503.211.1190.6","NMFS",2005,4,4,94,30.02,41.470065,-67.204872,0,0,0,0,0,"AL",0.038
"14645",562,"200503.212.1190.9","NMFS",2005,4,4,94,30.02,41.326852,-67.242413,0,0,0,0,0,"AL",0.038
"14646",525,"200503.213.1160.4","NMFS",2005,4,4,94,29.95,41.146618,-67.246627,0,0,0,0,0,"AL",0.038
"14647",525,"200503.214.1190.5","NMFS",2005,4,4,94,30.02,41.151637,-67.477352,0,0,0,0,0,"AL",0.038
"14648",525,"200503.215.1130.5","NMFS",2005,4,4,94,29.98,40.972175,-67.370503,0,0,0,0,0,"AL",0.038
"14649",562,"200503.216.1160.3","NMFS",2005,4,4,94,30.1,40.975773,-66.994462,0,0,0,0,0,"AL",0.038
"14650",562,"200503.217.1160.5","NMFS",2005,4,4,94,30.08,40.989217,-66.719297,0,0,0,0,0,"AL",0.038
"14651",562,"200503.218.1170.3","NMFS",2005,4,5,95,30,40.852988,-66.72378,0,0,0,0,0,"AL",0.038
"14652",562,"200503.219.1180.2","NMFS",2005,4,5,95,30,40.938882,-66.504208,14,13,1,14,0,"AL",0.038
"14653",562,"200503.220.1160.1","NMFS",2005,4,5,95,29.98,41.19047,-66.666173,0,0,0,0,0,"AL",0.038
"14654",562,"200503.221.1160.7","NMFS",2005,4,5,95,29.97,41.151307,-66.703547,0,0,0,0,0,"AL",0.038
"14655",562,"200503.222.1160.2","NMFS",2005,4,5,95,29.98,41.183525,-66.915515,0,0,0,0,0,"AL",0.038
"14656",552,"200503.223.1160.6","NMFS",2005,4,5,95,30.02,41.47702,-66.48875,0,0,0,0,0,"AL",0.038
"14657",552,"200503.224.1170.2","NMFS",2005,4,5,95,30.02,41.563057,-66.032002,0,0,0,0,0,"AL",0.038
"14658",552,"200503.225.1160.9","NMFS",2005,4,5,95,30.03,41.68468,-66.04792,0,0,0,0,0,"AL",0.038
"14659",551,"200503.226.1160.10","NMFS",2005,4,6,96,30.02,41.893602,-66.12835,0,0,0,0,0,"AL",0.038
"14660",551,"200503.227.1170.1","NMFS",2005,4,6,96,30,41.934978,-65.877197,7,4,3,7,0,"AL",0.038
"14661",551,"200503.229.1290.7","NMFS",2005,4,6,96,30.05,42.234057,-66.018303,3,3,0,3,0,"AL",0.038
"14662",464,"200503.230.1300.2","NMFS",2005,4,6,96,30,42.405092,-66.728487,9,9,0,9,0,"AL",0.038
"14663",464,"200503.231.1300.3","NMFS",2005,4,6,96,30.05,42.433728,-66.843557,10,6,4,10,0,"AL",0.038
"14664",551,"200503.232.1220.1","NMFS",2005,4,6,96,30.02,42.187662,-67.0815,10,9,1,10,0,"AL",0.038
"14665",551,"200503.233.1210.1","NMFS",2005,4,6,96,30.05,42.110093,-67.052222,0,0,0,0,0,"AL",0.038
"14666",551,"200503.234.1210.4","NMFS",2005,4,6,96,30,42.113332,-66.790847,0,0,0,0,0,"AL",0.038
"14667",551,"200503.235.1160.8","NMFS",2005,4,7,97,29.97,41.898938,-66.734618,0,0,0,0,0,"AL",0.038
"14668",561,"200503.236.1200.1","NMFS",2005,4,7,97,30.02,41.88512,-67.372798,0,0,0,0,0,"AL",0.038
"14669",561,"200503.237.1200.2","NMFS",2005,4,7,97,30.02,41.844318,-67.583932,1,1,0,1,0,"AL",0.038
"14670",522,"200503.238.1200.5","NMFS",2005,4,7,97,30.02,41.779528,-67.689808,0,0,0,0,0,"AL",0.038
"14671",522,"200503.239.1200.6","NMFS",2005,4,7,97,30.03,41.724335,-67.679558,0,0,0,0,0,"AL",0.038
"14672",522,"200503.240.1200.4","NMFS",2005,4,7,97,29.92,41.73327,-67.835933,0,0,0,0,0,"AL",0.038
"14673",522,"200503.241.1200.3","NMFS",2005,4,7,97,30.03,41.587697,-68.369948,0,0,0,0,0,"AL",0.038
"14674",522,"200503.242.1230.5","NMFS",2005,4,7,97,30.02,41.51496,-68.470322,0,0,0,0,0,"AL",0.038
"14675",522,"200503.243.1230.4","NMFS",2005,4,7,97,30.02,41.482028,-68.479592,0,0,0,0,0,"AL",0.038
"14676",521,"200503.244.1240.2","NMFS",2005,4,8,98,30,41.316962,-68.87109,0,0,0,0,0,"AL",0.038
"14677",521,"200503.245.1240.5","NMFS",2005,4,12,102,30.03,41.643502,-68.845877,1,1,0,1,0,"AL",0.038
"14678",521,"200503.246.1240.3","NMFS",2005,4,12,102,30.02,41.72745,-68.908297,0,0,0,0,0,"AL",0.038
"14679",521,"200503.247.1240.6","NMFS",2005,4,12,102,30.05,41.853392,-69.10748,0,0,0,0,0,"AL",0.038
"14680",522,"200503.248.1240.4","NMFS",2005,4,12,102,30.1,41.976715,-68.798835,0,0,0,0,0,"AL",0.038
"14681",522,"200503.249.1240.1","NMFS",2005,4,12,102,30,42.025592,-68.475473,0,0,0,0,0,"AL",0.038
"14682",522,"200503.250.1220.4","NMFS",2005,4,12,102,30.03,41.777182,-68.382007,0,0,0,0,0,"AL",0.038
"14683",522,"200503.251.1210.2","NMFS",2005,4,12,102,30.03,41.76652,-68.277413,0,0,0,0,0,"AL",0.038
"14684",522,"200503.252.1210.3","NMFS",2005,4,12,102,30.05,41.814432,-68.112312,0,0,0,0,0,"AL",0.038
"14685",522,"200503.253.1290.8","NMFS",2005,4,13,103,30.02,42.187527,-67.8506,3,3,0,3,0,"AL",0.038
"14686",522,"200503.254.1220.2","NMFS",2005,4,13,103,30,42.146453,-67.746213,2,2,0,2,0,"AL",0.038
"14687",561,"200503.255.1220.3","NMFS",2005,4,13,103,30.02,42.181062,-67.637728,8,6,2,8,0,"AL",0.038
"14688",464,"200503.256.1300.1","NMFS",2005,4,13,103,20.15,42.396147,-67.466103,2,2,0,2,0,"AL",0.038
"14689",464,"200503.257.1290.6","NMFS",2005,4,13,103,30.02,42.346832,-67.64281,2,1,1,2,0,"AL",0.038
"14690",515,"200503.258.1290.3","NMFS",2005,4,13,103,30,42.416967,-67.676767,0,0,0,0,0,"AL",0.038
"14691",515,"200503.259.1290.1","NMFS",2005,4,13,103,30.02,42.685828,-67.759492,1,1,0,1,0,"AL",0.038
"14692",464,"200503.260.1290.5","NMFS",2005,4,13,103,30.03,42.609282,-67.508725,3,2,1,3,0,"AL",0.038
"14693",464,"200503.261.1290.2","NMFS",2005,4,13,103,30.02,42.590333,-67.475102,0,0,0,0,0,"AL",0.038
"14694",464,"200503.262.1290.4","NMFS",2005,4,14,104,30,42.73595,-67.252092,1,0,1,1,0,"AL",0.038
"14695",464,"200503.263.1360.1","NMFS",2005,4,14,104,30,42.816243,-67.180412,2,2,0,2,0,"AL",0.038
"14696",464,"200503.264.1340.4","NMFS",2005,4,14,104,29.97,42.928835,-66.880522,3,3,0,3,0,"AL",0.038
"14697",465,"200503.265.1330.1","NMFS",2005,4,14,104,30.07,43.276795,-66.491598,2,1,1,2,0,"AL",0.038
"14698",465,"200503.266.1330.4","NMFS",2005,4,14,104,30.02,43.279105,-66.447662,0,0,0,0,0,"AL",0.038
"14699",465,"200503.267.1340.2","NMFS",2005,4,14,104,30,43.34965,-66.69616,4,1,3,4,0,"AL",0.038
"14700",465,"200503.268.1330.2","NMFS",2005,4,14,104,29.98,43.485897,-66.51793,9,5,4,9,0,"AL",0.038
"14701",465,"200503.269.1330.3","NMFS",2005,4,14,104,29.98,43.7503,-66.492247,10,6,4,10,0,"AL",0.038
"14702",465,"200503.270.1340.1","NMFS",2005,4,14,104,30.07,43.551015,-66.815855,1,1,0,1,0,"AL",0.038
"14703",465,"200503.271.1360.6","NMFS",2005,4,14,104,29.98,43.477837,-66.940547,1,0,1,1,0,"AL",0.038
"14704",465,"200503.272.1340.6","NMFS",2005,4,15,105,30.07,43.602437,-66.980972,3,2,1,3,0,"AL",0.038
"14705",511,"200503.273.1340.5","NMFS",2005,4,15,105,30,43.905777,-67.32753,1,1,0,1,0,"AL",0.038
"14706",511,"200503.274.1340.3","NMFS",2005,4,15,105,29.97,44.062457,-67.284135,4,4,0,4,0,"AL",0.038
"14707",511,"200503.275.1351.1","NMFS",2005,4,15,105,30,44.21952,-67.0148,4,4,0,4,0,"AL",0.038
"14708",511,"200503.276.1351.2","NMFS",2005,4,15,105,30,44.358295,-67.120777,5,3,2,5,0,"AL",0.038
"14709",511,"200503.277.1390.2","NMFS",2005,4,15,105,30.03,44.316172,-67.511137,12,7,5,12,0,"AL",0.038
"14710",511,"200503.278.1360.4","NMFS",2005,4,15,105,30.05,44.20058,-67.442553,1,0,1,1,0,"AL",0.038
"14711",512,"200503.279.1390.3","NMFS",2005,4,15,105,30,44.1602,-67.886127,3,1,2,3,0,"AL",0.038
"14712",512,"200503.280.1390.1","NMFS",2005,4,15,105,30.05,44.008733,-68.258957,9,5,4,9,0,"AL",0.038
"14713",512,"200503.281.1380.4","NMFS",2005,4,15,105,30,43.93642,-67.969427,5,2,3,5,0,"AL",0.038
"14714",465,"200503.282.1360.8","NMFS",2005,4,16,106,29.97,43.730407,-67.646253,3,2,1,3,0,"AL",0.038
"14715",465,"200503.283.1360.2","NMFS",2005,4,16,106,30,43.357295,-67.47818,0,0,0,0,0,"AL",0.038
"14716",515,"200503.284.1360.7","NMFS",2005,4,16,106,30.02,43.309143,-67.813568,5,5,0,5,0,"AL",0.038
"14717",512,"200503.285.1360.5","NMFS",2005,4,16,106,30.05,43.34884,-68.14576,1,0,1,1,0,"AL",0.038
"14718",512,"200503.286.1360.3","NMFS",2005,4,16,106,30,43.492022,-68.132957,0,0,0,0,0,"AL",0.038
"14719",512,"200503.287.1380.3","NMFS",2005,4,16,106,30.03,43.655162,-68.377747,1,0,1,1,0,"AL",0.038
"14720",512,"200503.288.1380.1","NMFS",2005,4,16,106,30,43.723308,-68.639548,0,0,0,0,0,"AL",0.038
"14721",513,"200503.289.1380.5","NMFS",2005,4,17,107,30.08,43.625273,-69.447205,2,2,0,2,0,"AL",0.038
"14722",513,"200503.290.1380.2","NMFS",2005,4,17,107,30.02,43.307685,-69.510992,0,0,0,0,0,"AL",0.038
"14723",515,"200503.291.1370.1","NMFS",2005,4,17,107,29.98,43.186072,-68.979797,2,2,0,2,0,"AL",0.038
"14724",515,"200503.292.1370.4","NMFS",2005,4,17,107,30,42.925803,-68.615815,2,2,0,2,0,"AL",0.038
"14725",515,"200503.293.1370.5","NMFS",2005,4,17,107,30,42.896657,-68.723338,2,2,0,2,0,"AL",0.038
"14726",515,"200503.294.1370.2","NMFS",2005,4,17,107,29.97,42.811977,-69.065582,0,0,0,0,0,"AL",0.038
"14727",515,"200503.295.1370.3","NMFS",2005,4,17,107,30.02,42.900342,-69.162413,0,0,0,0,0,"AL",0.038
"14728",515,"200503.296.1280.6","NMFS",2005,4,17,107,30,42.654293,-69.335143,0,0,0,0,0,"AL",0.038
"14729",515,"200503.297.1280.2","NMFS",2005,4,18,108,29.98,42.526328,-69.467908,1,0,1,1,0,"AL",0.038
"14730",515,"200503.298.1280.3","NMFS",2005,4,18,108,30.08,42.681885,-69.61422,1,0,1,1,0,"AL",0.038
"14731",514,"200503.299.1280.1","NMFS",2005,4,18,108,30,42.822748,-69.745323,0,0,0,0,0,"AL",0.038
"14732",513,"200503.300.1280.5","NMFS",2005,4,18,108,30.1,42.88686,-69.748665,2,2,0,2,0,"AL",0.038
"14733",513,"200503.301.1270.3","NMFS",2005,4,18,108,30,43.182158,-70.09854,1,1,0,1,0,"AL",0.038
"14734",513,"200503.302.1270.4","NMFS",2005,4,18,108,30.03,43.30463,-70.133742,1,1,0,1,0,"AL",0.038
"14735",513,"200503.303.1270.5","NMFS",2005,4,18,108,30,43.364032,-70.10347,3,3,0,3,0,"AL",0.038
"14736",513,"200503.304.1400.1","NMFS",2005,4,18,108,30.02,43.068862,-70.368013,3,3,0,3,0,"AL",0.038
"14737",513,"200503.305.1270.1","NMFS",2005,4,18,108,29.98,42.978353,-70.37622,10,8,2,10,0,"AL",0.038
"14738",514,"200503.306.1400.2","NMFS",2005,4,18,108,30,42.818993,-70.58089,6,3,3,6,0,"AL",0.038
"14739",514,"200503.307.3630.1","NMFS",2005,4,18,108,29.98,42.713498,-70.733397,4,1,3,4,0,"AL",0.038
"14740",514,"200503.308.3660.2","NMFS",2005,4,19,109,30,42.673112,-70.447217,5,3,2,5,0,"AL",0.038
"14741",514,"200503.309.1260.4","NMFS",2005,4,19,109,29.98,42.71807,-70.334463,0,0,0,0,0,"AL",0.038
"14742",514,"200503.310.1260.1","NMFS",2005,4,19,109,30,42.69774,-70.203375,1,1,0,1,0,"AL",0.038
"14743",514,"200503.311.1260.5","NMFS",2005,4,19,109,30.02,42.487922,-70.116358,0,0,0,0,0,"AL",0.038
"14744",514,"200503.312.1260.2","NMFS",2005,4,19,109,30,42.48522,-70.610163,6,2,4,6,0,"AL",0.038
"14745",514,"200503.313.3660.1","NMFS",2005,4,19,109,30,42.477917,-70.734067,4,1,3,4,0,"AL",0.038
"14746",514,"200503.314.3640.1","NMFS",2005,4,19,109,30.03,42.330562,-70.757977,9,6,3,9,0,"AL",0.038
"14747",514,"200503.315.3650.1","NMFS",2005,4,19,109,30.03,42.24029,-70.59404,3,1,2,3,0,"AL",0.038
"14748",514,"200503.317.3600.2","NMFS",2005,4,19,109,29.98,42.151585,-70.5311,5,4,1,5,0,"AL",0.038
"14749",514,"200503.318.3600.1","NMFS",2005,4,19,109,30,41.912613,-70.382288,10,7,3,9,1,"AL",0.038
"14750",514,"200503.319.3580.1","NMFS",2005,4,20,110,29.97,41.77427,-70.370908,1,0,1,1,0,"AL",0.038
"14751",514,"200503.320.3590.1","NMFS",2005,4,20,110,30,41.851205,-70.254197,1,0,1,1,0,"AL",0.038
"14752",514,"200503.321.3610.2","NMFS",2005,4,20,110,29.98,42.100722,-70.247133,0,0,0,0,0,"AL",0.038
"14753",514,"200503.322.1260.3","NMFS",2005,4,20,110,30,42.196928,-70.20222,0,0,0,0,0,"AL",0.038
"14754",514,"200503.323.3610.1","NMFS",2005,4,20,110,29.98,42.105245,-70.156938,1,0,1,1,0,"AL",0.038
"14755",521,"200503.324.1270.2","NMFS",2005,4,20,110,30,42.1085,-69.856717,4,4,0,4,0,"AL",0.038
"14756",521,"200503.325.1280.4","NMFS",2005,4,20,110,29.98,42.107035,-69.633055,1,1,0,1,0,"AL",0.038
"14757",521,"200503.326.1280.7","NMFS",2005,4,20,110,30,42.1091,-69.251972,0,0,0,0,0,"AL",0.038
"14758",521,"200503.327.3560.1","NMFS",2005,4,20,110,30.02,41.954772,-69.95397,0,0,0,0,0,"AL",0.038
"14759",521,"200503.329.3550.2","NMFS",2005,4,20,110,30.03,41.545652,-69.722883,0,0,0,0,0,"AL",0.038
"14760",521,"200503.330.1250.3","NMFS",2005,4,20,110,30,41.480373,-69.568802,6,4,2,6,0,"AL",0.038
"14761",521,"200503.331.1230.3","NMFS",2005,4,21,111,29.93,41.57356,-69.436805,2,1,1,2,0,"AL",0.038
"14762",521,"200503.332.1230.1","NMFS",2005,4,21,111,30.02,41.400345,-69.28103,0,0,0,0,0,"AL",0.038
"14763",521,"200503.333.1230.2","NMFS",2005,4,21,111,30.02,41.196615,-68.962312,0,0,0,0,0,"AL",0.038
"14764",521,"200503.334.1250.2","NMFS",2005,4,21,111,30,41.303403,-69.45193,0,0,0,0,0,"AL",0.038
"14765",526,"200510.177.1120.1","NMFS",2005,10,5,278,30,39.939717,-69.86535,4,0,4,4,0,"AL",0.038
"14766",526,"200510.178.1100.6","NMFS",2005,10,6,279,30,40.021883,-69.472867,0,0,0,0,0,"AL",0.038
"14767",526,"200510.179.1100.4","NMFS",2005,10,6,279,29.98,40.35995,-69.7896,1,0,1,0,1,"AL",0.038
"14768",526,"200510.180.1100.2","NMFS",2005,10,6,279,29.97,40.5955,-69.740383,0,0,0,0,0,"AL",0.038
"14769",526,"200510.181.3550.3","NMFS",2005,10,6,279,30.12,40.843317,-69.8902,0,0,0,0,0,"AL",0.038
"14770",526,"200510.182.3550.4","NMFS",2005,10,6,279,29.97,40.9743,-69.64585,1,1,0,1,0,"AL",0.038
"14771",526,"200510.183.3550.5","NMFS",2005,10,6,279,29.98,41.108517,-69.627417,1,1,0,1,0,"AL",0.038
"14772",521,"200510.184.3550.1","NMFS",2005,10,6,279,30.13,41.10535,-69.474467,2,2,0,2,0,"AL",0.038
"14773",526,"200510.185.1090.3","NMFS",2005,10,6,279,30.03,40.74285,-69.343833,1,1,0,1,0,"AL",0.038
"14774",526,"200510.186.1100.5","NMFS",2005,10,6,279,30,40.52385,-69.25455,0,0,0,0,0,"AL",0.038
"14775",526,"200510.187.1100.8","NMFS",2005,10,6,279,29.92,40.386233,-69.28195,0,0,0,0,0,"AL",0.038
"14776",526,"200510.188.1100.1","NMFS",2005,10,6,279,29.98,40.431117,-69.028083,1,0,1,1,0,"AL",0.038
"14777",525,"200510.189.1130.4","NMFS",2005,10,7,280,29.98,40.522817,-68.7171,0,0,0,0,0,"AL",0.038
"14778",525,"200510.190.1190.2","NMFS",2005,10,7,280,30.02,40.71555,-68.5419,0,0,0,0,0,"AL",0.038
"14779",525,"200510.191.1130.1","NMFS",2005,10,7,280,29.97,40.5345,-68.551983,0,0,0,0,0,"AL",0.038
"14780",525,"200510.192.1140.3","NMFS",2005,10,7,280,30.03,40.261483,-68.440917,1,1,0,1,0,"AL",0.038
"14781",525,"200510.193.1130.7","NMFS",2005,10,7,280,30.02,40.6493,-68.240183,0,0,0,0,0,"AL",0.038
"14782",525,"200510.194.1140.2","NMFS",2005,10,7,280,29.88,40.4795,-68.047833,0,0,0,0,0,"AL",0.038
"14783",525,"200510.195.1150.1","NMFS",2005,10,7,280,29.98,40.371233,-67.90715,5,4,1,5,0,"AL",0.038
"14784",525,"200510.196.1130.6","NMFS",2005,10,7,280,30.02,40.6481,-67.841,2,2,0,2,0,"AL",0.038
"14785",525,"200510.197.1130.9","NMFS",2005,10,7,280,29.93,40.609683,-67.780383,1,1,0,1,0,"AL",0.038
"14786",525,"200510.198.1140.1","NMFS",2005,10,7,280,29.98,40.560367,-67.5972,7,7,0,7,0,"AL",0.038
"14787",525,"200510.199.1130.8","NMFS",2005,10,8,281,30.12,40.77805,-67.321467,0,0,0,0,0,"AL",0.038
"14788",525,"200510.200.1130.5","NMFS",2005,10,8,281,29.98,40.889817,-67.5266,0,0,0,0,0,"AL",0.038
"14789",525,"200510.201.1130.3","NMFS",2005,10,8,281,30,40.936317,-67.410583,1,1,0,1,0,"AL",0.038
"14790",525,"200510.202.1130.2","NMFS",2005,10,8,281,29.98,41.054467,-67.5462,2,2,0,2,0,"AL",0.038
"14791",562,"200510.203.1190.3","NMFS",2005,10,8,281,30.05,41.218583,-67.501983,2,1,1,2,0,"AL",0.038
"14792",562,"200510.204.1190.9","NMFS",2005,10,8,281,30.05,41.410217,-67.31965,3,1,2,3,0,"AL",0.038
"14793",562,"200510.205.1190.8","NMFS",2005,10,8,281,30.02,41.450133,-67.36405,2,2,0,2,0,"AL",0.038
"14794",562,"200510.206.1190.1","NMFS",2005,10,8,281,29.97,41.524017,-67.38815,1,1,0,1,0,"AL",0.038
"14795",562,"200510.207.1160.3","NMFS",2005,10,8,281,29.98,41.659583,-66.879933,3,3,0,3,0,"AL",0.038
"14796",562,"200510.208.1160.9","NMFS",2005,10,8,281,30,41.483583,-67.101183,0,0,0,0,0,"AL",0.038
"14797",562,"200510.209.1160.2","NMFS",2005,10,8,281,29.85,41.224083,-67.035167,0,0,0,0,0,"AL",0.038
"14798",562,"200510.210.1160.6","NMFS",2005,10,9,282,30.02,40.89895,-66.921217,0,0,0,0,0,"AL",0.038
"14799",562,"200510.211.1170.2","NMFS",2005,10,9,282,29.97,40.850983,-66.681267,2,2,0,2,0,"AL",0.038
"14800",562,"200510.212.1180.2","NMFS",2005,10,9,282,29.98,41.026667,-66.409033,1,1,0,1,0,"AL",0.038
"14801",562,"200510.213.1160.1","NMFS",2005,10,9,282,30.83,41.31025,-66.482617,0,0,0,0,0,"AL",0.038
"14802",552,"200510.214.1160.7","NMFS",2005,10,9,282,29.93,41.35035,-66.310933,1,1,0,1,0,"AL",0.038
"14803",552,"200510.215.1160.4","NMFS",2005,10,9,282,29.98,41.555833,-66.414317,1,0,1,1,0,"AL",0.038
"14804",552,"200510.216.1160.10","NMFS",2005,10,9,282,30.08,41.728933,-66.5776,4,4,0,4,0,"AL",0.038
"14805",552,"200510.217.1170.1","NMFS",2005,10,10,283,30.05,41.808333,-65.812833,2,2,0,2,0,"AL",0.038
"14806",551,"200510.218.1170.3","NMFS",2005,10,10,283,29.98,41.931817,-65.876283,2,1,1,2,0,"AL",0.038
"14807",551,"200510.219.1180.1","NMFS",2005,10,10,283,29.98,41.982783,-65.78425,0,0,0,0,0,"AL",0.038
"14808",551,"200510.220.1290.4","NMFS",2005,10,10,283,30.03,42.105467,-65.8668,0,0,0,0,0,"AL",0.038
"14809",551,"200510.221.1160.8","NMFS",2005,10,10,283,30.05,42.010017,-66.173767,0,0,0,0,0,"AL",0.038
"14810",551,"200510.222.1210.3","NMFS",2005,10,10,283,30.02,42.1426,-66.5136,3,2,1,3,0,"AL",0.038
"14811",464,"200510.223.1300.1","NMFS",2005,10,10,283,30.02,42.480283,-66.707433,0,0,0,0,0,"AL",0.038
"14812",551,"200510.224.1300.2","NMFS",2005,10,10,283,29.95,42.31825,-66.882433,0,0,0,0,0,"AL",0.038
"14813",551,"200510.225.1290.7","NMFS",2005,10,10,283,30.05,42.227183,-66.7997,1,0,1,1,0,"AL",0.038
"14814",551,"200510.226.1220.3","NMFS",2005,10,11,284,29.95,42.189617,-66.898217,3,3,0,3,0,"AL",0.038
"14815",551,"200510.227.1210.2","NMFS",2005,10,11,284,29.98,42.104617,-66.826133,2,2,0,2,0,"AL",0.038
"14816",551,"200510.228.1160.5","NMFS",2005,10,11,284,30.02,41.896317,-66.850283,4,4,0,4,0,"AL",0.038
"14817",561,"200510.229.1190.7","NMFS",2005,10,11,284,29.98,41.93515,-67.139767,0,0,0,0,0,"AL",0.038
"14818",561,"200510.230.1200.6","NMFS",2005,10,11,284,30.03,42.026133,-67.235983,1,1,0,1,0,"AL",0.038
"14819",561,"200510.231.1210.4","NMFS",2005,10,11,284,30,42.140667,-67.238483,1,1,0,1,0,"AL",0.038
"14820",551,"200510.232.1220.2","NMFS",2005,10,11,284,30.05,42.21225,-67.155333,4,2,2,4,0,"AL",0.038
"14821",464,"200510.233.1300.3","NMFS",2005,10,11,284,30.02,42.356067,-67.30135,0,0,0,0,0,"AL",0.038
"14822",561,"200510.234.1220.4","NMFS",2005,10,11,284,29.97,42.1873,-67.55495,0,0,0,0,0,"AL",0.038
"14823",561,"200510.235.1220.1","NMFS",2005,10,11,284,29.97,42.095867,-67.616667,1,0,1,1,0,"AL",0.038
"14824",561,"200510.236.1200.2","NMFS",2005,10,12,285,29.97,42.050783,-67.454617,2,2,0,2,0,"AL",0.038
"14825",561,"200510.237.1200.5","NMFS",2005,10,12,285,30.02,41.880633,-67.651883,1,1,0,1,0,"AL",0.038
"14826",514,"200510.238.3610.1","NMFS",2005,10,12,285,29.97,42.03755,-70.256767,7,2,5,7,0,"AL",0.038
"14827",514,"200510.239.3600.2","NMFS",2005,10,12,285,29.1,41.93905,-70.404233,24,9,15,23,1,"AL",0.038
"14828",514,"200510.240.3600.1","NMFS",2005,10,12,285,29.95,41.887333,-70.262367,5,0,5,5,0,"AL",0.038
"14829",514,"200510.241.3590.1","NMFS",2005,10,13,286,29.98,41.855,-70.255217,4,0,4,4,0,"AL",0.038
"14830",514,"200510.242.3580.1","NMFS",2005,10,13,286,30.02,41.7562,-70.335033,11,3,8,10,1,"AL",0.038
"14831",521,"200510.243.1230.2","NMFS",2005,10,18,291,30.03,41.04125,-68.95115,0,0,0,0,0,"AL",0.038
"14832",525,"200510.244.1190.6","NMFS",2005,10,18,291,30,40.859183,-68.6743,0,0,0,0,0,"AL",0.038
"14833",525,"200510.245.1190.5","NMFS",2005,10,18,291,30,41.002633,-68.317833,0,0,0,0,0,"AL",0.038
"14834",525,"200510.246.1190.4","NMFS",2005,10,18,291,30.03,41.180083,-68.0601,0,0,0,0,0,"AL",0.038
"14835",522,"200510.247.1200.3","NMFS",2005,10,18,291,30.07,41.57865,-67.983017,0,0,0,0,0,"AL",0.038
"14836",522,"200510.248.1200.4","NMFS",2005,10,18,291,29.97,41.481367,-68.178317,0,0,0,0,0,"AL",0.038
"14837",522,"200510.249.1200.1","NMFS",2005,10,18,291,29.98,41.4137,-68.232417,2,1,1,2,0,"AL",0.038
"14838",522,"200510.250.1230.1","NMFS",2005,10,18,291,30,41.35775,-68.44485,1,1,0,1,0,"AL",0.038
"14839",522,"200510.251.1230.5","NMFS",2005,10,18,291,30,41.481267,-68.45775,0,0,0,0,0,"AL",0.038
"14840",522,"200510.252.1240.4","NMFS",2005,10,18,291,29.95,41.433133,-68.776883,0,0,0,0,0,"AL",0.038
"14841",522,"200510.253.1210.1","NMFS",2005,10,19,292,29.98,41.72705,-68.342033,1,1,0,1,0,"AL",0.038
"14842",522,"200510.254.1240.3","NMFS",2005,10,19,292,30.03,41.859417,-68.377583,1,1,0,1,0,"AL",0.038
"14843",522,"200510.255.1290.2","NMFS",2005,10,19,292,30,41.979517,-68.274767,0,0,0,0,0,"AL",0.038
"14844",522,"200510.256.1290.1","NMFS",2005,10,19,292,30.02,42.304817,-68.10445,0,0,0,0,0,"AL",0.038
"14845",515,"200510.257.1290.6","NMFS",2005,10,19,292,29.98,42.4315,-67.849383,0,0,0,0,0,"AL",0.038
"14846",515,"200510.258.1290.3","NMFS",2005,10,19,292,30,42.441967,-68.184617,0,0,0,0,0,"AL",0.038
"14847",515,"200510.259.1290.8","NMFS",2005,10,19,292,29.92,42.56595,-68.382217,0,0,0,0,0,"AL",0.038
"14848",515,"200510.260.1290.5","NMFS",2005,10,19,292,29.98,42.636083,-68.479617,0,0,0,0,0,"AL",0.038
"14849",515,"200510.261.1360.6","NMFS",2005,10,19,292,29.98,42.886517,-68.3497,0,0,0,0,0,"AL",0.038
"14850",515,"200510.262.1370.1","NMFS",2005,10,19,292,29.93,42.980817,-68.822233,0,0,0,0,0,"AL",0.038
"14851",515,"200510.263.1370.3","NMFS",2005,10,19,292,29.98,43.021917,-68.745483,0,0,0,0,0,"AL",0.038
"14852",515,"200510.264.1370.5","NMFS",2005,10,20,293,29.98,43.10935,-68.7408,0,0,0,0,0,"AL",0.038
"14853",515,"200510.265.1370.4","NMFS",2005,10,20,293,29.98,43.188183,-68.9503,0,0,0,0,0,"AL",0.038
"14854",515,"200510.266.1360.2","NMFS",2005,10,20,293,30.05,43.145067,-68.349,0,0,0,0,0,"AL",0.038
"14855",515,"200510.267.1360.3","NMFS",2005,10,20,293,30.07,43.068583,-67.67955,0,0,0,0,0,"AL",0.038
"14856",515,"200510.268.1360.4","NMFS",2005,10,20,293,29.95,42.9378,-67.677333,0,0,0,0,0,"AL",0.038
"14857",465,"200510.269.1360.1","NMFS",2005,10,20,293,29.97,43.026433,-67.447367,0,0,0,0,0,"AL",0.038
"14858",465,"200510.270.1340.4","NMFS",2005,10,20,293,30,43.26465,-66.818167,0,0,0,0,0,"AL",0.038
"14859",465,"200510.271.1340.6","NMFS",2005,10,20,293,30.02,43.167167,-66.696733,5,5,0,5,0,"AL",0.038
"14860",465,"200510.273.1330.2","NMFS",2005,10,21,294,29.98,43.381833,-66.284783,144,90,54,127,17,"AL",0.038
"14861",465,"200510.274.1340.1","NMFS",2005,10,21,294,30.03,43.545767,-66.523767,10,7,3,9,1,"AL",0.038
"14862",465,"200510.275.1330.1","NMFS",2005,10,21,294,30,43.789133,-66.590783,8,3,5,8,0,"AL",0.038
"14863",466,"200510.276.1330.3","NMFS",2005,10,21,294,30,44.1341,-66.6501,7,5,2,6,1,"AL",0.038
"14864",466,"200510.277.1351.1","NMFS",2005,10,21,294,29.97,44.3481,-66.7005,0,0,0,0,0,"AL",0.038
"14865",511,"200510.278.1351.2","NMFS",2005,10,21,294,30.05,44.167817,-67.071967,0,0,0,0,0,"AL",0.038
"14866",511,"200510.279.1340.3","NMFS",2005,10,21,294,29.97,44.061883,-67.13875,2,2,0,2,0,"AL",0.038
"14867",511,"200510.280.1340.5","NMFS",2005,10,21,294,30.05,43.979383,-66.919167,0,0,0,0,0,"AL",0.038
"14868",465,"200510.281.1340.2","NMFS",2005,10,22,295,30.08,43.67695,-67.209533,0,0,0,0,0,"AL",0.038
"14869",465,"200510.282.1360.8","NMFS",2005,10,22,295,29.97,43.524917,-67.272283,0,0,0,0,0,"AL",0.038
"14870",512,"200510.283.1360.5","NMFS",2005,10,22,295,30.12,43.511717,-67.741533,1,0,1,1,0,"AL",0.038
"14871",512,"200510.284.1360.7","NMFS",2005,10,22,295,30.02,43.725417,-67.802183,0,0,0,0,0,"AL",0.038
"14872",512,"200510.285.1390.1","NMFS",2005,10,22,295,29.97,44.181867,-67.91365,24,13,11,18,6,"AL",0.038
"14873",512,"200510.286.1390.2","NMFS",2005,10,22,295,30,44.0879,-68.08905,22,13,9,21,1,"AL",0.038
"14874",512,"200510.287.1390.3","NMFS",2005,10,22,295,30.05,43.973717,-68.312967,8,4,4,8,0,"AL",0.038
"14875",512,"200510.288.1390.4","NMFS",2005,10,23,296,29.98,43.91335,-68.636867,43,17,26,37,6,"AL",0.038
"14876",512,"200510.289.1380.1","NMFS",2005,10,23,296,30,43.686917,-68.31715,0,0,0,0,0,"AL",0.038
"14877",512,"200510.290.1380.4","NMFS",2005,10,23,296,29.98,43.572033,-68.4275,0,0,0,0,0,"AL",0.038
"14878",512,"200510.291.1380.5","NMFS",2005,10,23,296,30,43.475367,-68.3397,0,0,0,0,0,"AL",0.038
"14879",512,"200510.292.1380.3","NMFS",2005,10,23,296,29.23,43.431417,-68.69015,0,0,0,0,0,"AL",0.038
"14880",512,"200510.293.1380.2","NMFS",2005,10,24,297,29.97,43.604733,-68.950183,0,0,0,0,0,"AL",0.038
"14881",521,"200510.294.1250.4","NMFS",2005,10,27,300,30,41.4128,-69.565517,5,4,1,5,0,"AL",0.038
"14882",521,"200510.295.1250.1","NMFS",2005,10,27,300,30.03,41.422333,-69.499333,15,13,2,15,0,"AL",0.038
"14883",521,"200510.296.1250.2","NMFS",2005,10,28,301,30,41.195067,-69.395667,20,17,3,20,0,"AL",0.038
"14884",521,"200510.297.1250.3","NMFS",2005,10,28,301,29.98,41.053667,-69.3804,5,4,1,5,0,"AL",0.038
"14885",521,"200510.298.3550.2","NMFS",2005,10,28,301,29.93,41.258283,-69.527717,0,0,0,0,0,"AL",0.038
"14886",521,"200510.299.1230.3","NMFS",2005,10,28,301,30.03,41.6399,-69.647867,2,2,0,2,0,"AL",0.038
"14887",514,"200510.300.3660.2","NMFS",2005,10,31,304,30.05,42.228483,-70.507033,4,4,0,2,2,"AL",0.038
"14888",514,"200510.302.3640.2","NMFS",2005,10,31,304,29.05,42.204433,-70.586633,67,30,37,63,4,"AL",0.038
"14889",514,"200510.304.1260.1","NMFS",2005,11,1,305,29.98,42.635017,-70.25895,0,0,0,0,0,"AL",0.038
"14890",514,"200510.305.1270.1","NMFS",2005,11,1,305,30.1,42.703967,-70.0255,0,0,0,0,0,"AL",0.038
"14891",514,"200510.306.1260.4","NMFS",2005,11,1,305,29.97,42.604133,-70.1411,0,0,0,0,0,"AL",0.038
"14892",514,"200510.307.3660.1","NMFS",2005,11,1,305,22.08,42.581817,-70.524483,42,14,28,41,1,"AL",0.038
"14893",514,"200510.309.3660.5","NMFS",2005,11,1,305,29.98,42.7408,-70.551017,9,3,6,7,2,"AL",0.038
"14894",514,"200510.310.3630.1","NMFS",2005,11,1,305,30.08,42.696183,-70.6852,4,0,4,1,3,"AL",0.038
"14895",513,"200510.311.1270.2","NMFS",2005,11,1,305,30.03,43.01885,-70.367333,0,0,0,0,0,"AL",0.038
"14896",513,"200510.312.1260.3","NMFS",2005,11,1,305,30.1,43.119717,-70.065817,0,0,0,0,0,"AL",0.038
"14897",513,"200510.313.1270.3","NMFS",2005,11,2,306,29.98,43.26955,-70.049017,1,0,1,1,0,"AL",0.038
"14898",513,"200510.314.1400.1","NMFS",2005,11,2,306,29.98,43.27745,-70.245167,10,6,4,10,0,"AL",0.038
"14899",513,"200510.315.1400.2","NMFS",2005,11,2,306,20.08,43.57205,-69.695383,2,1,1,2,0,"AL",0.038
"14900",513,"200510.316.1400.3","NMFS",2005,11,2,306,28.85,43.719567,-69.510267,9,8,1,8,1,"AL",0.038
"14901",513,"200510.317.1370.2","NMFS",2005,11,2,306,30.03,43.240033,-69.543517,0,0,0,0,0,"AL",0.038
"14902",515,"200510.318.1280.1","NMFS",2005,11,2,306,29.98,42.686183,-69.640633,1,1,0,1,0,"AL",0.038
"14903",515,"200510.319.1280.5","NMFS",2005,11,2,306,29.97,42.555933,-69.3813,0,0,0,0,0,"AL",0.038
"14904",515,"200510.320.1280.6","NMFS",2005,11,3,307,30.02,42.4823,-68.852367,0,0,0,0,0,"AL",0.038
"14905",521,"200510.321.1240.1","NMFS",2005,11,3,307,30,42.265883,-68.898617,0,0,0,0,0,"AL",0.038
"14906",515,"200510.322.1280.4","NMFS",2005,11,3,307,29.98,42.48,-69.66535,2,2,0,2,0,"AL",0.038
"14907",514,"200510.323.1260.2","NMFS",2005,11,3,307,30,42.43375,-70.1123,0,0,0,0,0,"AL",0.038
"14908",514,"200510.324.1260.5","NMFS",2005,11,3,307,30,42.2428,-70.215067,1,1,0,1,0,"AL",0.038
"14909",514,"200510.325.3610.2","NMFS",2005,11,3,307,30.03,42.079333,-70.060317,9,8,1,9,0,"AL",0.038
"14910",521,"200510.326.1230.4","NMFS",2005,11,4,308,30.03,41.82515,-69.81535,0,0,0,0,0,"AL",0.038
"14911",521,"200510.327.3560.1","NMFS",2005,11,4,308,30,41.729583,-69.909183,0,0,0,0,0,"AL",0.038
"14912",521,"200510.328.1240.2","NMFS",2005,11,4,308,30.02,41.855233,-69.58965,0,0,0,0,0,"AL",0.038
"14913",521,"200510.329.1240.5","NMFS",2005,11,4,308,29.97,41.857183,-69.400133,0,0,0,0,0,"AL",0.038
"14914",521,"200510.330.1280.3","NMFS",2005,11,4,308,30.08,41.926817,-69.244783,0,0,0,0,0,"AL",0.038
"14915",521,"200510.331.1280.2","NMFS",2005,11,4,308,30.03,42.064983,-69.676867,0,0,0,0,0,"AL",0.038
"14916",521,"200510.332.1270.4","NMFS",2005,11,4,308,29.97,42.196133,-69.837783,0,0,0,0,0,"AL",0.038
"14917",526,"200604.175.1090.1","NMFS",2006,3,28,87,29.98,40.68285,-69.9728,0,0,0,0,0,"AL",0.038
"14918",526,"200604.176.1100.8","NMFS",2006,3,28,87,30.07,40.308283,-69.97815,0,0,0,0,0,"AL",0.038
"14919",526,"200604.179.1110.1","NMFS",2006,3,28,87,30.08,39.980833,-69.484883,0,0,0,0,0,"AL",0.038
"14920",526,"200604.180.1100.7","NMFS",2006,3,28,87,30.15,40.2208,-69.367233,0,0,0,0,0,"AL",0.038
"14921",526,"200604.181.1100.2","NMFS",2006,3,28,87,30.02,40.230417,-69.211183,0,0,0,0,0,"AL",0.038
"14922",526,"200604.182.1100.5","NMFS",2006,3,28,87,29.98,40.39915,-69.221767,0,0,0,0,0,"AL",0.038
"14923",526,"200604.183.1100.3","NMFS",2006,3,29,88,30.08,40.47885,-69.2052,0,0,0,0,0,"AL",0.038
"14924",526,"200604.184.1100.1","NMFS",2006,3,29,88,29.98,40.528433,-69.0525,0,0,0,0,0,"AL",0.038
"14925",526,"200604.185.1100.6","NMFS",2006,3,29,88,29.98,40.481383,-68.853917,0,0,0,0,0,"AL",0.038
"14926",525,"200604.186.1130.7","NMFS",2006,3,29,88,30.23,40.481233,-68.771733,0,0,0,0,0,"AL",0.038
"14927",525,"200604.187.1130.3","NMFS",2006,3,29,88,30.05,40.593533,-68.607967,0,0,0,0,0,"AL",0.038
"14928",525,"200604.188.1140.3","NMFS",2006,3,29,88,29.98,40.22845,-68.376467,0,0,0,0,0,"AL",0.038
"14929",525,"200604.189.1140.2","NMFS",2006,3,29,88,30.02,40.312883,-68.298183,0,0,0,0,0,"AL",0.038
"14930",525,"200604.190.1140.1","NMFS",2006,3,29,88,30,40.472317,-68.224567,0,0,0,0,0,"AL",0.038
"14931",525,"200604.191.1130.1","NMFS",2006,3,29,88,29.97,40.730283,-68.143017,0,0,0,0,0,"AL",0.038
"14932",525,"200604.192.1130.9","NMFS",2006,3,29,88,30.13,40.5899,-67.882133,0,0,0,0,0,"AL",0.038
"14933",525,"200604.193.1150.1","NMFS",2006,3,29,88,29.95,40.316583,-67.91655,1,1,0,1,0,"AL",0.038
"14934",525,"200604.194.1130.4","NMFS",2006,3,30,89,30,40.6465,-67.2396,0,0,0,0,0,"AL",0.038
"14935",525,"200604.195.1130.5","NMFS",2006,3,30,89,30.22,40.732083,-67.38715,0,0,0,0,0,"AL",0.038
"14936",525,"200604.196.1130.8","NMFS",2006,3,30,89,30.08,40.89165,-67.279633,0,0,0,0,0,"AL",0.038
"14937",525,"200604.197.1130.6","NMFS",2006,3,30,89,29.97,41.051133,-67.519567,0,0,0,0,0,"AL",0.038
"14938",525,"200604.198.1190.1","NMFS",2006,3,30,89,36,41.146083,-67.5449,0,0,0,0,0,"AL",0.038
"14939",562,"200604.199.1190.9","NMFS",2006,3,30,89,30.05,41.229967,-67.287883,0,0,0,0,0,"AL",0.038
"14940",525,"200604.200.1130.2","NMFS",2006,3,30,89,29.98,40.94285,-67.0161,0,0,0,0,0,"AL",0.038
"14941",562,"200604.201.1160.9","NMFS",2006,3,30,89,30.07,41.057817,-66.803583,0,0,0,0,0,"AL",0.038
"14942",562,"200604.202.1180.1","NMFS",2006,3,30,89,21.1,40.869233,-66.58355,0,0,0,0,0,"AL",0.038
"14943",562,"200604.203.1170.2","NMFS",2006,3,31,90,30.03,41.008983,-66.491817,0,0,0,0,0,"AL",0.038
"14944",562,"200604.204.1160.3","NMFS",2006,3,31,90,30,41.23655,-66.4818,0,0,0,0,0,"AL",0.038
"14945",562,"200604.205.1160.8","NMFS",2006,3,31,90,30,41.2778,-66.499067,3,3,0,3,0,"AL",0.038
"14946",562,"200604.206.1160.1","NMFS",2006,3,31,90,30.03,41.348167,-66.876883,0,0,0,0,0,"AL",0.038
"14947",562,"200604.207.1160.4","NMFS",2006,3,31,90,30.02,41.516533,-66.621417,0,0,0,0,0,"AL",0.038
"14948",552,"200604.208.1160.2","NMFS",2006,3,31,90,29.98,41.7696,-66.6925,0,0,0,0,0,"AL",0.038
"14949",552,"200604.209.1160.5","NMFS",2006,3,31,90,29.98,41.527567,-66.255667,0,0,0,0,0,"AL",0.038
"14950",552,"200604.210.1180.2","NMFS",2006,3,31,90,29.97,41.360033,-66.0639,4,3,1,4,0,"AL",0.038
"14951",552,"200604.211.1160.10","NMFS",2006,3,31,90,29.98,41.60435,-66.143183,0,0,0,0,0,"AL",0.038
"14952",552,"200604.212.1170.3","NMFS",2006,3,31,90,30.13,41.60135,-65.947433,8,5,3,8,0,"AL",0.038
"14953",551,"200604.213.1170.1","NMFS",2006,4,1,91,30.1,41.974817,-65.94475,0,0,0,0,0,"AL",0.038
"14954",551,"200604.214.1160.7","NMFS",2006,4,1,91,30.03,41.98415,-66.41125,4,4,0,4,0,"AL",0.038
"14955",551,"200604.215.1210.1","NMFS",2006,4,1,91,30.15,42.098983,-66.305283,5,4,1,5,0,"AL",0.038
"14956",551,"200604.216.1290.4","NMFS",2006,4,1,91,30.02,42.271733,-66.001317,0,0,0,0,0,"AL",0.038
"14957",464,"200604.217.1290.7","NMFS",2006,4,1,91,30.03,42.3971,-65.92115,5,4,1,5,0,"AL",0.038
"14958",464,"200604.218.1290.1","NMFS",2006,4,1,91,30.02,42.36365,-66.249133,1,1,0,1,0,"AL",0.038
"14959",464,"200604.219.1290.8","NMFS",2006,4,1,91,30.03,42.610267,-66.653533,0,0,0,0,0,"AL",0.038
"14960",464,"200604.220.1300.1","NMFS",2006,4,1,91,29.98,42.4043,-66.512817,22,21,1,22,0,"AL",0.038
"14961",551,"200604.221.1290.6","NMFS",2006,4,1,91,30.02,42.2716,-66.536883,10,10,0,10,0,"AL",0.038
"14962",551,"200604.222.1220.4","NMFS",2006,4,2,92,30,42.189683,-66.941667,2,0,2,2,0,"AL",0.038
"14963",464,"200604.223.1300.2","NMFS",2006,4,2,92,30.07,42.35105,-67.042467,3,3,0,3,0,"AL",0.038
"14964",464,"200604.224.1300.3","NMFS",2006,4,2,92,30.12,42.5198,-67.1111,4,4,0,4,0,"AL",0.038
"14965",515,"200604.225.1290.3","NMFS",2006,4,2,92,29.98,42.4836,-67.86455,2,2,0,2,0,"AL",0.038
"14966",561,"200604.226.1290.2","NMFS",2006,4,2,92,20.82,42.330033,-67.515483,5,3,2,5,0,"AL",0.038
"14967",561,"200604.227.1210.4","NMFS",2006,4,2,92,30,42.148533,-67.319433,0,0,0,0,0,"AL",0.038
"14968",561,"200604.228.1200.5","NMFS",2006,4,2,92,30.12,42.0632,-67.343033,0,0,0,0,0,"AL",0.038
"14969",561,"200604.229.1190.6","NMFS",2006,4,2,92,30.08,41.967233,-67.1005,1,0,1,0,1,"AL",0.038
"14970",562,"200604.230.1160.6","NMFS",2006,4,3,93,30.08,41.653483,-66.964933,0,0,0,0,0,"AL",0.038
"14971",562,"200604.231.1190.3","NMFS",2006,4,3,93,30,41.5121,-67.274667,0,0,0,0,0,"AL",0.038
"14972",562,"200604.232.1190.4","NMFS",2006,4,3,93,30.15,41.612933,-67.652967,0,0,0,0,0,"AL",0.038
"14973",522,"200604.233.1200.4","NMFS",2006,4,3,93,30.2,41.65725,-67.69605,0,0,0,0,0,"AL",0.038
"14974",562,"200604.234.1200.6","NMFS",2006,4,3,93,30.03,41.798567,-67.5748,0,0,0,0,0,"AL",0.038
"14975",561,"200604.235.1200.1","NMFS",2006,4,3,93,29.98,41.89495,-67.615417,0,0,0,0,0,"AL",0.038
"14976",522,"200604.236.1200.3","NMFS",2006,4,3,93,30,41.884117,-67.786767,2,1,1,2,0,"AL",0.038
"14977",522,"200604.237.1210.3","NMFS",2006,4,3,93,30,42.021533,-67.77425,0,0,0,0,0,"AL",0.038
"14978",522,"200604.238.1220.1","NMFS",2006,4,3,93,30,42.026633,-67.808583,2,1,1,2,0,"AL",0.038
"14979",522,"200604.239.1220.2","NMFS",2006,4,3,93,29.93,41.983417,-67.93595,0,0,0,0,0,"AL",0.038
"14980",522,"200604.240.1210.2","NMFS",2006,4,3,93,30.07,41.817067,-68.1665,0,0,0,0,0,"AL",0.038
"14981",522,"200604.241.1220.3","NMFS",2006,4,3,93,30,41.757117,-68.449467,3,3,0,3,0,"AL",0.038
"14982",522,"200604.242.1240.3","NMFS",2006,4,4,94,30.02,42.10085,-68.477233,0,0,0,0,0,"AL",0.038
"14983",522,"200604.243.1240.5","NMFS",2006,4,4,94,30.03,42.0568,-68.578617,0,0,0,0,0,"AL",0.038
"14984",521,"200604.244.1240.4","NMFS",2006,4,4,94,30.12,42.021133,-68.883017,0,0,0,0,0,"AL",0.038
"14985",522,"200604.245.1240.2","NMFS",2006,4,4,94,30.08,41.688883,-68.551667,3,3,0,3,0,"AL",0.038
"14986",522,"200604.246.1230.4","NMFS",2006,4,4,94,29.98,41.346983,-68.51335,3,2,1,3,0,"AL",0.038
"14987",522,"200604.247.1200.2","NMFS",2006,4,4,94,29.98,41.25655,-68.3519,1,1,0,0,1,"AL",0.038
"14988",525,"200604.248.1190.5","NMFS",2006,4,4,94,30,41.317767,-68.163933,0,0,0,0,0,"AL",0.038
"14989",525,"200604.249.1190.2","NMFS",2006,4,4,94,30.03,41.209067,-68.10675,0,0,0,0,0,"AL",0.038
"14990",525,"200604.250.1190.7","NMFS",2006,4,4,94,29.95,40.851217,-68.4601,0,0,0,0,0,"AL",0.038
"14991",525,"200604.251.1190.8","NMFS",2006,4,4,94,30.02,40.931933,-68.479517,0,0,0,0,0,"AL",0.038
"14992",522,"200604.252.1230.5","NMFS",2006,4,5,95,30,41.235833,-68.73725,0,0,0,0,0,"AL",0.038
"14993",522,"200604.253.1230.2","NMFS",2006,4,5,95,30.08,41.159183,-68.771683,0,0,0,0,0,"AL",0.038
"14994",522,"200604.254.1230.3","NMFS",2006,4,5,95,30.28,41.111883,-68.831567,1,0,1,1,0,"AL",0.038
"14995",526,"200604.255.3550.2","NMFS",2006,4,5,95,30.12,40.93685,-69.572633,0,0,0,0,0,"AL",0.038
"14996",526,"200604.256.1090.2","NMFS",2006,4,5,95,30,40.886233,-69.827483,0,0,0,0,0,"AL",0.038
"14997",521,"200604.257.3550.1","NMFS",2006,4,5,95,30.03,41.195767,-69.637617,0,0,0,0,0,"AL",0.038
"14998",526,"200604.258.3550.5","NMFS",2006,4,5,95,29.97,41.035517,-69.554267,0,0,0,0,0,"AL",0.038
"14999",521,"200604.259.1250.3","NMFS",2006,4,5,95,30.08,41.03,-69.3263,14,11,3,11,3,"AL",0.038
"15000",521,"200604.260.1250.4","NMFS",2006,4,5,95,30.07,41.38275,-69.392067,2,1,1,1,1,"AL",0.038
"15001",521,"200604.261.3550.4","NMFS",2006,4,6,96,30.03,41.30825,-69.52025,0,0,0,0,0,"AL",0.038
"15002",521,"200604.262.3550.3","NMFS",2006,4,6,96,30.02,41.369483,-69.555517,0,0,0,0,0,"AL",0.038
"15003",521,"200604.263.1250.2","NMFS",2006,4,6,96,30.12,41.512317,-69.577467,19,13,6,19,0,"AL",0.038
"15004",521,"200604.264.1240.1","NMFS",2006,4,6,96,30.05,41.654017,-69.375317,3,3,0,3,0,"AL",0.038
"15005",521,"200604.265.1280.4","NMFS",2006,4,6,96,29.97,41.975817,-69.38385,1,1,0,1,0,"AL",0.038
"15006",521,"200604.266.1240.6","NMFS",2006,4,6,96,30,41.84855,-69.714183,0,0,0,0,0,"AL",0.038
"15007",521,"200604.267.1230.1","NMFS",2006,4,6,96,30.03,41.8115,-69.781,0,0,0,0,0,"AL",0.038
"15008",521,"200604.268.1250.1","NMFS",2006,4,6,96,30.03,41.8512,-69.850483,0,0,0,0,0,"AL",0.038
"15009",514,"200604.269.3560.1","NMFS",2006,4,6,96,29.95,42.016933,-70.0092,0,0,0,0,0,"AL",0.038
"15010",521,"200604.270.1270.3","NMFS",2006,4,6,96,30.03,42.17575,-69.9425,1,1,0,1,0,"AL",0.038
"15011",521,"200604.271.1280.5","NMFS",2006,4,6,96,30.03,42.315467,-69.867067,3,3,0,3,0,"AL",0.038
"15012",514,"200604.272.1260.4","NMFS",2006,4,6,96,30.03,42.2731,-70.177117,0,0,0,0,0,"AL",0.038
"15013",514,"200604.273.1260.2","NMFS",2006,4,6,96,29.88,42.193167,-70.347033,0,0,0,0,0,"AL",0.038
"15014",514,"200604.274.3610.1","NMFS",2006,4,7,97,30,42.117433,-70.21085,2,2,0,2,0,"AL",0.038
"15015",515,"200604.275.1280.3","NMFS",2006,4,12,102,29.97,42.356367,-68.8813,0,0,0,0,0,"AL",0.038
"15016",515,"200604.276.1370.4","NMFS",2006,4,12,102,30.12,42.653833,-68.983983,0,0,0,0,0,"AL",0.038
"15017",515,"200604.277.1370.2","NMFS",2006,4,12,102,30.03,42.606917,-68.858267,1,1,0,1,0,"AL",0.038
"15018",515,"200604.278.1280.7","NMFS",2006,4,12,102,30.02,42.604217,-68.631033,0,0,0,0,0,"AL",0.038
"15019",515,"200604.279.1280.9","NMFS",2006,4,12,102,30,42.580517,-68.5518,0,0,0,0,0,"AL",0.038
"15020",515,"200604.280.1290.5","NMFS",2006,4,12,102,30.12,42.7402,-68.354267,1,1,0,1,0,"AL",0.038
"15021",515,"200604.281.1360.5","NMFS",2006,4,12,102,30.03,42.81495,-68.317,0,0,0,0,0,"AL",0.038
"15022",515,"200604.282.1360.4","NMFS",2006,4,12,102,30.12,42.935583,-68.125833,0,0,0,0,0,"AL",0.038
"15023",515,"200604.283.1360.8","NMFS",2006,4,12,102,30.08,43.138533,-68.246767,2,2,0,2,0,"AL",0.038
"15024",515,"200604.284.1360.6","NMFS",2006,4,12,102,30.1,43.1007,-68.018783,1,1,0,1,0,"AL",0.038
"15025",465,"200604.285.1360.2","NMFS",2006,4,13,103,30,43.43965,-67.591567,1,1,0,1,0,"AL",0.038
"15026",465,"200604.286.1360.1","NMFS",2006,4,13,103,30.07,43.061117,-67.3838,0,0,0,0,0,"AL",0.038
"15027",465,"200604.287.1340.4","NMFS",2006,4,13,103,31.97,43.06695,-67.004533,3,1,2,3,0,"AL",0.038
"15028",465,"200604.289.1340.6","NMFS",2006,4,13,103,30.05,43.31795,-66.844733,4,1,3,4,0,"AL",0.038
"15029",465,"200604.290.1360.7","NMFS",2006,4,13,103,29.92,43.442,-66.977867,3,2,1,3,0,"AL",0.038
"15030",465,"200604.291.1340.1","NMFS",2006,4,13,103,29.98,43.7354,-66.794283,8,4,4,8,0,"AL",0.038
"15031",465,"200604.292.1330.2","NMFS",2006,4,14,104,30.23,43.5629,-66.468467,57,27,30,57,0,"AL",0.038
"15032",465,"200604.293.1330.4","NMFS",2006,4,14,104,29.97,43.779367,-66.509783,17,8,9,16,1,"AL",0.038
"15033",465,"200604.294.1330.1","NMFS",2006,4,14,104,31.35,43.896667,-66.519217,14,8,6,14,0,"AL",0.038
"15034",465,"200604.295.1330.3","NMFS",2006,4,14,104,29.98,43.985317,-66.597417,22,10,12,22,0,"AL",0.038
"15035",466,"200604.296.1351.2","NMFS",2006,4,14,104,29.93,44.089283,-66.7607,4,3,1,4,0,"AL",0.038
"15036",511,"200604.297.1351.1","NMFS",2006,4,14,104,30.02,44.31865,-67.015283,6,3,3,5,1,"AL",0.038
"15037",511,"200604.298.1340.5","NMFS",2006,4,14,104,30.03,43.98015,-67.21965,3,3,0,3,0,"AL",0.038
"15038",465,"200604.299.1340.2","NMFS",2006,4,14,104,29.97,43.76655,-67.252617,2,1,1,2,0,"AL",0.038
"15039",511,"200604.300.1380.2","NMFS",2006,4,15,105,30.15,44.077033,-67.784183,4,2,2,4,0,"AL",0.038
"15040",512,"200604.301.1390.4","NMFS",2006,4,15,105,30.2,44.234467,-67.882717,55,27,28,46,9,"AL",0.038
"15041",512,"200604.302.1390.1","NMFS",2006,4,15,105,29.98,44.168767,-68.02975,55,28,27,46,9,"AL",0.038
"15042",512,"200604.303.1380.5","NMFS",2006,4,15,105,30.03,44.024067,-68.1644,16,8,8,15,1,"AL",0.038
"15043",512,"200604.304.1360.3","NMFS",2006,4,15,105,30,43.526667,-68.108167,1,0,1,1,0,"AL",0.038
"15044",512,"200604.305.1380.4","NMFS",2006,4,15,105,30.15,43.520383,-68.3503,0,0,0,0,0,"AL",0.038
"15045",512,"200604.306.1380.1","NMFS",2006,4,15,105,29.95,43.612067,-68.275733,2,2,0,2,0,"AL",0.038
"15046",512,"200604.307.1390.3","NMFS",2006,4,15,105,22.4,43.90755,-68.5847,4,2,2,4,0,"AL",0.038
"15047",512,"200604.308.1390.2","NMFS",2006,4,15,105,30.03,43.799317,-68.649483,6,6,0,6,0,"AL",0.038
"15048",512,"200604.309.1380.3","NMFS",2006,4,16,106,30.28,43.595333,-68.74205,0,0,0,0,0,"AL",0.038
"15049",513,"200604.310.1400.3","NMFS",2006,4,16,106,30,43.7875,-69.3765,57,31,26,45,12,"AL",0.038
"15050",513,"200604.311.1400.1","NMFS",2006,4,16,106,29.93,43.436383,-70.092533,13,10,3,11,2,"AL",0.038
"15051",513,"200604.312.1380.6","NMFS",2006,4,16,106,23.47,43.296317,-69.2944,0,0,0,0,0,"AL",0.038
"15052",513,"200604.313.1370.3","NMFS",2006,4,16,106,30.02,43.261033,-69.312517,0,0,0,0,0,"AL",0.038
"15053",513,"200604.314.1370.1","NMFS",2006,4,16,106,30.08,43.06015,-69.265117,1,1,0,1,0,"AL",0.038
"15054",515,"200604.315.1370.5","NMFS",2006,4,16,106,30.05,42.894383,-69.211883,0,0,0,0,0,"AL",0.038
"15055",513,"200604.316.1280.1","NMFS",2006,4,17,107,29.85,42.854833,-69.78225,1,1,0,1,0,"AL",0.038
"15056",514,"200604.317.1270.5","NMFS",2006,4,17,107,31.05,42.810733,-70.01385,6,5,1,6,0,"AL",0.038
"15057",513,"200604.319.1270.2","NMFS",2006,4,17,107,30.02,43.066683,-70.13665,0,0,0,0,0,"AL",0.038
"15058",513,"200604.320.1400.2","NMFS",2006,4,17,107,30.02,43.147617,-70.318367,6,2,4,6,0,"AL",0.038
"15059",513,"200604.321.1270.1","NMFS",2006,4,17,107,29.92,42.98035,-70.276833,2,0,2,2,0,"AL",0.038
"15060",514,"200604.322.1400.4","NMFS",2006,4,17,107,30.12,42.806083,-70.589367,12,3,9,11,1,"AL",0.038
"15061",514,"200604.323.3630.1","NMFS",2006,4,17,107,25.52,42.69665,-70.692883,2,0,2,2,0,"AL",0.038
"15062",514,"200604.324.3630.2","NMFS",2006,4,17,107,30.02,42.689033,-70.681133,2,0,2,2,0,"AL",0.038
"15063",514,"200604.325.3640.1","NMFS",2006,4,17,107,30,42.70305,-70.6025,30,16,14,29,1,"AL",0.038
"15064",514,"200604.326.3650.1","NMFS",2006,4,17,107,30,42.583,-70.614167,46,23,23,43,3,"AL",0.038
"15065",514,"200604.327.1260.5","NMFS",2006,4,17,107,29.58,42.73155,-70.45725,14,4,10,14,0,"AL",0.038
"15066",514,"200604.328.1260.6","NMFS",2006,4,18,108,30.18,42.62235,-70.381467,1,0,1,1,0,"AL",0.038
"15067",514,"200604.329.1260.3","NMFS",2006,4,18,108,30.17,42.620883,-70.135567,1,1,0,1,0,"AL",0.038
"15068",514,"200604.330.1270.4","NMFS",2006,4,18,108,30.08,42.474283,-69.926117,5,5,0,5,0,"AL",0.038
"15069",514,"200604.331.1280.6","NMFS",2006,4,18,108,29.98,42.51425,-69.697467,1,1,0,1,0,"AL",0.038
"15070",515,"200604.332.1280.2","NMFS",2006,4,18,108,30,42.437417,-69.304833,1,1,0,1,0,"AL",0.038
"15071",521,"200604.333.1280.8","NMFS",2006,4,18,108,30.47,42.1801,-69.491217,0,0,0,0,0,"AL",0.038
"15072",514,"200604.334.1260.7","NMFS",2006,4,18,108,30.1,42.430967,-70.399767,0,0,0,0,0,"AL",0.038
"15073",514,"200604.335.1260.1","NMFS",2006,4,18,108,29.98,42.39275,-70.571633,4,2,2,4,0,"AL",0.038
"15074",514,"200604.337.3660.1","NMFS",2006,4,19,109,30.13,42.320283,-70.636067,1,1,0,1,0,"AL",0.038
"15075",514,"200604.338.3660.2","NMFS",2006,4,19,109,29.97,42.274183,-70.581933,0,0,0,0,0,"AL",0.038
"15076",514,"200604.340.3590.1","NMFS",2006,4,19,109,30.13,41.971667,-70.551183,5,1,4,5,0,"AL",0.038
"15077",514,"200604.341.3580.2","NMFS",2006,4,19,109,29.98,41.837167,-70.4948,0,0,0,0,0,"AL",0.038
"15078",514,"200604.342.3610.2","NMFS",2006,4,19,109,29.98,42.024417,-70.446817,25,10,15,24,1,"AL",0.038
"15079",514,"200604.343.3600.2","NMFS",2006,4,19,109,30.13,41.934167,-70.4299,28,14,14,26,2,"AL",0.038
"15080",514,"200604.344.3600.1","NMFS",2006,4,19,109,30.08,41.894867,-70.28065,1,0,1,1,0,"AL",0.038
"15081",526,"200610.184.1100.10","NMFS",2006,9,27,270,30.08,40.232028,-69.683643,0,0,0,0,0,"AL",0.038
"15082",526,"200610.185.1100.4","NMFS",2006,9,27,270,30.1,40.223617,-69.583757,0,0,0,0,0,"AL",0.038
"15083",526,"200610.186.1100.5","NMFS",2006,9,27,270,30.05,40.1839,-69.375648,0,0,0,0,0,"AL",0.038
"15084",526,"200610.187.1100.8","NMFS",2006,9,27,270,30.03,40.063512,-69.30036,1,1,0,0,1,"AL",0.038
"15085",526,"200610.188.1110.2","NMFS",2006,9,28,271,29.87,40.187013,-68.9816,1,0,1,1,0,"AL",0.038
"15086",526,"200610.189.1110.1","NMFS",2006,9,28,271,30.07,40.221568,-68.848195,0,0,0,0,0,"AL",0.038
"15087",526,"200610.190.1100.9","NMFS",2006,9,28,271,30.03,40.312048,-68.945505,0,0,0,0,0,"AL",0.038
"15088",525,"200610.191.1130.2","NMFS",2006,9,28,271,30.05,40.613288,-68.801172,2,2,0,2,0,"AL",0.038
"15089",526,"200610.192.1100.11","NMFS",2006,9,28,271,30.07,40.516232,-69.2282,0,0,0,0,0,"AL",0.038
"15090",526,"200610.193.1100.2","NMFS",2006,9,28,271,29.93,40.559453,-69.404213,1,0,1,1,0,"AL",0.038
"15091",526,"200610.194.1100.3","NMFS",2006,9,28,271,30.08,40.47417,-69.614757,0,0,0,0,0,"AL",0.038
"15092",526,"200610.195.1090.7","NMFS",2006,9,28,271,29.98,40.771638,-69.557055,0,0,0,0,0,"AL",0.038
"15093",526,"200610.196.3550.4","NMFS",2006,9,28,271,30.07,40.890797,-69.847423,0,0,0,0,0,"AL",0.038
"15094",526,"200610.197.3550.5","NMFS",2006,9,28,271,30.03,41.066452,-69.621152,0,0,0,0,0,"AL",0.038
"15095",526,"200610.198.3550.3","NMFS",2006,9,28,271,30.05,40.968828,-69.451468,0,0,0,0,0,"AL",0.038
"15096",521,"200610.199.1250.2","NMFS",2006,9,28,271,30.03,41.094503,-69.248648,3,2,1,3,0,"AL",0.038
"15097",521,"200610.200.1250.3","NMFS",2006,9,29,272,30.03,41.012143,-69.235947,5,2,3,5,0,"AL",0.038
"15098",526,"200610.201.1100.7","NMFS",2006,9,29,272,30.03,40.939205,-69.075173,2,2,0,2,0,"AL",0.038
"15099",526,"200610.202.1100.6","NMFS",2006,9,29,272,30.05,40.98744,-68.952455,2,1,1,2,0,"AL",0.038
"15100",526,"200610.203.1130.9","NMFS",2006,9,29,272,30.18,40.866078,-68.88542,1,1,0,1,0,"AL",0.038
"15101",525,"200610.204.1190.1","NMFS",2006,9,29,272,30.02,40.7639,-68.355338,0,0,0,0,0,"AL",0.038
"15102",525,"200610.205.1130.7","NMFS",2006,9,29,272,29.98,40.771905,-68.109798,2,2,0,2,0,"AL",0.038
"15103",525,"200610.206.1140.1","NMFS",2006,9,29,272,30.1,40.438138,-67.978255,0,0,0,0,0,"AL",0.038
"15104",525,"200610.207.1140.2","NMFS",2006,9,29,272,30.07,40.426782,-67.822353,0,0,0,0,0,"AL",0.038
"15105",525,"200610.208.1130.1","NMFS",2006,9,29,272,30,40.518032,-67.81857,1,1,0,1,0,"AL",0.038
"15106",525,"200610.209.1130.5","NMFS",2006,9,29,272,30.05,40.725097,-67.74933,0,0,0,0,0,"AL",0.038
"15107",525,"200610.210.1130.3","NMFS",2006,9,29,272,30.1,40.804918,-67.69008,2,2,0,2,0,"AL",0.038
"15108",525,"200610.211.1190.8","NMFS",2006,9,30,273,30.23,40.972977,-67.981885,0,0,0,0,0,"AL",0.038
"15109",525,"200610.212.1190.2","NMFS",2006,9,30,273,30.07,41.064202,-67.832032,3,3,0,3,0,"AL",0.038
"15110",525,"200610.213.1190.7","NMFS",2006,9,30,273,30.48,41.159005,-67.513913,4,3,1,4,0,"AL",0.038
"15111",522,"200610.214.1190.6","NMFS",2006,9,30,273,30,41.398818,-67.846862,0,0,0,0,0,"AL",0.038
"15112",562,"200610.215.1190.3","NMFS",2006,9,30,273,30.15,41.559935,-67.638905,0,0,0,0,0,"AL",0.038
"15113",562,"200610.216.1190.9","NMFS",2006,9,30,273,30.07,41.440765,-67.316882,1,1,0,1,0,"AL",0.038
"15114",562,"200610.217.1190.5","NMFS",2006,9,30,273,30.05,41.311407,-67.260142,0,0,0,0,0,"AL",0.038
"15115",562,"200610.218.1190.4","NMFS",2006,9,30,273,30.05,41.234748,-67.305367,6,6,0,6,0,"AL",0.038
"15116",525,"200610.219.1160.17","NMFS",2006,9,30,273,30.02,41.158748,-67.248032,3,3,0,3,0,"AL",0.038
"15117",525,"200610.220.1130.6","NMFS",2006,9,30,273,30,40.993298,-67.318027,1,1,0,1,0,"AL",0.038
"15118",525,"200610.221.1130.4","NMFS",2006,9,30,273,30.1,40.890293,-67.174757,0,0,0,0,0,"AL",0.038
"15119",525,"200610.222.1130.8","NMFS",2006,10,1,274,30,40.767933,-66.984603,10,10,0,10,0,"AL",0.038
"15120",525,"200610.223.1140.3","NMFS",2006,10,1,274,30.03,40.677852,-67.072905,2,2,0,2,0,"AL",0.038
"15121",525,"200610.224.1150.1","NMFS",2006,10,1,274,30.03,40.63275,-66.918092,2,2,0,2,0,"AL",0.038
"15122",562,"200610.225.1170.1","NMFS",2006,10,1,274,30.1,40.890613,-66.673273,3,3,0,3,0,"AL",0.038
"15123",562,"200610.226.1160.20","NMFS",2006,10,1,274,30.03,41.055845,-66.749665,4,4,0,4,0,"AL",0.038
"15124",562,"200610.227.1160.7","NMFS",2006,10,1,274,29.98,41.146412,-66.737908,0,0,0,0,0,"AL",0.038
"15125",562,"200610.228.1160.12","NMFS",2006,10,1,274,30.02,41.2588,-66.675665,0,0,0,0,0,"AL",0.038
"15126",562,"200610.229.1160.11","NMFS",2006,10,1,274,30.1,41.30719,-66.985527,1,1,0,1,0,"AL",0.038
"15127",562,"200610.230.1160.1","NMFS",2006,10,1,274,30.03,41.66231,-67.000245,9,9,0,9,0,"AL",0.038
"15128",562,"200610.231.1160.8","NMFS",2006,10,1,274,30.08,41.808367,-66.89403,5,4,1,5,0,"AL",0.038
"15129",552,"200610.232.1160.4","NMFS",2006,10,1,274,30.03,41.772905,-66.779583,2,2,0,2,0,"AL",0.038
"15130",562,"200610.233.1160.15","NMFS",2006,10,1,274,30.15,41.471757,-66.766037,1,1,0,1,0,"AL",0.038
"15131",562,"200610.234.1160.14","NMFS",2006,10,2,275,29.9,41.3444,-66.581097,0,0,0,0,0,"AL",0.038
"15132",552,"200610.235.1160.19","NMFS",2006,10,2,275,30.22,41.262575,-66.380398,0,0,0,0,0,"AL",0.038
"15133",562,"200610.236.1180.2","NMFS",2006,10,2,275,30.1,41.11275,-66.365313,4,4,0,4,0,"AL",0.038
"15134",552,"200610.237.1170.3","NMFS",2006,10,2,275,30.03,41.436245,-66.086395,4,1,3,4,0,"AL",0.038
"15135",552,"200610.238.1170.2","NMFS",2006,10,2,275,30,41.481348,-66.051492,1,1,0,1,0,"AL",0.038
"15136",552,"200610.239.1160.9","NMFS",2006,10,2,275,30.05,41.603075,-66.107843,0,0,0,0,0,"AL",0.038
"15137",552,"200610.240.1160.6","NMFS",2006,10,2,275,29.82,41.521625,-66.378498,0,0,0,0,0,"AL",0.038
"15138",552,"200610.241.1160.2","NMFS",2006,10,2,275,31.12,41.64154,-66.454448,2,1,1,2,0,"AL",0.038
"15139",552,"200610.242.1160.16","NMFS",2006,10,2,275,30.05,41.722102,-66.37923,1,0,1,1,0,"AL",0.038
"15140",551,"200610.243.1160.3","NMFS",2006,10,2,275,30.08,41.894355,-66.495242,2,2,0,2,0,"AL",0.038
"15141",552,"200610.244.1160.18","NMFS",2006,10,2,275,30.1,41.782137,-66.12086,0,0,0,0,0,"AL",0.038
"15142",551,"200610.245.1160.13","NMFS",2006,10,3,276,30.03,41.900912,-66.175572,2,2,0,2,0,"AL",0.038
"15143",551,"200610.246.1180.1","NMFS",2006,10,3,276,30.05,42.022653,-65.851752,0,0,0,0,0,"AL",0.038
"15144",551,"200610.247.1290.3","NMFS",2006,10,3,276,30.05,42.195337,-66.121267,0,0,0,0,0,"AL",0.038
"15145",551,"200610.248.1220.2","NMFS",2006,10,3,276,30.07,42.153528,-66.245725,1,1,0,1,0,"AL",0.038
"15146",551,"200610.249.1210.3","NMFS",2006,10,3,276,29.93,42.1042,-66.363758,2,1,1,2,0,"AL",0.038
"15147",551,"200610.250.1160.10","NMFS",2006,10,3,276,30.08,42.019992,-66.498988,0,0,0,0,0,"AL",0.038
"15148",551,"200610.251.1160.5","NMFS",2006,10,3,276,30.43,41.969555,-66.974557,3,3,0,3,0,"AL",0.038
"15149",551,"200610.252.1210.4","NMFS",2006,10,3,276,30.02,42.101222,-66.892658,0,0,0,0,0,"AL",0.038
"15150",551,"200610.253.1220.4","NMFS",2006,10,3,276,30.18,42.188593,-66.621463,10,6,4,10,0,"AL",0.038
"15151",551,"200610.254.1300.1","NMFS",2006,10,4,277,30.02,42.31477,-66.77537,0,0,0,0,0,"AL",0.038
"15152",464,"200610.255.1300.2","NMFS",2006,10,4,277,30.02,42.518473,-67.010697,1,1,0,1,0,"AL",0.038
"15153",561,"200610.256.1300.3","NMFS",2006,10,4,277,30.03,42.312282,-67.370927,0,0,0,0,0,"AL",0.038
"15154",522,"200610.257.1220.1","NMFS",2006,10,4,277,30.05,42.179802,-67.711107,0,0,0,0,0,"AL",0.038
"15155",522,"200610.258.1220.3","NMFS",2006,10,4,277,27.48,42.022507,-68.025027,0,0,0,0,0,"AL",0.038
"15156",522,"200610.259.1290.2","NMFS",2006,10,4,277,30.25,42.064342,-68.147202,0,0,0,0,0,"AL",0.038
"15157",522,"200610.260.1290.1","NMFS",2006,10,4,277,29.95,41.942455,-68.21071,0,0,0,0,0,"AL",0.038
"15158",522,"200610.261.1210.1","NMFS",2006,10,4,277,30.05,41.856187,-67.981193,2,2,0,2,0,"AL",0.038
"15159",522,"200610.262.1200.1","NMFS",2006,10,4,277,30.08,41.768147,-67.899853,11,6,5,11,0,"AL",0.038
"15160",522,"200610.263.1200.6","NMFS",2006,10,4,277,30,41.769063,-68.076733,5,4,1,5,0,"AL",0.038
"15161",522,"200610.264.1200.2","NMFS",2006,10,4,277,30.05,41.602253,-67.9883,0,0,0,0,0,"AL",0.038
"15162",522,"200610.265.1200.5","NMFS",2006,10,4,277,30.07,41.321087,-68.22204,1,1,0,0,1,"AL",0.038
"15163",522,"200610.266.1200.3","NMFS",2006,10,5,278,30.03,41.410102,-68.341875,0,0,0,0,0,"AL",0.038
"15164",522,"200610.267.1230.2","NMFS",2006,10,5,278,30.02,41.394268,-68.57067,0,0,0,0,0,"AL",0.038
"15165",522,"200610.268.1200.4","NMFS",2006,10,5,278,30.02,41.234137,-68.465833,1,1,0,1,0,"AL",0.038
"15166",522,"200610.269.1230.4","NMFS",2006,10,5,278,30.08,41.140395,-68.733748,1,1,0,1,0,"AL",0.038
"15167",521,"200610.270.1240.2","NMFS",2006,10,5,278,30.1,41.264463,-69.103058,0,0,0,0,0,"AL",0.038
"15168",521,"200610.272.1240.1","NMFS",2006,10,11,284,30.03,41.556137,-69.174872,0,0,0,0,0,"AL",0.038
"15169",521,"200610.273.1240.4","NMFS",2006,10,11,284,30.05,41.551277,-68.84295,0,0,0,0,0,"AL",0.038
"15170",522,"200610.274.1230.5","NMFS",2006,10,12,285,29.98,41.64493,-68.44554,0,0,0,0,0,"AL",0.038
"15171",522,"200610.275.1210.2","NMFS",2006,10,12,285,30,41.772133,-68.31173,1,1,0,1,0,"AL",0.038
"15172",522,"200610.276.1290.7","NMFS",2006,10,12,285,30.07,41.826977,-68.418002,0,0,0,0,0,"AL",0.038
"15173",522,"200610.277.1240.3","NMFS",2006,10,12,285,29.98,41.808828,-68.723028,1,1,0,1,0,"AL",0.038
"15174",521,"200610.278.1240.5","NMFS",2006,10,12,285,29.88,41.860417,-69.048177,0,0,0,0,0,"AL",0.038
"15175",521,"200610.279.1280.1","NMFS",2006,10,12,285,30.03,42.22718,-69.420763,0,0,0,0,0,"AL",0.038
"15176",521,"200610.280.1280.5","NMFS",2006,10,12,285,30.05,42.304982,-69.421798,1,1,0,1,0,"AL",0.038
"15177",521,"200610.281.1280.4","NMFS",2006,10,12,285,30.03,42.26407,-69.181318,0,0,0,0,0,"AL",0.038
"15178",515,"200610.282.1280.2","NMFS",2006,10,13,286,30.05,42.443642,-68.91736,1,0,1,1,0,"AL",0.038
"15179",515,"200610.283.1280.6","NMFS",2006,10,13,286,29.97,42.470738,-68.75744,0,0,0,0,0,"AL",0.038
"15180",515,"200610.284.1370.2","NMFS",2006,10,13,286,30.05,42.897262,-69.017288,0,0,0,0,0,"AL",0.038
"15181",515,"200610.285.1370.4","NMFS",2006,10,13,286,30.03,43.044332,-68.924795,0,0,0,0,0,"AL",0.038
"15182",515,"200610.286.1360.6","NMFS",2006,10,13,286,30.02,42.843625,-68.400503,0,0,0,0,0,"AL",0.038
"15183",515,"200610.287.1360.2","NMFS",2006,10,13,286,30.05,42.774478,-68.345992,0,0,0,0,0,"AL",0.038
"15184",515,"200610.288.1290.5","NMFS",2006,10,13,286,30.03,42.513008,-68.492538,0,0,0,0,0,"AL",0.038
"15185",515,"200610.289.1290.6","NMFS",2006,10,13,286,30.1,42.350967,-68.149778,1,0,1,1,0,"AL",0.038
"15186",515,"200610.290.1290.8","NMFS",2006,10,14,287,30.02,42.729328,-67.876787,0,0,0,0,0,"AL",0.038
"15187",515,"200610.291.1360.7","NMFS",2006,10,14,287,30.03,43.020332,-68.096842,0,0,0,0,0,"AL",0.038
"15188",515,"200610.292.1360.5","NMFS",2006,10,14,287,29.93,43.306342,-67.87976,1,1,0,1,0,"AL",0.038
"15189",515,"200610.293.1360.4","NMFS",2006,10,14,287,30.02,43.22353,-67.781473,0,0,0,0,0,"AL",0.038
"15190",464,"200610.294.1360.3","NMFS",2006,10,14,287,29.98,42.884432,-67.381112,1,1,0,1,0,"AL",0.038
"15191",464,"200610.295.1290.4","NMFS",2006,10,14,287,29.93,42.687038,-67.354185,2,2,0,2,0,"AL",0.038
"15192",465,"200610.296.1340.1","NMFS",2006,10,14,287,30.02,43.116043,-66.737855,1,1,0,1,0,"AL",0.038
"15193",465,"200610.297.1340.5","NMFS",2006,10,14,287,30.03,43.22842,-66.80387,1,1,0,1,0,"AL",0.038
"15194",465,"200610.299.1360.1","NMFS",2006,10,15,288,30.13,43.48523,-67.015482,0,0,0,0,0,"AL",0.038
"15195",465,"200610.300.1340.2","NMFS",2006,10,15,288,30.77,43.770675,-67.20176,0,0,0,0,0,"AL",0.038
"15196",465,"200610.301.1340.4","NMFS",2006,10,15,288,30.05,43.734335,-66.870128,0,0,0,0,0,"AL",0.038
"15197",465,"200610.302.1340.6","NMFS",2006,10,15,288,29.97,43.726545,-66.76019,4,0,4,4,0,"AL",0.038
"15198",465,"200610.303.1330.1","NMFS",2006,10,15,288,27.95,43.93267,-66.62357,13,8,5,13,0,"AL",0.038
"15199",465,"200610.304.1330.2","NMFS",2006,10,15,288,30.02,43.968663,-66.51693,44,26,18,44,0,"AL",0.038
"15200",466,"200610.305.1330.4","NMFS",2006,10,15,288,29.95,44.203108,-66.507022,37,22,15,31,6,"AL",0.038
"15201",511,"200610.306.1351.2","NMFS",2006,10,15,288,30.03,44.267127,-67.172242,1,0,1,1,0,"AL",0.038
"15202",511,"200610.307.1351.1","NMFS",2006,10,16,289,30.08,44.23103,-67.133068,1,1,0,1,0,"AL",0.038
"15203",511,"200610.308.1340.3","NMFS",2006,10,16,289,30,44.142227,-67.309693,0,0,0,0,0,"AL",0.038
"15204",512,"200610.309.1360.8","NMFS",2006,10,16,289,29.93,43.789373,-67.70653,1,0,1,1,0,"AL",0.038
"15205",512,"200610.310.1380.3","NMFS",2006,10,16,289,30.02,44.056362,-67.873552,6,4,2,6,0,"AL",0.038
"15206",512,"200610.311.1390.3","NMFS",2006,10,16,289,29.98,44.180137,-67.923117,53,26,27,47,6,"AL",0.038
"15207",512,"200610.312.1390.1","NMFS",2006,10,16,289,30.12,44.001805,-68.266638,15,11,4,15,0,"AL",0.038
"15208",512,"200610.313.1390.2","NMFS",2006,10,16,289,30.02,43.930547,-68.40105,11,11,0,11,0,"AL",0.038
"15209",512,"200610.314.1380.1","NMFS",2006,10,16,289,30.07,43.528155,-68.68057,0,0,0,0,0,"AL",0.038
"15210",512,"200610.315.1390.4","NMFS",2006,10,17,290,20.27,43.804678,-68.624407,3,2,1,3,0,"AL",0.038
"15211",513,"200610.316.1380.5","NMFS",2006,10,17,290,30.15,43.51747,-69.412423,2,2,0,2,0,"AL",0.038
"15212",513,"200610.317.1380.2","NMFS",2006,10,17,290,19.98,43.615075,-69.557398,1,1,0,1,0,"AL",0.038
"15213",513,"200610.318.1400.2","NMFS",2006,10,17,290,20.33,43.55079,-69.704725,3,3,0,3,0,"AL",0.038
"15214",513,"200610.319.1380.4","NMFS",2006,10,17,290,30.22,43.282605,-69.641068,0,0,0,0,0,"AL",0.038
"15215",513,"200610.320.1370.1","NMFS",2006,10,17,290,30.03,43.163725,-69.616935,0,0,0,0,0,"AL",0.038
"15216",513,"200610.321.1370.3","NMFS",2006,10,18,291,30.02,43.103147,-69.419643,0,0,0,0,0,"AL",0.038
"15217",513,"200610.322.1370.5","NMFS",2006,10,18,291,30.17,43.103865,-69.711017,0,0,0,0,0,"AL",0.038
"15218",513,"200610.323.1260.3","NMFS",2006,10,18,291,29.97,43.1468,-69.996983,0,0,0,0,0,"AL",0.038
"15219",513,"200610.324.1270.3","NMFS",2006,10,18,291,30.13,43.106035,-70.114277,1,0,1,1,0,"AL",0.038
"15220",513,"200610.325.1270.2","NMFS",2006,10,18,291,30.15,43.242068,-70.133993,1,0,1,1,0,"AL",0.038
"15221",513,"200610.326.1400.1","NMFS",2006,10,18,291,30.2,43.197332,-70.174495,11,3,8,11,0,"AL",0.038
"15222",513,"200610.327.1270.6","NMFS",2006,10,18,291,30.07,43.052703,-70.269632,1,0,1,1,0,"AL",0.038
"15223",513,"200610.328.1260.4","NMFS",2006,10,18,291,29.98,42.897605,-70.145967,0,0,0,0,0,"AL",0.038
"15224",514,"200610.329.1270.1","NMFS",2006,10,18,291,30.08,42.80975,-70.12164,0,0,0,0,0,"AL",0.038
"15225",513,"200610.330.1270.7","NMFS",2006,10,18,291,29.98,42.953147,-69.988713,0,0,0,0,0,"AL",0.038
"15226",513,"200610.331.1280.3","NMFS",2006,10,19,292,30.07,42.894798,-69.845083,0,0,0,0,0,"AL",0.038
"15227",514,"200610.332.1280.7","NMFS",2006,10,19,292,30.15,42.728885,-69.717035,1,1,0,1,0,"AL",0.038
"15228",514,"200610.333.1260.5","NMFS",2006,10,19,292,21.93,42.561443,-70.141792,1,1,0,1,0,"AL",0.038
"15229",514,"200610.334.1260.7","NMFS",2006,10,19,292,30.22,42.777688,-70.355242,2,0,2,2,0,"AL",0.038
"15230",513,"200610.336.1270.8","NMFS",2006,10,19,292,30.1,42.84623,-70.443363,0,0,0,0,0,"AL",0.038
"15231",513,"200610.337.1400.3","NMFS",2006,10,19,292,30.12,42.875995,-70.622147,42,15,27,41,1,"AL",0.038
"15232",514,"200610.338.3650.1","NMFS",2006,10,19,292,30.03,42.762435,-70.667215,4,1,3,4,0,"AL",0.038
"15233",514,"200610.340.3660.5","NMFS",2006,10,19,292,20.67,42.659988,-70.466657,3,3,0,3,0,"AL",0.038
"15234",514,"200610.341.3660.3","NMFS",2006,10,19,292,30.03,42.52343,-70.62023,48,13,35,40,8,"AL",0.038
"15235",514,"200610.342.3660.4","NMFS",2006,10,19,292,26.97,42.44741,-70.715495,15,9,6,15,0,"AL",0.038
"15236",514,"200610.343.1260.1","NMFS",2006,10,20,293,30.08,42.372025,-70.518562,3,0,3,3,0,"AL",0.038
"15237",514,"200610.344.3580.1","NMFS",2006,10,24,297,30.05,41.757357,-70.320387,8,4,4,6,2,"AL",0.038
"15238",514,"200610.345.3590.1","NMFS",2006,10,24,297,30.12,41.833545,-70.275705,17,7,10,16,1,"AL",0.038
"15239",514,"200610.346.3610.4","NMFS",2006,10,24,297,30.2,42.013517,-70.226943,5,2,3,5,0,"AL",0.038
"15240",514,"200610.347.3610.3","NMFS",2006,10,24,297,30.03,42.024777,-70.337892,21,9,12,19,2,"AL",0.038
"15241",514,"200610.348.3600.1","NMFS",2006,10,24,297,30.03,41.945992,-70.486218,40,19,21,24,16,"AL",0.038
"15242",514,"200610.349.3600.2","NMFS",2006,10,24,297,20.32,41.98336,-70.451115,23,10,13,16,7,"AL",0.038
"15243",514,"200610.350.3610.2","NMFS",2006,10,24,297,27.58,42.085358,-70.461298,13,4,9,12,1,"AL",0.038
"15244",514,"200610.351.1260.8","NMFS",2006,10,24,297,29.97,42.144473,-70.378232,2,0,2,2,0,"AL",0.038
"15245",514,"200610.353.3660.6","NMFS",2006,10,24,297,30.05,42.227683,-70.52337,2,1,1,2,0,"AL",0.038
"15246",514,"200610.354.3640.1","NMFS",2006,10,24,297,20.32,42.405725,-70.794917,33,19,14,31,2,"AL",0.038
"15247",514,"200610.356.1260.6","NMFS",2006,10,25,298,30.02,42.407048,-70.281758,2,1,1,2,0,"AL",0.038
"15248",514,"200610.357.1260.2","NMFS",2006,10,25,298,30.05,42.359615,-70.212972,3,1,2,3,0,"AL",0.038
"15249",514,"200610.358.3610.1","NMFS",2006,10,25,298,30.02,42.108895,-70.150213,12,9,3,12,0,"AL",0.038
"15250",521,"200610.359.1270.4","NMFS",2006,10,25,298,30.05,42.145527,-69.780033,1,1,0,1,0,"AL",0.038
"15251",521,"200610.360.3560.1","NMFS",2006,10,25,298,30.02,41.848205,-69.915773,17,12,5,11,6,"AL",0.038
"15252",521,"200610.361.1240.6","NMFS",2006,10,25,298,30.1,41.80595,-69.442648,0,0,0,0,0,"AL",0.038
"15253",521,"200610.363.1230.6","NMFS",2006,10,25,298,30.05,41.64979,-69.563248,0,0,0,0,0,"AL",0.038
"15254",521,"200610.364.1250.4","NMFS",2006,10,25,298,29.97,41.444867,-69.583128,7,5,2,7,0,"AL",0.038
"15255",521,"200610.366.1250.1","NMFS",2006,10,25,298,30.03,41.399422,-69.370873,1,1,0,1,0,"AL",0.038
"15256",526,"200610.367.3550.2","NMFS",2006,10,26,299,20,41.14409,-69.502675,2,2,0,2,0,"AL",0.038
"15257",526,"200703.192.1090.4","NMFS",2007,3,30,89,30.02,40.77963,-69.750342,0,0,0,0,0,"AL",0.038
"15258",526,"200703.193.1100.5","NMFS",2007,3,30,89,30.02,40.612338,-69.608308,0,0,0,0,0,"AL",0.038
"15259",526,"200703.194.1100.8","NMFS",2007,3,30,89,30.02,40.428273,-69.778283,0,0,0,0,0,"AL",0.038
"15260",526,"200703.198.1110.1","NMFS",2007,3,30,89,30.02,40.066627,-69.789582,0,0,0,0,0,"AL",0.038
"15261",526,"200703.199.1110.2","NMFS",2007,3,30,89,30.05,39.976983,-69.338807,0,0,0,0,0,"AL",0.038
"15262",526,"200703.200.1100.3","NMFS",2007,3,31,90,30.08,40.52834,-68.890127,0,0,0,0,0,"AL",0.038
"15263",525,"200703.201.1140.2","NMFS",2007,3,31,90,30.05,40.234867,-68.75243,0,0,0,0,0,"AL",0.038
"15264",525,"200703.202.1140.1","NMFS",2007,3,31,90,30.02,40.27067,-68.430437,0,0,0,0,0,"AL",0.038
"15265",525,"200703.203.1130.6","NMFS",2007,3,31,90,30,40.389803,-68.492035,0,0,0,0,0,"AL",0.038
"15266",525,"200703.204.1150.1","NMFS",2007,3,31,90,30,40.449905,-68.143822,3,2,1,3,0,"AL",0.038
"15267",525,"200703.205.1130.8","NMFS",2007,3,31,90,30.07,40.565985,-68.222613,0,0,0,0,0,"AL",0.038
"15268",525,"200703.206.1130.5","NMFS",2007,3,31,90,30.05,40.599507,-68.090918,0,0,0,0,0,"AL",0.038
"15269",525,"200703.207.1130.7","NMFS",2007,3,31,90,30.03,40.76867,-67.951798,1,1,0,1,0,"AL",0.038
"15270",525,"200703.208.1130.3","NMFS",2007,3,31,90,30.03,40.768283,-67.877323,0,0,0,0,0,"AL",0.038
"15271",525,"200703.209.1130.9","NMFS",2007,3,31,90,30.03,40.969077,-67.723915,0,0,0,0,0,"AL",0.038
"15272",525,"200703.210.1190.1","NMFS",2007,3,31,90,30.02,41.140062,-67.555867,0,0,0,0,0,"AL",0.038
"15273",562,"200703.211.1190.4","NMFS",2007,3,31,90,30.05,41.30824,-67.648412,0,0,0,0,0,"AL",0.038
"15274",562,"200703.212.1190.9","NMFS",2007,4,1,91,30,41.523398,-67.625853,0,0,0,0,0,"AL",0.038
"15275",562,"200703.213.1190.8","NMFS",2007,4,1,91,30.17,41.327465,-67.40708,0,0,0,0,0,"AL",0.038
"15276",525,"200703.214.1130.4","NMFS",2007,4,1,91,30.03,41.023277,-67.416127,0,0,0,0,0,"AL",0.038
"15277",525,"200703.215.1130.2","NMFS",2007,4,1,91,30.07,40.766643,-67.080705,0,0,0,0,0,"AL",0.038
"15278",525,"200703.216.1140.3","NMFS",2007,4,1,91,30.03,40.558345,-67.155847,0,0,0,0,0,"AL",0.038
"15279",562,"200703.217.1180.2","NMFS",2007,4,1,91,26.35,40.85218,-66.64237,1,1,0,1,0,"AL",0.038
"15280",562,"200703.218.1170.2","NMFS",2007,4,1,91,30.08,40.892433,-66.668993,0,0,0,0,0,"AL",0.038
"15281",562,"200703.219.1160.19","NMFS",2007,4,1,91,30.03,41.020098,-66.716838,0,0,0,0,0,"AL",0.038
"15282",562,"200703.220.1160.3","NMFS",2007,4,1,91,30.03,41.133127,-66.841123,0,0,0,0,0,"AL",0.038
"15283",562,"200703.221.1160.13","NMFS",2007,4,1,91,30,41.178268,-66.889597,0,0,0,0,0,"AL",0.038
"15284",562,"200703.222.1160.12","NMFS",2007,4,1,91,30.02,41.227368,-66.824947,0,0,0,0,0,"AL",0.038
"15285",562,"200703.223.1160.14","NMFS",2007,4,1,91,30.03,41.23395,-66.619643,0,0,0,0,0,"AL",0.038
"15286",562,"200703.224.1160.6","NMFS",2007,4,2,92,30.07,41.396102,-66.551185,0,0,0,0,0,"AL",0.038
"15287",562,"200703.225.1160.20","NMFS",2007,4,2,92,30.05,41.352708,-66.765282,0,0,0,0,0,"AL",0.038
"15288",562,"200703.226.1160.8","NMFS",2007,4,2,92,30.05,41.477345,-66.968597,0,0,0,0,0,"AL",0.038
"15289",562,"200703.227.1190.2","NMFS",2007,4,2,92,30.03,41.680355,-67.253015,1,1,0,1,0,"AL",0.038
"15290",562,"200703.228.1160.16","NMFS",2007,4,2,92,30.07,41.600705,-66.988143,0,0,0,0,0,"AL",0.038
"15291",552,"200703.229.1160.17","NMFS",2007,4,2,92,30.03,41.682028,-66.718815,0,0,0,0,0,"AL",0.038
"15292",552,"200703.230.1160.9","NMFS",2007,4,2,92,30.07,41.766983,-66.567772,0,0,0,0,0,"AL",0.038
"15293",552,"200703.231.1160.5","NMFS",2007,4,2,92,30.03,41.81146,-66.500907,3,2,1,3,0,"AL",0.038
"15294",552,"200703.232.1160.15","NMFS",2007,4,2,92,20.1,41.82252,-66.25693,0,0,0,0,0,"AL",0.038
"15295",552,"200703.233.1160.4","NMFS",2007,4,2,92,29.97,41.73791,-66.170007,0,0,0,0,0,"AL",0.038
"15296",552,"200703.234.1160.2","NMFS",2007,4,2,92,30.03,41.560057,-66.375365,0,0,0,0,0,"AL",0.038
"15297",552,"200703.235.1160.11","NMFS",2007,4,2,92,30.07,41.316222,-66.322457,1,0,1,1,0,"AL",0.038
"15298",552,"200703.236.1170.1","NMFS",2007,4,2,92,30.05,41.310517,-66.249392,8,7,1,8,0,"AL",0.038
"15299",552,"200703.237.1180.1","NMFS",2007,4,3,93,30.02,41.512372,-65.947335,1,1,0,1,0,"AL",0.038
"15300",552,"200703.238.1160.10","NMFS",2007,4,3,93,30.07,41.639015,-65.989378,4,4,0,4,0,"AL",0.038
"15301",552,"200703.239.1160.7","NMFS",2007,4,3,93,30.03,41.722717,-65.928273,6,5,1,6,0,"AL",0.038
"15302",552,"200703.240.1170.3","NMFS",2007,4,3,93,30,41.679182,-65.819857,12,12,0,12,0,"AL",0.038
"15303",464,"200703.241.1290.6","NMFS",2007,4,3,93,30.05,42.18188,-65.766528,0,0,0,0,0,"AL",0.038
"15304",464,"200703.242.1290.8","NMFS",2007,4,3,93,30.05,42.264358,-65.708278,3,2,1,3,0,"AL",0.038
"15305",464,"200703.243.1290.1","NMFS",2007,4,3,93,30.02,42.439283,-66.162883,1,0,1,1,0,"AL",0.038
"15306",464,"200703.244.1290.3","NMFS",2007,4,3,93,30,42.349218,-66.32329,2,2,0,2,0,"AL",0.038
"15307",551,"200703.245.1290.7","NMFS",2007,4,4,94,30.02,42.242883,-66.031597,2,2,0,2,0,"AL",0.038
"15308",551,"200703.246.1210.3","NMFS",2007,4,4,94,30.02,42.1103,-66.141855,4,2,2,4,0,"AL",0.038
"15309",551,"200703.247.1220.3","NMFS",2007,4,4,94,30.02,42.147535,-66.387655,6,5,1,6,0,"AL",0.038
"15310",551,"200703.248.1160.1","NMFS",2007,4,4,94,30.03,42.056452,-66.612937,1,0,1,1,0,"AL",0.038
"15311",551,"200703.249.1160.18","NMFS",2007,4,4,94,30,41.976013,-66.8807,0,0,0,0,0,"AL",0.038
"15312",551,"200703.250.1210.4","NMFS",2007,4,4,94,30.08,42.141165,-66.772445,0,0,0,0,0,"AL",0.038
"15313",551,"200703.251.1220.1","NMFS",2007,4,4,94,30.03,42.184243,-66.772815,19,11,8,19,0,"AL",0.038
"15314",551,"200703.252.1300.1","NMFS",2007,4,4,94,30.03,42.304423,-66.889845,4,4,0,4,0,"AL",0.038
"15315",464,"200703.253.1300.3","NMFS",2007,4,4,94,30,42.387645,-66.929192,15,13,2,15,0,"AL",0.038
"15316",464,"200703.254.1300.2","NMFS",2007,4,4,94,29.97,42.449432,-67.399698,2,1,1,2,0,"AL",0.038
"15317",561,"200703.255.1210.1","NMFS",2007,4,5,95,30.03,42.144447,-67.246775,0,0,0,0,0,"AL",0.038
"15318",561,"200703.256.1200.5","NMFS",2007,4,5,95,30.02,41.978537,-67.268112,0,0,0,0,0,"AL",0.038
"15319",561,"200703.257.1210.2","NMFS",2007,4,5,95,21.47,42.098688,-67.430355,0,0,0,0,0,"AL",0.038
"15320",521,"200703.260.1230.1","NMFS",2007,4,10,100,30.03,41.880102,-69.80986,0,0,0,0,0,"AL",0.038
"15321",521,"200703.261.1240.1","NMFS",2007,4,10,100,30.07,41.826992,-69.757503,0,0,0,0,0,"AL",0.038
"15322",521,"200703.262.1250.4","NMFS",2007,4,10,100,30.05,41.609773,-69.717152,0,0,0,0,0,"AL",0.038
"15323",521,"200703.263.1250.1","NMFS",2007,4,10,100,30.03,41.318977,-69.386902,0,0,0,0,0,"AL",0.038
"15324",521,"200703.264.1250.2","NMFS",2007,4,10,100,30.03,41.063723,-69.269972,0,0,0,0,0,"AL",0.038
"15325",526,"200703.265.1090.2","NMFS",2007,4,10,100,30.02,40.880198,-69.388367,0,0,0,0,0,"AL",0.038
"15326",526,"200703.266.1100.2","NMFS",2007,4,10,100,30.12,40.897767,-69.051612,0,0,0,0,0,"AL",0.038
"15327",526,"200703.267.1130.1","NMFS",2007,4,10,100,30.05,40.862402,-68.856895,0,0,0,0,0,"AL",0.038
"15328",525,"200703.268.1190.3","NMFS",2007,4,10,100,30,40.807413,-68.505202,0,0,0,0,0,"AL",0.038
"15329",525,"200703.269.1190.5","NMFS",2007,4,10,100,30.05,40.971328,-68.397358,0,0,0,0,0,"AL",0.038
"15330",522,"200703.270.1230.3","NMFS",2007,4,11,101,30.03,41.141373,-68.774492,5,4,1,5,0,"AL",0.038
"15331",521,"200703.271.1230.2","NMFS",2007,4,11,101,30.08,41.098413,-68.942013,1,1,0,1,0,"AL",0.038
"15332",521,"200703.272.1230.5","NMFS",2007,4,11,101,30.1,41.103685,-69.006937,1,1,0,1,0,"AL",0.038
"15333",521,"200703.273.1230.4","NMFS",2007,4,11,101,29.98,41.068245,-69.0828,0,0,0,0,0,"AL",0.038
"15334",521,"200703.274.1240.6","NMFS",2007,4,11,101,30.03,41.563882,-68.971108,0,0,0,0,0,"AL",0.038
"15335",522,"200703.275.1240.3","NMFS",2007,4,11,101,30.02,41.694615,-68.759685,2,2,0,2,0,"AL",0.038
"15336",522,"200703.276.1200.4","NMFS",2007,4,11,101,30.02,41.608365,-68.415155,0,0,0,0,0,"AL",0.038
"15337",522,"200703.277.1200.1","NMFS",2007,4,11,101,30.05,41.449193,-68.282348,0,0,0,0,0,"AL",0.038
"15338",522,"200703.278.1200.6","NMFS",2007,4,11,101,30.13,41.407952,-68.150503,0,0,0,0,0,"AL",0.038
"15339",525,"200703.279.1190.6","NMFS",2007,4,11,101,30.07,41.15314,-68.080342,0,0,0,0,0,"AL",0.038
"15340",522,"200703.280.1190.7","NMFS",2007,4,11,101,30,41.392213,-67.975328,0,0,0,0,0,"AL",0.038
"15341",522,"200703.281.1200.3","NMFS",2007,4,12,102,30.05,41.620227,-67.902547,0,0,0,0,0,"AL",0.038
"15342",522,"200703.282.1200.2","NMFS",2007,4,12,102,29.98,41.840575,-67.745158,1,0,1,1,0,"AL",0.038
"15343",522,"200703.283.1220.2","NMFS",2007,4,12,102,30.05,42.192122,-67.735055,0,0,0,0,0,"AL",0.038
"15344",522,"200703.284.1220.4","NMFS",2007,4,12,102,30.03,41.987648,-67.961615,0,0,0,0,0,"AL",0.038
"15345",522,"200703.285.1240.5","NMFS",2007,4,12,102,30.05,41.971742,-68.445428,0,0,0,0,0,"AL",0.038
"15346",522,"200703.286.1240.4","NMFS",2007,4,12,102,30.07,42.139642,-68.505907,0,0,0,0,0,"AL",0.038
"15347",522,"200703.287.1240.2","NMFS",2007,4,12,102,30.02,42.185952,-68.608445,0,0,0,0,0,"AL",0.038
"15348",515,"200703.288.1290.2","NMFS",2007,4,12,102,30.03,42.393652,-68.213653,1,1,0,1,0,"AL",0.038
"15349",515,"200703.289.1290.5","NMFS",2007,4,12,102,30.05,42.506277,-68.458815,0,0,0,0,0,"AL",0.038
"15350",515,"200703.290.1290.4","NMFS",2007,4,12,102,30.08,42.716345,-68.293578,0,0,0,0,0,"AL",0.038
"15351",515,"200703.291.1360.6","NMFS",2007,4,13,103,30.07,42.777713,-68.28776,3,2,1,3,0,"AL",0.038
"15352",515,"200703.292.1360.8","NMFS",2007,4,13,103,30.02,42.92023,-68.41602,0,0,0,0,0,"AL",0.038
"15353",515,"200703.294.1360.9","NMFS",2007,4,13,103,30.03,43.150327,-68.077967,1,1,0,1,0,"AL",0.038
"15354",464,"200703.295.1360.1","NMFS",2007,4,13,103,30.03,42.94013,-67.506953,3,3,0,3,0,"AL",0.038
"15355",465,"200703.296.1360.4","NMFS",2007,4,14,104,30.03,43.107317,-67.51413,4,2,2,4,0,"AL",0.038
"15356",465,"200703.297.1360.3","NMFS",2007,4,14,104,30.05,43.289425,-67.46331,0,0,0,0,0,"AL",0.038
"15357",465,"200703.298.1340.3","NMFS",2007,4,14,104,30.02,43.17793,-66.664193,0,0,0,0,0,"AL",0.038
"15358",465,"200703.299.1330.1","NMFS",2007,4,14,104,20.15,43.272903,-66.424397,2,1,1,2,0,"AL",0.038
"15359",465,"200703.300.1330.4","NMFS",2007,4,14,104,30.03,43.413085,-66.452265,8,6,2,8,0,"AL",0.038
"15360",465,"200703.301.1340.1","NMFS",2007,4,14,104,30.07,43.466528,-66.619293,2,2,0,2,0,"AL",0.038
"15361",465,"200703.302.1340.5","NMFS",2007,4,14,104,30.03,43.575362,-66.52844,8,4,4,8,0,"AL",0.038
"15362",465,"200703.303.1340.6","NMFS",2007,4,15,105,30.02,43.762253,-67.02998,2,0,2,2,0,"AL",0.038
"15363",511,"200703.304.1340.4","NMFS",2007,4,15,105,30.15,43.97747,-66.929322,0,0,0,0,0,"AL",0.038
"15364",465,"200703.305.1330.2","NMFS",2007,4,15,105,30.08,43.879465,-66.592633,2,1,1,2,0,"AL",0.038
"15365",466,"200703.306.1330.3","NMFS",2007,4,15,105,30.02,44.026628,-66.519542,4,2,2,4,0,"AL",0.038
"15366",466,"200703.307.1351.1","NMFS",2007,4,15,105,30.02,44.103278,-66.764877,1,0,1,1,0,"AL",0.038
"15367",511,"200703.308.1340.2","NMFS",2007,4,15,105,30.02,44.15175,-67.190342,4,2,2,4,0,"AL",0.038
"15368",511,"200703.309.1351.2","NMFS",2007,4,15,105,30.02,44.385102,-67.081033,0,0,0,0,0,"AL",0.038
"15369",511,"200703.310.1390.4","NMFS",2007,4,18,108,30.03,44.241175,-67.743417,0,0,0,0,0,"AL",0.038
"15370",511,"200703.311.1360.7","NMFS",2007,4,18,108,30.02,44.059327,-67.63036,1,1,0,1,0,"AL",0.038
"15371",512,"200703.313.1390.2","NMFS",2007,4,19,109,30.03,43.924982,-68.64995,27,15,12,25,2,"AL",0.038
"15372",512,"200703.314.1390.1","NMFS",2007,4,19,109,20.1,43.74614,-68.885305,49,26,23,43,6,"AL",0.038
"15373",512,"200703.315.1390.3","NMFS",2007,4,19,109,30.05,43.741322,-68.931907,57,36,21,33,24,"AL",0.038
"15374",512,"200703.316.1380.1","NMFS",2007,4,19,109,30.03,43.562498,-68.768767,2,2,0,2,0,"AL",0.038
"15375",513,"200703.317.1380.4","NMFS",2007,4,19,109,30.03,43.549922,-69.031947,10,6,4,10,0,"AL",0.038
"15376",513,"200703.319.1400.3","NMFS",2007,4,19,109,30.05,43.695643,-69.47552,3,2,1,3,0,"AL",0.038
"15377",514,"200703.320.3580.1","NMFS",2007,4,24,114,30.03,41.775128,-70.423403,6,3,3,5,1,"AL",0.038
"15378",514,"200703.321.3590.1","NMFS",2007,4,24,114,30.03,41.798413,-70.406943,6,3,3,3,3,"AL",0.038
"15379",514,"200703.322.3600.1","NMFS",2007,4,24,114,30.03,41.888655,-70.35257,27,7,20,24,3,"AL",0.038
"15380",514,"200703.323.3600.2","NMFS",2007,4,24,114,30.03,41.923185,-70.31613,44,12,32,39,5,"AL",0.038
"15381",514,"200703.324.3610.2","NMFS",2007,4,24,114,30.05,42.131532,-70.491213,5,2,3,4,1,"AL",0.038
"15382",514,"200703.325.1260.4","NMFS",2007,4,24,114,30.08,42.17838,-70.373892,1,1,0,1,0,"AL",0.038
"15383",514,"200703.326.1260.5","NMFS",2007,4,24,114,30.08,42.26298,-70.384612,2,1,1,2,0,"AL",0.038
"15384",514,"200703.327.1260.2","NMFS",2007,4,24,114,30.05,42.355265,-70.325687,0,0,0,0,0,"AL",0.038
"15385",514,"200703.329.3640.1","NMFS",2007,4,24,114,20.03,42.308627,-70.756777,13,9,4,11,2,"AL",0.038
"15386",514,"200703.330.3650.1","NMFS",2007,4,24,114,30.02,42.491518,-70.73975,29,16,13,29,0,"AL",0.038
"15387",514,"200703.331.3660.3","NMFS",2007,4,24,114,30.05,42.473558,-70.654335,10,3,7,10,0,"AL",0.038
"15388",514,"200703.332.1260.1","NMFS",2007,4,25,115,30.13,42.603853,-70.250935,0,0,0,0,0,"AL",0.038
"15389",514,"200703.333.1260.3","NMFS",2007,4,25,115,30.03,42.721127,-70.318553,1,1,0,1,0,"AL",0.038
"15390",514,"200703.334.3660.2","NMFS",2007,4,25,115,22.1,42.675932,-70.44868,2,0,2,2,0,"AL",0.038
"15391",514,"200703.335.3630.1","NMFS",2007,4,25,115,30.1,42.694163,-70.66917,1,1,0,1,0,"AL",0.038
"15392",514,"200703.336.1400.2","NMFS",2007,4,25,115,30.02,42.792858,-70.645757,5,3,2,5,0,"AL",0.038
"15393",513,"200703.337.1270.2","NMFS",2007,4,25,115,30.07,42.884702,-70.342043,9,8,1,9,0,"AL",0.038
"15394",513,"200703.338.1400.1","NMFS",2007,4,25,115,30.02,42.97211,-70.41514,3,0,3,3,0,"AL",0.038
"15395",513,"200703.339.1270.1","NMFS",2007,4,25,115,30.08,43.0732,-70.206132,3,2,1,3,0,"AL",0.038
"15396",513,"200703.340.1280.7","NMFS",2007,4,25,115,30.02,43.066367,-69.929297,0,0,0,0,0,"AL",0.038
"15397",513,"200703.341.1380.3","NMFS",2007,4,25,115,29.98,43.510157,-69.464705,1,1,0,1,0,"AL",0.038
"15398",513,"200703.342.1380.2","NMFS",2007,4,25,115,30.07,43.436598,-69.196793,1,1,0,1,0,"AL",0.038
"15399",515,"200703.343.1370.1","NMFS",2007,4,26,116,30,43.030905,-68.811522,2,2,0,2,0,"AL",0.038
"15400",515,"200703.344.1370.3","NMFS",2007,4,26,116,30,42.948145,-69.295137,0,0,0,0,0,"AL",0.038
"15401",515,"200703.345.1370.4","NMFS",2007,4,26,116,30.05,42.689158,-69.202327,1,1,0,1,0,"AL",0.038
"15402",515,"200703.346.1370.5","NMFS",2007,4,26,116,30.02,42.613135,-68.97188,0,0,0,0,0,"AL",0.038
"15403",515,"200703.347.1370.2","NMFS",2007,4,26,116,30.02,42.64984,-68.803497,0,0,0,0,0,"AL",0.038
"15404",515,"200703.348.1280.2","NMFS",2007,4,26,116,29.92,42.536925,-68.942475,0,0,0,0,0,"AL",0.038
"15405",515,"200703.349.1280.3","NMFS",2007,4,26,116,29.97,42.45617,-68.994138,0,0,0,0,0,"AL",0.038
"15406",521,"200703.350.1280.5","NMFS",2007,4,26,116,30.03,42.26793,-69.436395,0,0,0,0,0,"AL",0.038
"15407",515,"200703.351.1280.1","NMFS",2007,4,26,116,30,42.605735,-69.605843,0,0,0,0,0,"AL",0.038
"15408",515,"200703.352.1280.4","NMFS",2007,4,27,117,30.05,42.643362,-69.660327,1,1,0,1,0,"AL",0.038
"15409",514,"200703.353.1270.3","NMFS",2007,4,27,117,30.02,42.621668,-69.958123,5,5,0,5,0,"AL",0.038
"15410",514,"200703.354.1280.6","NMFS",2007,4,27,117,30.02,42.528457,-69.881173,6,6,0,6,0,"AL",0.038
"15411",521,"200703.355.1270.4","NMFS",2007,4,27,117,30.03,42.107147,-69.91125,6,3,3,6,0,"AL",0.038
"15412",514,"200703.356.3610.1","NMFS",2007,4,27,117,30.02,42.105193,-70.15392,14,5,9,13,1,"AL",0.038
"15413",514,"200703.357.3560.1","NMFS",2007,4,27,117,30.08,42.030072,-70.025223,5,0,5,5,0,"AL",0.038
"15414",521,"200703.358.3550.3","NMFS",2007,4,27,117,29.98,41.456512,-69.666502,0,0,0,0,0,"AL",0.038
"15415",521,"200703.359.3550.1","NMFS",2007,4,27,117,30.02,41.367975,-69.57351,3,3,0,3,0,"AL",0.038
"15416",521,"200703.360.3550.5","NMFS",2007,4,27,117,28.4,41.170458,-69.554298,0,0,0,0,0,"AL",0.038
"15417",526,"200703.361.3550.4","NMFS",2007,4,27,117,30.05,41.118763,-69.540263,1,0,1,1,0,"AL",0.038
"15418",521,"200703.363.3550.6","NMFS",2007,4,27,117,30.02,41.07503,-69.404175,4,1,3,2,2,"AL",0.038
"15419",526,"200709.179.1100.6","NMFS",2007,10,5,278,30.08,40.407842,-69.90408,1,1,0,1,0,"AL",0.038
"15420",526,"200709.180.1100.7","NMFS",2007,10,5,278,29.93,40.103328,-69.601532,0,0,0,0,0,"AL",0.038
"15421",526,"200709.182.1120.2","NMFS",2007,10,5,278,25.65,39.979613,-69.251497,4,1,3,3,1,"AL",0.038
"15422",526,"200709.183.1110.1","NMFS",2007,10,5,278,30,40.187758,-68.983503,0,0,0,0,0,"AL",0.038
"15423",526,"200709.184.1100.5","NMFS",2007,10,5,278,30.23,40.28403,-68.916867,0,0,0,0,0,"AL",0.038
"15424",526,"200709.185.1100.3","NMFS",2007,10,5,278,30.05,40.643923,-68.98289,0,0,0,0,0,"AL",0.038
"15425",526,"200709.186.1100.1","NMFS",2007,10,5,278,30.03,40.732,-69.103007,2,2,0,2,0,"AL",0.038
"15426",526,"200709.187.1090.2","NMFS",2007,10,5,278,30.02,40.814587,-69.379713,0,0,0,0,0,"AL",0.038
"15427",521,"200709.188.3550.3","NMFS",2007,10,5,278,22.85,41.078027,-69.486733,0,0,0,0,0,"AL",0.038
"15428",526,"200709.189.1100.2","NMFS",2007,10,6,279,30.55,40.979333,-69.166658,2,1,1,2,0,"AL",0.038
"15429",525,"200709.190.1130.9","NMFS",2007,10,6,279,29.97,40.988827,-68.827363,0,0,0,0,0,"AL",0.038
"15430",525,"200709.191.1130.7","NMFS",2007,10,6,279,30.08,40.564715,-68.524995,0,0,0,0,0,"AL",0.038
"15431",525,"200709.192.1130.3","NMFS",2007,10,6,279,30,40.725893,-68.089498,0,0,0,0,0,"AL",0.038
"15432",525,"200709.193.1190.6","NMFS",2007,10,6,279,30.18,41.071208,-67.875993,0,0,0,0,0,"AL",0.038
"15433",525,"200709.194.1130.5","NMFS",2007,10,6,279,30.13,40.81435,-67.870188,0,0,0,0,0,"AL",0.038
"15434",525,"200709.195.1130.1","NMFS",2007,10,6,279,30.03,40.52269,-67.88493,0,0,0,0,0,"AL",0.038
"15435",525,"200709.196.1150.1","NMFS",2007,10,6,279,29.93,40.30896,-67.938437,2,1,1,2,0,"AL",0.038
"15436",525,"200709.197.1140.2","NMFS",2007,10,6,279,30.08,40.434608,-67.729515,2,2,0,2,0,"AL",0.038
"15437",525,"200709.198.1140.3","NMFS",2007,10,7,280,30.05,40.51979,-67.645775,6,6,0,6,0,"AL",0.038
"15438",525,"200709.199.1130.2","NMFS",2007,10,7,280,30.15,40.603815,-67.613423,0,0,0,0,0,"AL",0.038
"15439",525,"200709.200.1130.6","NMFS",2007,10,7,280,30.07,40.567688,-67.49443,1,1,0,1,0,"AL",0.038
"15440",525,"200709.201.1130.4","NMFS",2007,10,7,280,30.07,40.81142,-67.4589,0,0,0,0,0,"AL",0.038
"15441",525,"200709.202.1130.8","NMFS",2007,10,7,280,29.98,40.773555,-67.223175,0,0,0,0,0,"AL",0.038
"15442",525,"200709.203.1140.1","NMFS",2007,10,7,280,30.03,40.654197,-67.091508,7,7,0,7,0,"AL",0.038
"15443",562,"200709.204.1180.2","NMFS",2007,10,7,280,30.05,40.856932,-66.603762,0,0,0,0,0,"AL",0.038
"15444",562,"200709.205.1160.11","NMFS",2007,10,7,280,30.02,40.899832,-66.719655,0,0,0,0,0,"AL",0.038
"15445",562,"200709.206.1160.17","NMFS",2007,10,7,280,30,40.973727,-66.720102,0,0,0,0,0,"AL",0.038
"15446",562,"200709.207.1160.14","NMFS",2007,10,7,280,30,41.097033,-66.52758,1,1,0,1,0,"AL",0.038
"15447",562,"200709.208.1170.1","NMFS",2007,10,7,280,30.02,41.130352,-66.417867,0,0,0,0,0,"AL",0.038
"15448",562,"200709.209.1160.8","NMFS",2007,10,7,280,30.1,41.189272,-66.510553,2,2,0,2,0,"AL",0.038
"15449",562,"200709.210.1160.12","NMFS",2007,10,8,281,30.02,41.148298,-66.608938,0,0,0,0,0,"AL",0.038
"15450",562,"200709.211.1160.3","NMFS",2007,10,8,281,30.12,41.154727,-66.80121,0,0,0,0,0,"AL",0.038
"15451",562,"200709.212.1160.18","NMFS",2007,10,8,281,30.05,41.10712,-66.980415,0,0,0,0,0,"AL",0.038
"15452",562,"200709.213.1160.1","NMFS",2007,10,8,281,29.98,41.304567,-66.890505,0,0,0,0,0,"AL",0.038
"15453",562,"200709.214.1160.20","NMFS",2007,10,8,281,29.97,41.350278,-66.611765,1,1,0,1,0,"AL",0.038
"15454",562,"200709.215.1160.13","NMFS",2007,10,8,281,30,41.437367,-66.73713,1,1,0,1,0,"AL",0.038
"15455",562,"200709.216.1160.10","NMFS",2007,10,8,281,30,41.482048,-66.905755,5,5,0,5,0,"AL",0.038
"15456",562,"200709.217.1160.6","NMFS",2007,10,8,281,30.08,41.543235,-66.796075,4,4,0,4,0,"AL",0.038
"15457",562,"200709.218.1160.16","NMFS",2007,10,8,281,30.02,41.515157,-66.641197,1,1,0,1,0,"AL",0.038
"15458",552,"200709.219.1160.15","NMFS",2007,10,8,281,30.03,41.675132,-66.640298,1,1,0,0,1,"AL",0.038
"15459",552,"200709.220.1160.4","NMFS",2007,10,8,281,29.98,41.806347,-66.655947,2,2,0,2,0,"AL",0.038
"15460",552,"200709.221.1160.19","NMFS",2007,10,8,281,30.1,41.735507,-66.19278,0,0,0,0,0,"AL",0.038
"15461",552,"200709.222.1160.5","NMFS",2007,10,9,282,30.05,41.616538,-66.221232,2,2,0,2,0,"AL",0.038
"15462",552,"200709.223.1170.3","NMFS",2007,10,9,282,30.05,41.443038,-66.108563,0,0,0,0,0,"AL",0.038
"15463",552,"200709.224.1180.1","NMFS",2007,10,9,282,30.02,41.648618,-65.83563,2,2,0,2,0,"AL",0.038
"15464",552,"200709.225.1170.2","NMFS",2007,10,9,282,30.02,41.764368,-65.799117,0,0,0,0,0,"AL",0.038
"15465",552,"200709.226.1160.7","NMFS",2007,10,9,282,30,41.804403,-65.983033,0,0,0,0,0,"AL",0.038
"15466",551,"200709.227.1160.2","NMFS",2007,10,9,282,30.03,41.980462,-66.011447,0,0,0,0,0,"AL",0.038
"15467",551,"200709.228.1220.4","NMFS",2007,10,9,282,30.02,42.14697,-66.267143,8,6,2,8,0,"AL",0.038
"15468",464,"200709.229.1290.5","NMFS",2007,10,9,282,30.02,42.396818,-66.129705,0,0,0,0,0,"AL",0.038
"15469",464,"200709.230.1300.3","NMFS",2007,10,9,282,30.02,42.479693,-66.82722,1,1,0,1,0,"AL",0.038
"15470",464,"200709.231.1300.2","NMFS",2007,10,10,283,30.03,42.483088,-66.950885,0,0,0,0,0,"AL",0.038
"15471",551,"200709.232.1290.8","NMFS",2007,10,10,283,30.08,42.269197,-66.778103,0,0,0,0,0,"AL",0.038
"15472",551,"200709.233.1210.2","NMFS",2007,10,10,283,30.08,42.097,-66.699883,2,1,1,2,0,"AL",0.038
"15473",551,"200709.234.1160.9","NMFS",2007,10,10,283,30,41.968965,-66.807118,9,7,2,9,0,"AL",0.038
"15474",551,"200709.235.1210.1","NMFS",2007,10,10,283,30,42.097505,-66.839902,3,2,1,3,0,"AL",0.038
"15475",551,"200709.236.1220.2","NMFS",2007,10,10,283,30.02,42.184435,-67.083232,0,0,0,0,0,"AL",0.038
"15476",551,"200709.237.1290.1","NMFS",2007,10,10,283,30.22,42.26662,-67.184318,0,0,0,0,0,"AL",0.038
"15477",464,"200709.238.1300.1","NMFS",2007,10,10,283,30,42.361268,-67.253025,2,2,0,2,0,"AL",0.038
"15478",561,"200709.239.1210.4","NMFS",2007,10,10,283,30.02,42.146532,-67.373755,0,0,0,0,0,"AL",0.038
"15479",561,"200709.240.1210.3","NMFS",2007,10,10,283,29.95,42.096818,-67.436108,0,0,0,0,0,"AL",0.038
"15480",561,"200709.241.1200.2","NMFS",2007,10,10,283,29.97,41.897877,-67.598758,0,0,0,0,0,"AL",0.038
"15481",561,"200709.242.1200.3","NMFS",2007,10,10,283,30.07,41.860783,-67.43478,1,1,0,1,0,"AL",0.038
"15482",562,"200709.243.1190.1","NMFS",2007,10,11,284,30,41.78575,-67.161635,6,5,1,5,1,"AL",0.038
"15483",562,"200709.244.1190.4","NMFS",2007,10,11,284,30.1,41.695402,-67.073918,8,8,0,8,0,"AL",0.038
"15484",562,"200709.245.1190.7","NMFS",2007,10,11,284,30.37,41.596583,-67.199088,1,1,0,1,0,"AL",0.038
"15485",562,"200709.246.1190.3","NMFS",2007,10,11,284,30,41.480183,-67.3655,0,0,0,0,0,"AL",0.038
"15486",562,"200709.247.1190.9","NMFS",2007,10,11,284,30.02,41.532327,-67.61965,0,0,0,0,0,"AL",0.038
"15487",522,"200709.248.1190.5","NMFS",2007,10,11,284,30.02,41.449678,-67.795218,0,0,0,0,0,"AL",0.038
"15488",525,"200709.249.1190.2","NMFS",2007,10,11,284,30.02,41.316303,-67.710607,0,0,0,0,0,"AL",0.038
"15489",522,"200709.250.1190.8","NMFS",2007,10,11,284,29.93,41.402215,-67.904573,0,0,0,0,0,"AL",0.038
"15490",522,"200709.251.1200.6","NMFS",2007,10,11,284,30.02,41.365067,-68.131353,0,0,0,0,0,"AL",0.038
"15491",522,"200709.252.1200.5","NMFS",2007,10,11,284,30,41.21914,-68.37051,6,5,1,5,1,"AL",0.038
"15492",522,"200709.253.1200.1","NMFS",2007,10,11,284,30.05,41.269162,-68.464323,2,2,0,2,0,"AL",0.038
"15493",522,"200709.254.1230.5","NMFS",2007,10,11,284,30,41.271227,-68.605432,10,8,2,10,0,"AL",0.038
"15494",522,"200709.255.1230.2","NMFS",2007,10,11,284,30,41.161147,-68.735607,0,0,0,0,0,"AL",0.038
"15495",521,"200709.256.3550.2","NMFS",2007,10,16,289,23.05,41.664553,-69.85067,47,26,21,41,6,"AL",0.038
"15496",521,"200709.257.1240.4","NMFS",2007,10,16,289,30.05,41.821267,-69.623455,1,1,0,1,0,"AL",0.038
"15497",521,"200709.258.1240.6","NMFS",2007,10,16,289,30.03,41.823065,-69.448207,0,0,0,0,0,"AL",0.038
"15498",521,"200709.259.1240.1","NMFS",2007,10,16,289,30.02,41.604383,-69.241717,0,0,0,0,0,"AL",0.038
"15499",521,"200709.261.1250.5","NMFS",2007,10,16,289,30.07,41.48373,-69.53175,11,5,6,11,0,"AL",0.038
"15500",521,"200709.262.1250.1","NMFS",2007,10,16,289,29.63,41.489213,-69.648102,5,4,1,5,0,"AL",0.038
"15501",521,"200709.263.3550.4","NMFS",2007,10,16,289,29.98,41.340807,-69.679762,0,0,0,0,0,"AL",0.038
"15502",521,"200709.264.3550.5","NMFS",2007,10,17,290,30.1,41.206377,-69.643758,7,7,0,7,0,"AL",0.038
"15503",521,"200709.265.3550.1","NMFS",2007,10,17,290,30.05,41.251088,-69.531268,0,0,0,0,0,"AL",0.038
"15504",521,"200709.266.1250.4","NMFS",2007,10,17,290,30.05,41.259863,-69.430175,4,3,1,4,0,"AL",0.038
"15505",522,"200709.267.1230.1","NMFS",2007,10,17,290,30.03,41.351857,-68.618283,1,1,0,1,0,"AL",0.038
"15506",522,"200709.268.1230.3","NMFS",2007,10,17,290,30.45,41.477212,-68.376503,9,9,0,9,0,"AL",0.038
"15507",522,"200709.269.1200.4","NMFS",2007,10,17,290,30.07,41.650872,-68.375527,0,0,0,0,0,"AL",0.038
"15508",522,"200709.270.1230.4","NMFS",2007,10,17,290,30.12,41.562367,-68.499805,0,0,0,0,0,"AL",0.038
"15509",522,"200709.271.1240.3","NMFS",2007,10,17,290,30.03,41.601442,-68.773398,0,0,0,0,0,"AL",0.038
"15510",521,"200709.272.1240.2","NMFS",2007,10,17,290,30.07,42.059133,-69.163363,1,1,0,1,0,"AL",0.038
"15511",522,"200709.273.1240.5","NMFS",2007,10,18,291,30.13,42.023552,-68.719682,0,0,0,0,0,"AL",0.038
"15512",522,"200709.274.1220.1","NMFS",2007,10,18,291,30.02,41.864607,-68.24294,0,0,0,0,0,"AL",0.038
"15513",522,"200709.275.1220.3","NMFS",2007,10,18,291,30.02,42.057512,-67.986788,0,0,0,0,0,"AL",0.038
"15514",522,"200709.276.1290.6","NMFS",2007,10,18,291,30.05,42.137652,-68.211798,2,2,0,2,0,"AL",0.038
"15515",522,"200709.277.1290.3","NMFS",2007,10,18,291,30.15,42.312778,-67.742255,1,1,0,1,0,"AL",0.038
"15516",464,"200709.278.1290.2","NMFS",2007,10,18,291,30.25,42.355948,-67.66567,0,0,0,0,0,"AL",0.038
"15517",515,"200709.279.1290.7","NMFS",2007,10,18,291,30.05,42.569243,-68.199625,1,1,0,1,0,"AL",0.038
"15518",515,"200709.280.1280.2","NMFS",2007,10,18,291,30.07,42.466972,-68.763915,1,1,0,1,0,"AL",0.038
"15519",515,"200709.281.1280.6","NMFS",2007,10,18,291,30.02,42.559825,-68.650648,0,0,0,0,0,"AL",0.038
"15520",515,"200709.282.1370.1","NMFS",2007,10,19,292,30.17,42.6334,-69.100297,1,1,0,1,0,"AL",0.038
"15521",515,"200709.283.1280.5","NMFS",2007,10,19,292,30.08,42.691723,-69.347745,0,0,0,0,0,"AL",0.038
"15522",515,"200709.284.1370.3","NMFS",2007,10,19,292,30.05,42.925957,-69.106758,0,0,0,0,0,"AL",0.038
"15523",515,"200709.285.1370.2","NMFS",2007,10,19,292,30.05,43.002852,-68.930835,0,0,0,0,0,"AL",0.038
"15524",515,"200709.286.1370.4","NMFS",2007,10,19,292,30.07,43.261603,-68.597142,0,0,0,0,0,"AL",0.038
"15525",515,"200709.287.1380.3","NMFS",2007,10,19,292,30.1,43.270687,-68.380727,1,1,0,1,0,"AL",0.038
"15526",512,"200709.288.1380.4","NMFS",2007,10,19,292,30.03,43.48075,-68.212722,0,0,0,0,0,"AL",0.038
"15527",515,"200709.289.1360.8","NMFS",2007,10,19,292,30.07,43.071182,-68.057802,0,0,0,0,0,"AL",0.038
"15528",515,"200709.290.1360.5","NMFS",2007,10,19,292,30.02,42.888715,-67.718062,0,0,0,0,0,"AL",0.038
"15529",464,"200709.291.1290.4","NMFS",2007,10,20,293,30.03,42.643398,-66.986247,1,0,1,1,0,"AL",0.038
"15530",464,"200709.292.1360.6","NMFS",2007,10,20,293,30.02,42.809827,-66.94136,0,0,0,0,0,"AL",0.038
"15531",464,"200709.293.1360.7","NMFS",2007,10,20,293,30.12,42.94306,-67.215822,0,0,0,0,0,"AL",0.038
"15532",464,"200709.294.1360.3","NMFS",2007,10,20,293,30.02,42.981172,-67.278935,1,0,1,1,0,"AL",0.038
"15533",465,"200709.295.1340.4","NMFS",2007,10,20,293,29.58,43.098137,-66.633122,0,0,0,0,0,"AL",0.038
"15534",465,"200709.296.1330.3","NMFS",2007,10,20,293,24.05,43.225732,-66.378805,4,1,3,4,0,"AL",0.038
"15535",465,"200709.297.1330.2","NMFS",2007,10,20,293,20.05,43.29122,-66.479362,8,5,3,6,2,"AL",0.038
"15536",465,"200709.298.1340.1","NMFS",2007,10,21,294,29.97,43.26052,-66.693835,0,0,0,0,0,"AL",0.038
"15537",465,"200709.299.1340.5","NMFS",2007,10,21,294,29.98,43.48754,-66.84606,1,1,0,1,0,"AL",0.038
"15538",465,"200709.300.1360.1","NMFS",2007,10,21,294,30.02,43.486048,-67.48533,0,0,0,0,0,"AL",0.038
"15539",465,"200709.301.1360.4","NMFS",2007,10,21,294,30.05,43.730417,-67.481707,0,0,0,0,0,"AL",0.038
"15540",511,"200709.302.1340.2","NMFS",2007,10,21,294,30.17,43.94405,-67.179682,0,0,0,0,0,"AL",0.038
"15541",465,"200709.303.1340.6","NMFS",2007,10,21,294,30.02,43.824817,-66.99879,0,0,0,0,0,"AL",0.038
"15542",465,"200709.304.1330.1","NMFS",2007,10,21,294,30.02,43.778313,-66.50931,2,0,2,1,1,"AL",0.038
"15543",465,"200709.305.1330.4","NMFS",2007,10,22,295,30.1,43.893717,-66.640147,5,2,3,5,0,"AL",0.038
"15544",466,"200709.306.1340.3","NMFS",2007,10,22,295,25.03,44.020753,-66.747283,2,2,0,2,0,"AL",0.038
"15545",466,"200709.307.1351.1","NMFS",2007,10,22,295,30.1,44.349147,-66.764208,0,0,0,0,0,"AL",0.038
"15546",511,"200709.308.1351.2","NMFS",2007,10,22,295,30.03,44.316773,-67.313308,0,0,0,0,0,"AL",0.038
"15547",511,"200709.309.1360.2","NMFS",2007,10,22,295,30.32,44.104922,-67.417217,0,0,0,0,0,"AL",0.038
"15548",511,"200709.310.1390.1","NMFS",2007,10,22,295,25.98,44.284255,-67.655027,7,4,3,7,0,"AL",0.038
"15549",511,"200709.311.1390.4","NMFS",2007,10,22,295,30.08,44.236818,-67.844473,76,41,35,71,5,"AL",0.038
"15550",512,"200709.312.1380.2","NMFS",2007,10,22,295,30.02,44.025922,-67.891752,1,0,1,1,0,"AL",0.038
"15551",512,"200709.313.1390.2","NMFS",2007,10,23,296,29.97,43.86712,-68.458383,0,0,0,0,0,"AL",0.038
"15552",512,"200709.314.1390.5","NMFS",2007,10,23,296,40.53,43.846807,-68.602242,8,6,2,8,0,"AL",0.038
"15553",512,"200709.315.1390.3","NMFS",2007,10,23,296,27.82,43.79928,-68.650473,9,6,3,8,1,"AL",0.038
"15554",513,"200709.316.1400.2","NMFS",2007,10,23,296,30.12,43.76082,-69.39164,21,11,10,15,6,"AL",0.038
"15555",513,"200709.317.1400.1","NMFS",2007,10,23,296,20.03,43.51361,-69.916478,0,0,0,0,0,"AL",0.038
"15556",513,"200709.318.1270.3","NMFS",2007,10,24,297,30.12,43.31028,-70.100993,1,0,1,1,0,"AL",0.038
"15557",513,"200709.319.1400.3","NMFS",2007,10,24,297,30.07,42.954838,-70.447473,3,1,2,3,0,"AL",0.038
"15558",513,"200709.320.3640.1","NMFS",2007,10,24,297,30,42.853393,-70.757453,18,10,8,17,1,"AL",0.038
"15559",514,"200709.321.3650.1","NMFS",2007,10,24,297,30.02,42.741597,-70.675755,28,13,15,25,3,"AL",0.038
"15560",514,"200709.322.3630.1","NMFS",2007,10,24,297,20.07,42.706502,-70.721025,26,11,15,22,4,"AL",0.038
"15561",514,"200709.323.1260.1","NMFS",2007,10,24,297,30.07,42.491132,-70.534385,1,0,1,1,0,"AL",0.038
"15562",514,"200709.326.3660.4","NMFS",2007,10,24,297,30.03,42.293052,-70.594227,0,0,0,0,0,"AL",0.038
"15563",514,"200709.327.3660.1","NMFS",2007,10,25,298,20.55,42.207582,-70.51098,0,0,0,0,0,"AL",0.038
"15564",514,"200709.328.3560.1","NMFS",2007,10,25,298,20,42.022982,-70.020958,1,1,0,1,0,"AL",0.038
"15565",521,"200709.329.1250.3","NMFS",2007,10,25,298,21.18,41.887715,-69.85136,4,2,2,3,1,"AL",0.038
"15566",514,"200709.330.3610.1","NMFS",2007,10,25,298,26.48,42.125688,-70.439117,5,1,4,5,0,"AL",0.038
"15567",514,"200709.331.3610.2","NMFS",2007,10,25,298,30.23,41.963557,-70.362755,11,5,6,10,1,"AL",0.038
"15568",514,"200709.332.3600.2","NMFS",2007,10,25,298,30.05,41.952358,-70.185338,3,1,2,3,0,"AL",0.038
"15569",514,"200709.333.3590.1","NMFS",2007,10,25,298,30.05,41.906985,-70.166435,20,9,11,18,2,"AL",0.038
"15570",514,"200709.335.3580.1","NMFS",2007,10,25,298,25.05,41.764087,-70.37793,26,12,14,24,2,"AL",0.038
"15571",521,"200709.336.1280.4","NMFS",2007,10,30,303,30.07,42.264482,-69.69646,0,0,0,0,0,"AL",0.038
"15572",514,"200709.337.1280.7","NMFS",2007,10,30,303,30.12,42.34235,-69.77106,0,0,0,0,0,"AL",0.038
"15573",514,"200709.338.1260.2","NMFS",2007,10,30,303,30.12,42.357577,-70.332402,0,0,0,0,0,"AL",0.038
"15574",514,"200709.339.1260.5","NMFS",2007,10,30,303,29.97,42.433757,-70.240258,0,0,0,0,0,"AL",0.038
"15575",514,"200709.340.1260.4","NMFS",2007,10,30,303,30.02,42.508358,-70.372002,1,0,1,1,0,"AL",0.038
"15576",514,"200709.341.1260.3","NMFS",2007,10,30,303,30.03,42.762893,-70.244588,1,0,1,1,0,"AL",0.038
"15577",513,"200709.342.1270.4","NMFS",2007,10,30,303,30,42.933677,-70.28391,0,0,0,0,0,"AL",0.038
"15578",513,"200709.343.1270.1","NMFS",2007,10,31,304,30.05,42.95287,-69.984592,0,0,0,0,0,"AL",0.038
"15579",513,"200709.344.1280.1","NMFS",2007,10,31,304,30.02,42.978932,-69.825038,0,0,0,0,0,"AL",0.038
"15580",513,"200709.345.1370.5","NMFS",2007,10,31,304,30.02,43.177155,-69.562432,0,0,0,0,0,"AL",0.038
"15581",513,"200709.346.1380.5","NMFS",2007,10,31,304,30,43.506417,-69.06719,0,0,0,0,0,"AL",0.038
"15582",513,"200709.347.1380.1","NMFS",2007,10,31,304,29.97,43.393873,-69.038555,0,0,0,0,0,"AL",0.038
"15583",515,"200709.348.1280.3","NMFS",2007,10,31,304,30.02,42.818433,-69.639333,0,0,0,0,0,"AL",0.038
"15584",514,"200709.349.1270.2","NMFS",2007,11,1,305,30.03,42.811615,-69.988465,0,0,0,0,0,"AL",0.038
"15585",526,"200803.175.1110.1","NMFS",2008,4,3,94,30.03,39.9894,-69.884083,0,0,0,0,0,"AL",0.038
"15586",526,"200803.178.1100.6","NMFS",2008,4,3,94,29.95,40.517867,-69.766117,0,0,0,0,0,"AL",0.038
"15587",526,"200803.179.1100.3","NMFS",2008,4,3,94,30.08,40.440567,-69.68275,0,0,0,0,0,"AL",0.038
"15588",526,"200803.180.1100.4","NMFS",2008,4,3,94,30.12,40.32075,-69.608517,0,0,0,0,0,"AL",0.038
"15589",526,"200803.181.1100.7","NMFS",2008,4,3,94,30.02,40.275083,-69.649267,0,0,0,0,0,"AL",0.038
"15590",525,"200803.182.1150.1","NMFS",2008,4,4,95,29.87,40.12555,-68.583567,0,0,0,0,0,"AL",0.038
"15591",525,"200803.183.1140.1","NMFS",2008,4,4,95,30.02,40.260667,-68.3592,0,0,0,0,0,"AL",0.038
"15592",525,"200803.184.1140.2","NMFS",2008,4,4,95,30.07,40.345983,-68.200133,0,0,0,0,0,"AL",0.038
"15593",525,"200803.185.1130.1","NMFS",2008,4,4,95,30.1,40.607183,-67.9625,0,0,0,0,0,"AL",0.038
"15594",525,"200803.186.1130.2","NMFS",2008,4,4,95,NA,40.64535,-68.112783,0,0,0,0,0,"AL",0.038
"15595",525,"200803.187.1190.9","NMFS",2008,4,4,95,30.05,40.898483,-68.034617,0,0,0,0,0,"AL",0.038
"15596",525,"200803.188.1130.7","NMFS",2008,4,4,95,29.92,40.935317,-67.883883,0,0,0,0,0,"AL",0.038
"15597",525,"200803.189.1130.8","NMFS",2008,4,4,95,30.07,40.983717,-67.746983,0,0,0,0,0,"AL",0.038
"15598",525,"200803.190.1130.4","NMFS",2008,4,4,95,30.03,40.658067,-67.651233,0,0,0,0,0,"AL",0.038
"15599",525,"200803.191.1130.9","NMFS",2008,4,5,96,30.08,40.65295,-67.445833,0,0,0,0,0,"AL",0.038
"15600",525,"200803.192.1140.3","NMFS",2008,4,5,96,29.85,40.528067,-67.21925,0,0,0,0,0,"AL",0.038
"15601",562,"200803.193.1160.1","NMFS",2008,4,5,96,30.07,40.85765,-66.847517,0,0,0,0,0,"AL",0.038
"15602",525,"200803.194.1130.5","NMFS",2008,4,5,96,30.15,40.891,-67.010133,0,0,0,0,0,"AL",0.038
"15603",525,"200803.195.1190.6","NMFS",2008,4,5,96,30.05,41.146783,-67.643967,0,0,0,0,0,"AL",0.038
"15604",522,"200803.196.1190.7","NMFS",2008,4,5,96,30.07,41.3504,-67.684017,0,0,0,0,0,"AL",0.038
"15605",562,"200803.197.1190.3","NMFS",2008,4,5,96,30.07,41.389533,-67.58675,0,0,0,0,0,"AL",0.038
"15606",562,"200803.198.1190.1","NMFS",2008,4,5,96,30.02,41.604533,-67.378767,0,0,0,0,0,"AL",0.038
"15607",562,"200803.199.1160.3","NMFS",2008,4,6,97,30.03,41.149533,-66.888433,0,0,0,0,0,"AL",0.038
"15608",562,"200803.200.1160.4","NMFS",2008,4,6,97,30.07,41.015817,-66.55095,3,3,0,3,0,"AL",0.038
"15609",562,"200803.202.1170.1","NMFS",2008,4,6,97,30.05,41.141567,-66.369,0,0,0,0,0,"AL",0.038
"15610",562,"200803.203.1160.20","NMFS",2008,4,6,97,29.45,41.271817,-66.7516,0,0,0,0,0,"AL",0.038
"15611",562,"200803.204.1160.14","NMFS",2008,4,6,97,30.1,41.31045,-66.61505,0,0,0,0,0,"AL",0.038
"15612",562,"200803.205.1160.2","NMFS",2008,4,6,97,30,41.399917,-66.579667,0,0,0,0,0,"AL",0.038
"15613",562,"200803.206.1160.12","NMFS",2008,4,6,97,29.98,41.602117,-66.734733,0,0,0,0,0,"AL",0.038
"15614",562,"200803.207.1160.10","NMFS",2008,4,6,97,29.98,41.644083,-67.01515,0,0,0,0,0,"AL",0.038
"15615",551,"200803.208.1160.19","NMFS",2008,4,6,97,29.97,41.855617,-66.8164,0,0,0,0,0,"AL",0.038
"15616",551,"200803.209.1160.18","NMFS",2008,4,7,98,30,41.923383,-66.655833,0,0,0,0,0,"AL",0.038
"15617",551,"200803.210.1160.8","NMFS",2008,4,7,98,30,41.851817,-66.586767,0,0,0,0,0,"AL",0.038
"15618",552,"200803.211.1160.7","NMFS",2008,4,8,99,30.7,41.602983,-66.457667,0,0,0,0,0,"AL",0.038
"15619",552,"200803.212.1160.15","NMFS",2008,4,8,99,30.1,41.291783,-66.338517,2,2,0,2,0,"AL",0.038
"15620",552,"200803.213.1170.3","NMFS",2008,4,8,99,30.07,41.345833,-66.250383,2,2,0,2,0,"AL",0.038
"15621",552,"200803.214.1180.2","NMFS",2008,4,8,99,30.05,41.405567,-66.000133,60,59,1,60,0,"AL",0.038
"15622",552,"200803.215.1160.13","NMFS",2008,4,8,99,29.95,41.607383,-65.995833,4,4,0,4,0,"AL",0.038
"15623",552,"200803.216.1160.9","NMFS",2008,4,8,99,30.1,41.643833,-66.1779,0,0,0,0,0,"AL",0.038
"15624",552,"200803.217.1160.6","NMFS",2008,4,8,99,29.98,41.727433,-66.142583,0,0,0,0,0,"AL",0.038
"15625",552,"200803.218.1170.2","NMFS",2008,4,9,100,30.05,41.775283,-65.880417,3,3,0,3,0,"AL",0.038
"15626",551,"200803.219.1160.17","NMFS",2008,4,9,100,30,41.8576,-65.949017,0,0,0,0,0,"AL",0.038
"15627",551,"200803.220.1160.11","NMFS",2008,4,9,100,30.07,41.942817,-65.980783,0,0,0,0,0,"AL",0.038
"15628",551,"200803.221.1160.5","NMFS",2008,4,9,100,30.05,42.056983,-66.039833,7,6,1,7,0,"AL",0.038
"15629",551,"200803.222.1160.16","NMFS",2008,4,9,100,30.13,42.013883,-66.240817,0,0,0,0,0,"AL",0.038
"15630",551,"200803.223.1210.1","NMFS",2008,4,9,100,30.07,42.098333,-66.168867,2,1,1,2,0,"AL",0.038
"15631",551,"200803.224.1220.2","NMFS",2008,4,9,100,30,42.146717,-66.31925,11,10,1,11,0,"AL",0.038
"15632",551,"200803.225.1290.6","NMFS",2008,4,9,100,30.13,42.197367,-66.231933,1,1,0,1,0,"AL",0.038
"15633",551,"200803.226.1290.3","NMFS",2008,4,9,100,30.02,42.221267,-66.512183,5,4,1,5,0,"AL",0.038
"15634",464,"200803.227.1290.1","NMFS",2008,4,9,100,30.07,42.362817,-66.371017,4,4,0,4,0,"AL",0.038
"15635",464,"200803.228.1300.1","NMFS",2008,4,9,100,30.05,42.437967,-66.598917,4,3,1,4,0,"AL",0.038
"15636",464,"200803.229.1300.3","NMFS",2008,4,9,100,29.95,42.437383,-66.810467,11,11,0,11,0,"AL",0.038
"15637",551,"200803.230.1290.7","NMFS",2008,4,10,101,30.02,42.231133,-66.67165,11,9,2,11,0,"AL",0.038
"15638",551,"200803.231.1220.1","NMFS",2008,4,10,101,30.1,42.177667,-66.856167,5,5,0,5,0,"AL",0.038
"15639",551,"200803.232.1210.4","NMFS",2008,4,10,101,30.02,42.15265,-66.9655,4,3,1,4,0,"AL",0.038
"15640",561,"200803.233.1200.1","NMFS",2008,4,10,101,30.02,42.007517,-67.164717,0,0,0,0,0,"AL",0.038
"15641",561,"200803.234.1190.4","NMFS",2008,4,10,101,30.05,41.8777,-67.108617,1,1,0,1,0,"AL",0.038
"15642",562,"200803.235.1190.2","NMFS",2008,4,10,101,29.98,41.79105,-67.265483,1,1,0,1,0,"AL",0.038
"15643",562,"200803.236.1190.5","NMFS",2008,4,10,101,30.03,41.71705,-67.49445,0,0,0,0,0,"AL",0.038
"15644",561,"200803.237.1200.5","NMFS",2008,4,10,101,29.98,41.9171,-67.416967,1,1,0,1,0,"AL",0.038
"15645",561,"200803.238.1210.2","NMFS",2008,4,10,101,29.97,42.1096,-67.4003,0,0,0,0,0,"AL",0.038
"15646",522,"200803.239.1220.3","NMFS",2008,4,10,101,29.95,41.966217,-67.9212,1,0,1,1,0,"AL",0.038
"15647",522,"200803.240.1200.4","NMFS",2008,4,10,101,29.95,41.730083,-67.863883,1,1,0,1,0,"AL",0.038
"15648",521,"200803.241.1250.1","NMFS",2008,4,16,107,30.02,41.558705,-69.560142,0,0,0,0,0,"AL",0.038
"15649",521,"200803.242.1230.4","NMFS",2008,4,16,107,30.02,41.527747,-69.453845,14,6,8,13,1,"AL",0.038
"15650",521,"200803.243.1250.4","NMFS",2008,4,17,108,30.05,41.36738,-69.487015,1,1,0,1,0,"AL",0.038
"15651",521,"200803.244.1250.2","NMFS",2008,4,17,108,30.03,41.22745,-69.380768,0,0,0,0,0,"AL",0.038
"15652",521,"200803.245.1250.3","NMFS",2008,4,17,108,20.07,41.119212,-69.214863,0,0,0,0,0,"AL",0.038
"15653",526,"200803.246.1090.1","NMFS",2008,4,17,108,30.03,40.901672,-69.592302,0,0,0,0,0,"AL",0.038
"15654",526,"200803.247.1100.1","NMFS",2008,4,17,108,29.97,40.956247,-69.11418,0,0,0,0,0,"AL",0.038
"15655",521,"200803.248.1230.1","NMFS",2008,4,17,108,28.13,41.062415,-68.91188,0,0,0,0,0,"AL",0.038
"15656",526,"200803.249.1130.3","NMFS",2008,4,17,108,30.08,40.979868,-68.844308,1,0,1,1,0,"AL",0.038
"15657",526,"200803.250.1100.2","NMFS",2008,4,17,108,30.02,40.679317,-68.956435,0,0,0,0,0,"AL",0.038
"15658",525,"200803.251.1190.8","NMFS",2008,4,18,109,30.05,40.86163,-68.618887,0,0,0,0,0,"AL",0.038
"15659",525,"200803.252.1130.6","NMFS",2008,4,18,109,30.07,40.957938,-68.795508,1,0,1,1,0,"AL",0.038
"15660",522,"200803.253.1230.3","NMFS",2008,4,18,109,30.05,41.279683,-68.633738,0,0,0,0,0,"AL",0.038
"15661",522,"200803.254.1200.3","NMFS",2008,4,18,109,30.05,41.272488,-68.446055,0,0,0,0,0,"AL",0.038
"15662",522,"200803.255.1200.2","NMFS",2008,4,18,109,30.02,41.355145,-68.279638,4,3,1,2,2,"AL",0.038
"15663",522,"200803.256.1200.6","NMFS",2008,4,18,109,30.02,41.43463,-68.111902,0,0,0,0,0,"AL",0.038
"15664",522,"200803.257.1210.3","NMFS",2008,4,18,109,30.07,41.8065,-68.189607,0,0,0,0,0,"AL",0.038
"15665",522,"200803.258.1220.4","NMFS",2008,4,18,109,30.02,41.735863,-68.398345,1,1,0,1,0,"AL",0.038
"15666",521,"200803.259.1240.6","NMFS",2008,4,19,110,30.2,41.539208,-68.950975,0,0,0,0,0,"AL",0.038
"15667",522,"200803.260.1240.2","NMFS",2008,4,19,110,30.05,41.773573,-68.611003,0,0,0,0,0,"AL",0.038
"15668",522,"200803.261.1240.1","NMFS",2008,4,19,110,30.03,42.019233,-68.44529,1,0,1,1,0,"AL",0.038
"15669",522,"200803.262.1240.3","NMFS",2008,4,19,110,30.05,42.17718,-68.547102,0,0,0,0,0,"AL",0.038
"15670",515,"200803.263.1240.5","NMFS",2008,4,19,110,30.02,42.350555,-68.569987,1,1,0,1,0,"AL",0.038
"15671",515,"200803.264.1290.2","NMFS",2008,4,19,110,30.13,42.437333,-68.0105,1,1,0,1,0,"AL",0.038
"15672",522,"200803.265.1290.5","NMFS",2008,4,19,110,29.98,42.31394,-67.775837,1,1,0,1,0,"AL",0.038
"15673",464,"200803.266.1300.2","NMFS",2008,4,19,110,30.15,42.511998,-67.375563,2,0,2,2,0,"AL",0.038
"15674",464,"200803.267.1290.4","NMFS",2008,4,19,110,30.02,42.709565,-67.561625,3,3,0,3,0,"AL",0.038
"15675",515,"200803.268.1360.5","NMFS",2008,4,20,111,30.05,42.89135,-67.823958,1,1,0,1,0,"AL",0.038
"15676",464,"200803.269.1360.7","NMFS",2008,4,20,111,30.12,42.978372,-67.608672,3,2,1,3,0,"AL",0.038
"15677",464,"200803.270.1360.6","NMFS",2008,4,20,111,30.07,42.83735,-67.346733,0,0,0,0,0,"AL",0.038
"15678",465,"200803.271.1360.3","NMFS",2008,4,20,111,30.48,43.483012,-67.389235,1,1,0,1,0,"AL",0.038
"15679",465,"200803.272.1340.4","NMFS",2008,4,20,111,29.95,43.644477,-67.153717,2,0,2,2,0,"AL",0.038
"15680",465,"200803.273.1340.1","NMFS",2008,4,20,111,30.07,43.769203,-67.051107,2,0,2,2,0,"AL",0.038
"15681",511,"200803.274.1340.5","NMFS",2008,4,20,111,30.03,43.943548,-66.851692,2,2,0,2,0,"AL",0.038
"15682",465,"200803.275.1340.2","NMFS",2008,4,20,111,30.03,43.7763,-66.728925,14,9,5,14,0,"AL",0.038
"15683",465,"200803.276.1340.3","NMFS",2008,4,20,111,30.02,43.614923,-66.630958,4,2,2,4,0,"AL",0.038
"15684",465,"200803.277.1340.6","NMFS",2008,4,20,111,30.02,43.400587,-66.680197,4,0,4,4,0,"AL",0.038
"15685",465,"200803.278.1330.3","NMFS",2008,4,21,112,25.87,43.307398,-66.570855,16,4,12,16,0,"AL",0.038
"15686",465,"200803.279.1330.1","NMFS",2008,4,21,112,30.05,43.304482,-66.401987,1,1,0,1,0,"AL",0.038
"15687",465,"200803.280.1330.4","NMFS",2008,4,21,112,30.03,43.747667,-66.45665,37,23,14,34,3,"AL",0.038
"15688",466,"200803.281.1330.2","NMFS",2008,4,21,112,30.05,44.06948,-66.586445,4,0,4,4,0,"AL",0.038
"15689",511,"200803.282.1351.2","NMFS",2008,4,21,112,30,44.241062,-66.981073,2,1,1,2,0,"AL",0.038
"15690",511,"200803.283.1351.1","NMFS",2008,4,21,112,30.05,44.270372,-67.216473,8,8,0,8,0,"AL",0.038
"15691",511,"200803.284.1390.1","NMFS",2008,4,21,112,29.98,44.221328,-67.770898,9,2,7,9,0,"AL",0.038
"15692",511,"200803.285.1380.3","NMFS",2008,4,21,112,30.18,44.034308,-67.684008,4,2,2,4,0,"AL",0.038
"15693",512,"200803.286.1360.8","NMFS",2008,4,22,113,29.97,43.849423,-67.77329,2,2,0,2,0,"AL",0.038
"15694",512,"200803.287.1360.1","NMFS",2008,4,22,113,30.05,43.518365,-68.080627,2,1,1,2,0,"AL",0.038
"15695",512,"200803.288.1360.4","NMFS",2008,4,22,113,30.02,43.679787,-68.00956,0,0,0,0,0,"AL",0.038
"15696",512,"200803.289.1380.5","NMFS",2008,4,22,113,30.12,43.889105,-68.162012,3,3,0,3,0,"AL",0.038
"15697",512,"200803.290.1390.3","NMFS",2008,4,22,113,29.88,43.838468,-68.455067,7,5,2,7,0,"AL",0.038
"15698",512,"200803.291.1390.2","NMFS",2008,4,23,114,30.05,43.957055,-68.308658,7,1,6,7,0,"AL",0.038
"15699",513,"200803.292.1400.2","NMFS",2008,4,23,114,30.03,43.774188,-69.385193,75,39,36,66,9,"AL",0.038
"15700",513,"200803.293.1380.2","NMFS",2008,4,23,114,30,43.44217,-69.16677,3,3,0,3,0,"AL",0.038
"15701",513,"200803.294.1380.1","NMFS",2008,4,23,114,30.08,43.395743,-69.309963,1,1,0,1,0,"AL",0.038
"15702",513,"200803.295.1370.5","NMFS",2008,4,23,114,30,43.192712,-69.192243,3,2,1,3,0,"AL",0.038
"15703",513,"200803.296.1370.4","NMFS",2008,4,23,114,30.35,43.112335,-69.286422,1,1,0,1,0,"AL",0.038
"15704",515,"200803.297.1370.3","NMFS",2008,4,23,114,30,42.856068,-69.031172,0,0,0,0,0,"AL",0.038
"15705",515,"200803.298.1370.2","NMFS",2008,4,24,115,30.25,42.934137,-68.538887,1,1,0,1,0,"AL",0.038
"15706",515,"200803.299.1360.2","NMFS",2008,4,24,115,30.02,42.93031,-68.35729,0,0,0,0,0,"AL",0.038
"15707",515,"200803.300.1290.8","NMFS",2008,4,24,115,30,42.637123,-68.431332,0,0,0,0,0,"AL",0.038
"15708",515,"200803.301.1370.1","NMFS",2008,4,24,115,30.03,42.773617,-68.737752,1,1,0,1,0,"AL",0.038
"15709",515,"200803.302.1280.3","NMFS",2008,4,24,115,30.05,42.393825,-68.818173,0,0,0,0,0,"AL",0.038
"15710",515,"200803.303.1280.1","NMFS",2008,4,24,115,30.03,42.642878,-69.305283,1,1,0,1,0,"AL",0.038
"15711",515,"200803.304.1280.5","NMFS",2008,4,24,115,30.05,42.613323,-69.609823,0,0,0,0,0,"AL",0.038
"15712",515,"200803.305.1280.4","NMFS",2008,4,24,115,30.03,42.405355,-69.53685,0,0,0,0,0,"AL",0.038
"15713",514,"200803.306.3580.1","NMFS",2008,4,29,120,30,41.770923,-70.385945,7,3,4,2,5,"AL",0.038
"15714",514,"200803.307.3590.1","NMFS",2008,4,29,120,30.03,41.93811,-70.149978,2,1,1,1,1,"AL",0.038
"15715",514,"200803.308.3600.1","NMFS",2008,4,29,120,30.1,41.938463,-70.479112,12,4,8,10,2,"AL",0.038
"15716",514,"200803.309.3600.2","NMFS",2008,4,29,120,30.05,41.975043,-70.48006,28,11,17,24,4,"AL",0.038
"15717",514,"200803.310.3610.2","NMFS",2008,4,29,120,30.02,42.058198,-70.396737,5,1,4,5,0,"AL",0.038
"15718",514,"200803.311.3610.1","NMFS",2008,4,29,120,30.02,42.10116,-70.225287,8,4,4,8,0,"AL",0.038
"15719",514,"200803.312.1260.4","NMFS",2008,4,29,120,30.13,42.26965,-70.273985,1,1,0,1,0,"AL",0.038
"15720",514,"200803.313.3660.2","NMFS",2008,4,29,120,30.02,42.26719,-70.551002,6,3,3,6,0,"AL",0.038
"15721",514,"200803.316.3660.4","NMFS",2008,4,30,121,30.07,42.394882,-70.706242,15,8,7,15,0,"AL",0.038
"15722",514,"200803.318.1260.2","NMFS",2008,4,30,121,29.93,42.557238,-70.482845,2,0,2,2,0,"AL",0.038
"15723",514,"200803.320.1260.6","NMFS",2008,4,30,121,29.95,42.664982,-70.37047,2,1,1,2,0,"AL",0.038
"15724",514,"200803.321.3650.2","NMFS",2008,4,30,121,29.9,42.740365,-70.632893,23,8,15,22,1,"AL",0.038
"15725",514,"200803.322.3630.1","NMFS",2008,4,30,121,30.17,42.698083,-70.704512,1,0,1,1,0,"AL",0.038
"15726",513,"200803.323.3640.1","NMFS",2008,4,30,121,30,42.853362,-70.754932,1,0,1,1,0,"AL",0.038
"15727",513,"200803.324.1400.3","NMFS",2008,4,30,121,30.05,42.833647,-70.519185,3,2,1,3,0,"AL",0.038
"15728",513,"200803.325.1270.3","NMFS",2008,5,1,122,30,43.146975,-70.246293,8,6,2,8,0,"AL",0.038
"15729",513,"200803.326.1400.1","NMFS",2008,5,1,122,29.88,43.380165,-70.194753,10,0,10,7,3,"AL",0.038
"15730",513,"200803.327.1380.4","NMFS",2008,5,1,122,30.2,43.357267,-69.780893,0,0,0,0,0,"AL",0.038
"15731",513,"200803.328.1260.5","NMFS",2008,5,1,122,30.03,43.092823,-70.015188,2,2,0,2,0,"AL",0.038
"15732",513,"200803.329.1280.6","NMFS",2008,5,1,122,30,43.064312,-69.910408,1,1,0,1,0,"AL",0.038
"15733",513,"200803.330.1270.4","NMFS",2008,5,1,122,29.97,42.887607,-69.978525,2,2,0,2,0,"AL",0.038
"15734",514,"200803.331.1260.1","NMFS",2008,5,1,122,30.03,42.599332,-70.084763,0,0,0,0,0,"AL",0.038
"15735",514,"200803.332.1270.1","NMFS",2008,5,1,122,30.12,42.632805,-69.966807,1,1,0,1,0,"AL",0.038
"15736",521,"200803.333.1270.2","NMFS",2008,5,2,123,30,42.18171,-69.865138,1,1,0,1,0,"AL",0.038
"15737",515,"200803.334.1280.7","NMFS",2008,5,2,123,29.95,42.356653,-69.37798,1,1,0,1,0,"AL",0.038
"15738",521,"200803.335.1280.2","NMFS",2008,5,2,123,30.52,42.270945,-69.209532,0,0,0,0,0,"AL",0.038
"15739",521,"200803.336.1240.4","NMFS",2008,5,2,123,30.02,41.809665,-69.194213,0,0,0,0,0,"AL",0.038
"15740",521,"200803.337.3560.1","NMFS",2008,5,2,123,30,41.904327,-69.944415,14,4,10,14,0,"AL",0.038
"15741",521,"200803.340.3550.2","NMFS",2008,5,2,123,29.98,41.262107,-69.523112,0,0,0,0,0,"AL",0.038
"15742",521,"200803.341.3550.4","NMFS",2008,5,3,124,29.95,41.177463,-69.543725,0,0,0,0,0,"AL",0.038
"15743",526,"200803.342.3550.3","NMFS",2008,5,3,124,28.42,41.066118,-69.51808,1,0,1,1,0,"AL",0.038
"15744",521,"200803.344.3550.5","NMFS",2008,5,3,124,30.03,41.221652,-69.678763,0,0,0,0,0,"AL",0.038
"15745",526,"200807.173.1120.1","NMFS",2008,10,1,275,30.07,39.933987,-69.502527,8,3,5,5,3,"AL",0.038
"15746",526,"200807.174.1110.1","NMFS",2008,10,1,275,30.05,40.102107,-69.181262,0,0,0,0,0,"AL",0.038
"15747",526,"200807.175.1100.1","NMFS",2008,10,1,275,30.08,40.355483,-69.043385,1,0,1,1,0,"AL",0.038
"15748",526,"200807.176.1100.5","NMFS",2008,10,1,275,30.05,40.228687,-69.680268,2,1,1,1,1,"AL",0.038
"15749",526,"200807.177.1100.6","NMFS",2008,10,1,275,30.02,40.520595,-69.914178,0,0,0,0,0,"AL",0.038
"15750",526,"200807.178.1090.3","NMFS",2008,10,1,275,30.03,40.605738,-69.45111,0,0,0,0,0,"AL",0.038
"15751",526,"200807.179.1100.7","NMFS",2008,10,1,275,29.97,40.555852,-69.353122,0,0,0,0,0,"AL",0.038
"15752",526,"200807.180.1100.3","NMFS",2008,10,1,275,30.1,40.634915,-69.25495,0,0,0,0,0,"AL",0.038
"15753",526,"200807.181.1100.2","NMFS",2008,10,1,275,30.13,40.688763,-69.21759,0,0,0,0,0,"AL",0.038
"15754",526,"200807.182.1100.8","NMFS",2008,10,2,276,30.02,40.561875,-68.924758,0,0,0,0,0,"AL",0.038
"15755",525,"200807.183.1130.4","NMFS",2008,10,2,276,30.03,40.521433,-68.191535,0,0,0,0,0,"AL",0.038
"15756",525,"200807.184.1140.3","NMFS",2008,10,2,276,30.02,40.36332,-68.182193,1,1,0,1,0,"AL",0.038
"15757",525,"200807.185.1150.1","NMFS",2008,10,2,276,29.77,40.387323,-67.571018,0,0,0,0,0,"AL",0.038
"15758",525,"200807.186.1140.2","NMFS",2008,10,2,276,30.05,40.520953,-67.619738,1,1,0,1,0,"AL",0.038
"15759",525,"200807.187.1130.8","NMFS",2008,10,2,276,29.98,40.557542,-67.966653,0,0,0,0,0,"AL",0.038
"15760",525,"200807.188.1130.2","NMFS",2008,10,2,276,30.42,40.687757,-68.330623,0,0,0,0,0,"AL",0.038
"15761",521,"200807.189.3550.1","NMFS",2008,10,6,280,29.98,41.51006,-69.778173,2,2,0,2,0,"AL",0.038
"15762",521,"200807.190.3560.1","NMFS",2008,10,7,281,29.92,41.881397,-69.946695,16,11,5,16,0,"AL",0.038
"15763",521,"200807.191.1230.3","NMFS",2008,10,7,281,30.02,41.939185,-69.84554,0,0,0,0,0,"AL",0.038
"15764",521,"200807.192.3550.2","NMFS",2008,10,7,281,29.98,41.512962,-69.74432,2,1,1,2,0,"AL",0.038
"15765",521,"200807.193.3550.3","NMFS",2008,10,7,281,28,41.38245,-69.582258,5,3,2,5,0,"AL",0.038
"15766",521,"200807.194.1250.2","NMFS",2008,10,7,281,30.05,41.366145,-69.350127,0,0,0,0,0,"AL",0.038
"15767",521,"200807.195.1250.3","NMFS",2008,10,7,281,30.02,41.194298,-69.414875,7,3,4,7,0,"AL",0.038
"15768",521,"200807.196.1250.1","NMFS",2008,10,7,281,30.03,41.110967,-69.270618,7,5,2,7,0,"AL",0.038
"15769",526,"200807.197.3550.4","NMFS",2008,10,7,281,29.98,40.983493,-69.461977,7,7,0,7,0,"AL",0.038
"15770",526,"200807.198.3550.5","NMFS",2008,10,8,282,30.02,41.017212,-69.74019,3,3,0,3,0,"AL",0.038
"15771",526,"200807.199.1090.4","NMFS",2008,10,8,282,30.12,40.812707,-69.716558,0,0,0,0,0,"AL",0.038
"15772",526,"200807.200.1090.5","NMFS",2008,10,8,282,30.02,40.811763,-69.446548,0,0,0,0,0,"AL",0.038
"15773",526,"200807.201.1100.4","NMFS",2008,10,8,282,30,40.807858,-69.020915,1,0,1,1,0,"AL",0.038
"15774",521,"200807.202.1230.1","NMFS",2008,10,8,282,30,41.009547,-68.879947,3,2,1,3,0,"AL",0.038
"15775",525,"200807.203.1130.6","NMFS",2008,10,8,282,30.12,40.974365,-68.671848,2,2,0,1,1,"AL",0.038
"15776",522,"200807.204.1230.5","NMFS",2008,10,8,282,30.08,41.310562,-68.772943,0,0,0,0,0,"AL",0.038
"15777",522,"200807.205.1200.5","NMFS",2008,10,8,282,30.03,41.193092,-68.526708,5,4,1,3,2,"AL",0.038
"15778",522,"200807.206.1200.2","NMFS",2008,10,8,282,30,41.265572,-68.28738,0,0,0,0,0,"AL",0.038
"15779",525,"200807.207.1190.5","NMFS",2008,10,9,283,30.4,41.143545,-68.243213,0,0,0,0,0,"AL",0.038
"15780",525,"200807.208.1190.6","NMFS",2008,10,9,283,30.03,41.019728,-68.310178,0,0,0,0,0,"AL",0.038
"15781",525,"200807.209.1190.7","NMFS",2008,10,9,283,30,41.155153,-67.84536,0,0,0,0,0,"AL",0.038
"15782",525,"200807.210.1130.5","NMFS",2008,10,9,283,29.97,40.77541,-67.691917,0,0,0,0,0,"AL",0.038
"15783",525,"200807.211.1130.9","NMFS",2008,10,9,283,30.03,40.722547,-67.389598,0,0,0,0,0,"AL",0.038
"15784",525,"200807.212.1130.7","NMFS",2008,10,9,283,30.07,40.932775,-67.009733,1,1,0,1,0,"AL",0.038
"15785",525,"200807.213.1130.1","NMFS",2008,10,9,283,30.17,40.83207,-66.946855,0,0,0,0,0,"AL",0.038
"15786",525,"200807.214.1140.1","NMFS",2008,10,9,283,30.02,40.697507,-66.924173,2,2,0,2,0,"AL",0.038
"15787",562,"200807.215.1180.2","NMFS",2008,10,9,283,30,40.866428,-66.587073,0,0,0,0,0,"AL",0.038
"15788",562,"200807.216.1160.6","NMFS",2008,10,10,284,30.05,40.890093,-66.706725,8,8,0,8,0,"AL",0.038
"15789",562,"200807.217.1160.7","NMFS",2008,10,10,284,30,41.181698,-66.84275,2,2,0,2,0,"AL",0.038
"15790",562,"200807.218.1160.10","NMFS",2008,10,10,284,30.23,41.102818,-66.974483,0,0,0,0,0,"AL",0.038
"15791",525,"200807.219.1130.3","NMFS",2008,10,10,284,30,41.13792,-67.339802,5,5,0,5,0,"AL",0.038
"15792",562,"200807.220.1190.8","NMFS",2008,10,10,284,30.05,41.363437,-67.301133,2,2,0,2,0,"AL",0.038
"15793",562,"200807.221.1160.15","NMFS",2008,10,10,284,29.97,41.349858,-67.115902,3,3,0,3,0,"AL",0.038
"15794",562,"200807.222.1160.17","NMFS",2008,10,10,284,29.95,41.428778,-66.916163,4,3,1,4,0,"AL",0.038
"15795",562,"200807.223.1160.19","NMFS",2008,10,10,284,30.1,41.576362,-66.694782,7,6,1,7,0,"AL",0.038
"15796",562,"200807.224.1160.4","NMFS",2008,10,10,284,30.07,41.396652,-66.681172,1,1,0,1,0,"AL",0.038
"15797",562,"200807.225.1160.2","NMFS",2008,10,10,284,29.97,41.315033,-66.617065,1,1,0,1,0,"AL",0.038
"15798",562,"200807.227.1170.4","NMFS",2008,10,10,284,30.12,41.13943,-66.417097,3,3,0,3,0,"AL",0.038
"15799",552,"200807.229.1160.21","NMFS",2008,10,11,285,30.08,41.440127,-66.207105,0,0,0,0,0,"AL",0.038
"15800",552,"200807.230.1160.12","NMFS",2008,10,11,285,30.03,41.516592,-66.249202,0,0,0,0,0,"AL",0.038
"15801",552,"200807.231.1160.11","NMFS",2008,10,11,285,30,41.60538,-66.172925,0,0,0,0,0,"AL",0.038
"15802",552,"200807.232.1160.14","NMFS",2008,10,11,285,30.08,41.517125,-66.481748,2,2,0,2,0,"AL",0.038
"15803",552,"200807.233.1160.1","NMFS",2008,10,11,285,30.05,41.695542,-66.370933,4,2,2,4,0,"AL",0.038
"15804",552,"200807.234.1160.9","NMFS",2008,10,11,285,29.97,41.687662,-66.400952,1,1,0,1,0,"AL",0.038
"15805",552,"200807.235.1160.3","NMFS",2008,10,11,285,29.97,41.808278,-66.43943,11,10,1,11,0,"AL",0.038
"15806",551,"200807.236.1160.13","NMFS",2008,10,11,285,30.08,41.864635,-66.703973,2,2,0,2,0,"AL",0.038
"15807",551,"200807.237.1160.20","NMFS",2008,10,11,285,29.93,42.020655,-66.752497,6,6,0,6,0,"AL",0.038
"15808",551,"200807.238.1160.16","NMFS",2008,10,11,285,29.92,42.064035,-66.412582,0,0,0,0,0,"AL",0.038
"15809",551,"200807.239.1160.18","NMFS",2008,10,12,286,30.1,41.856082,-66.44924,5,3,2,5,0,"AL",0.038
"15810",552,"200807.240.1160.8","NMFS",2008,10,12,286,29.92,41.764263,-66.18617,1,1,0,1,0,"AL",0.038
"15811",552,"200807.241.1170.3","NMFS",2008,10,12,286,30,41.779337,-65.755852,0,0,0,0,0,"AL",0.038
"15812",551,"200807.242.1180.1","NMFS",2008,10,12,286,29.97,41.947223,-65.798547,0,0,0,0,0,"AL",0.038
"15813",551,"200807.243.1170.2","NMFS",2008,10,12,286,30.28,41.868923,-65.801402,1,0,1,1,0,"AL",0.038
"15814",551,"200807.244.1220.1","NMFS",2008,10,12,286,30.05,42.105473,-66.074677,0,0,0,0,0,"AL",0.038
"15815",551,"200807.245.1220.2","NMFS",2008,10,12,286,30.08,42.148922,-66.396352,2,1,1,2,0,"AL",0.038
"15816",551,"200807.246.1210.3","NMFS",2008,10,12,286,30.02,42.144347,-66.642087,1,1,0,1,0,"AL",0.038
"15817",551,"200807.247.1210.1","NMFS",2008,10,12,286,30.02,42.097418,-67.013208,5,4,1,5,0,"AL",0.038
"15818",464,"200807.248.1300.3","NMFS",2008,10,13,287,30,42.35374,-67.013937,1,1,0,1,0,"AL",0.038
"15819",464,"200807.249.1290.6","NMFS",2008,10,13,287,30.03,42.684945,-66.879828,0,0,0,0,0,"AL",0.038
"15820",464,"200807.250.1290.2","NMFS",2008,10,13,287,30,42.648287,-67.012927,1,0,1,1,0,"AL",0.038
"15821",464,"200807.251.1300.1","NMFS",2008,10,13,287,30.02,42.479497,-67.24674,1,1,0,1,0,"AL",0.038
"15822",464,"200807.252.1290.8","NMFS",2008,10,13,287,30.4,42.563485,-67.374037,1,0,1,1,0,"AL",0.038
"15823",464,"200807.253.1300.2","NMFS",2008,10,13,287,30.08,42.432978,-67.476353,1,1,0,1,0,"AL",0.038
"15824",515,"200807.254.1290.3","NMFS",2008,10,13,287,30.02,42.509307,-67.691072,0,0,0,0,0,"AL",0.038
"15825",515,"200807.255.1290.7","NMFS",2008,10,13,287,30,42.483185,-67.913635,0,0,0,0,0,"AL",0.038
"15826",522,"200807.256.1220.4","NMFS",2008,10,13,287,30.4,42.14797,-67.775083,1,1,0,1,0,"AL",0.038
"15827",522,"200807.257.1220.3","NMFS",2008,10,14,288,30.08,42.02234,-68.020665,0,0,0,0,0,"AL",0.038
"15828",522,"200807.258.1210.4","NMFS",2008,10,14,288,30.02,41.978552,-67.816352,0,0,0,0,0,"AL",0.038
"15829",561,"200807.259.1200.1","NMFS",2008,10,14,288,30.07,41.868737,-67.621945,0,0,0,0,0,"AL",0.038
"15830",561,"200807.260.1200.6","NMFS",2008,10,14,288,30,42.04189,-67.398837,9,8,1,9,0,"AL",0.038
"15831",561,"200807.261.1190.9","NMFS",2008,10,14,288,30.03,41.877457,-67.117273,7,5,2,6,1,"AL",0.038
"15832",561,"200807.262.1190.2","NMFS",2008,10,14,288,29.82,41.91629,-67.065178,50,50,0,50,0,"AL",0.038
"15833",562,"200807.263.1190.1","NMFS",2008,10,14,288,30,41.761635,-67.170307,8,8,0,8,0,"AL",0.038
"15834",562,"200807.264.1190.4","NMFS",2008,10,14,288,30.05,41.608502,-67.561235,0,0,0,0,0,"AL",0.038
"15835",562,"200807.265.1190.3","NMFS",2008,10,14,288,30,41.618465,-67.638975,0,0,0,0,0,"AL",0.038
"15836",522,"200807.266.1200.3","NMFS",2008,10,15,289,30.05,41.53009,-67.944588,0,0,0,0,0,"AL",0.038
"15837",522,"200807.267.1200.4","NMFS",2008,10,15,289,30.07,41.689002,-68.139832,0,0,0,0,0,"AL",0.038
"15838",522,"200807.268.1210.2","NMFS",2008,10,15,289,30.07,41.76909,-68.307723,1,1,0,1,0,"AL",0.038
"15839",522,"200807.269.1290.5","NMFS",2008,10,15,289,30.07,42.026155,-68.244687,0,0,0,0,0,"AL",0.038
"15840",522,"200807.270.1240.1","NMFS",2008,10,15,289,30.05,41.92978,-68.634128,0,0,0,0,0,"AL",0.038
"15841",522,"200807.271.1240.2","NMFS",2008,10,15,289,30.07,42.064062,-68.583132,0,0,0,0,0,"AL",0.038
"15842",522,"200807.272.1240.6","NMFS",2008,10,15,289,30.05,42.106687,-68.44405,0,0,0,0,0,"AL",0.038
"15843",522,"200807.273.1290.4","NMFS",2008,10,15,289,29.82,42.229012,-68.31198,0,0,0,0,0,"AL",0.038
"15844",522,"200807.274.1240.3","NMFS",2008,10,15,289,30.05,42.26717,-68.479188,1,1,0,1,0,"AL",0.038
"15845",515,"200807.275.1290.1","NMFS",2008,10,15,289,30.22,42.544403,-68.432012,0,0,0,0,0,"AL",0.038
"15846",515,"200807.276.1280.6","NMFS",2008,10,15,289,30.07,42.611345,-68.711063,0,0,0,0,0,"AL",0.038
"15847",515,"200807.277.1280.3","NMFS",2008,10,16,290,29.88,42.39439,-68.709748,0,0,0,0,0,"AL",0.038
"15848",515,"200807.278.1280.4","NMFS",2008,10,16,290,30.13,42.44824,-68.86303,0,0,0,0,0,"AL",0.038
"15849",515,"200807.279.1280.5","NMFS",2008,10,16,290,30.02,42.443287,-69.402708,0,0,0,0,0,"AL",0.038
"15850",521,"200807.280.1280.2","NMFS",2008,10,16,290,29.97,42.331352,-69.656097,0,0,0,0,0,"AL",0.038
"15851",521,"200807.281.1240.5","NMFS",2008,10,16,290,29.97,42.023057,-68.914815,0,0,0,0,0,"AL",0.038
"15852",521,"200807.282.1240.4","NMFS",2008,10,16,290,30.02,41.727758,-69.37934,1,1,0,1,0,"AL",0.038
"15853",521,"200807.283.1230.4","NMFS",2008,10,17,291,29.97,41.506958,-69.415733,1,0,1,1,0,"AL",0.038
"15854",521,"200807.284.1250.4","NMFS",2008,10,17,291,30.03,41.470797,-69.409385,11,5,6,11,0,"AL",0.038
"15855",514,"200807.285.3600.2","NMFS",2008,10,21,295,29.98,41.892587,-70.35241,43,19,24,41,2,"AL",0.038
"15856",514,"200807.286.3590.1","NMFS",2008,10,21,295,30.08,41.899905,-70.174177,34,13,21,34,0,"AL",0.038
"15857",514,"200807.287.3580.1","NMFS",2008,10,21,295,29.13,41.897595,-70.146762,2,2,0,2,0,"AL",0.038
"15858",514,"200807.288.3600.1","NMFS",2008,10,22,296,28.6,41.980697,-70.274323,8,5,3,8,0,"AL",0.038
"15859",514,"200807.289.3610.2","NMFS",2008,10,22,296,30,42.007947,-70.432658,20,8,12,18,2,"AL",0.038
"15860",514,"200807.290.3640.1","NMFS",2008,10,22,296,30.03,42.353582,-70.76128,101,66,35,92,9,"AL",0.038
"15861",514,"200807.292.3610.1","NMFS",2008,10,23,297,30.02,42.0892,-70.040413,8,4,4,8,0,"AL",0.038
"15862",521,"200807.293.1270.2","NMFS",2008,10,23,297,29.98,42.168675,-69.926385,0,0,0,0,0,"AL",0.038
"15863",515,"200807.294.1280.7","NMFS",2008,10,24,298,30.18,42.552495,-69.283038,0,0,0,0,0,"AL",0.038
"15864",515,"200807.295.1370.1","NMFS",2008,10,24,298,30.05,42.745905,-69.301083,0,0,0,0,0,"AL",0.038
"15865",515,"200807.296.1370.3","NMFS",2008,10,24,298,30.07,43.007675,-68.613708,0,0,0,0,0,"AL",0.038
"15866",515,"200807.297.1370.5","NMFS",2008,10,24,298,30.07,43.184798,-68.621763,0,0,0,0,0,"AL",0.038
"15867",512,"200807.298.1380.2","NMFS",2008,10,24,298,30.35,43.344675,-68.29841,0,0,0,0,0,"AL",0.038
"15868",512,"200807.299.1360.6","NMFS",2008,10,24,298,30.4,43.575113,-67.698648,0,0,0,0,0,"AL",0.038
"15869",515,"200807.300.1360.1","NMFS",2008,10,24,298,29.95,43.285768,-67.947988,0,0,0,0,0,"AL",0.038
"15870",515,"200807.301.1360.5","NMFS",2008,10,25,299,30.65,42.997402,-68.2006,0,0,0,0,0,"AL",0.038
"15871",515,"200807.302.1360.4","NMFS",2008,10,25,299,30.27,42.828893,-67.861195,0,0,0,0,0,"AL",0.038
"15872",465,"200807.303.1360.7","NMFS",2008,10,25,299,30.02,43.151635,-67.495157,0,0,0,0,0,"AL",0.038
"15873",464,"200807.304.1360.3","NMFS",2008,10,25,299,30.07,42.9358,-66.786058,4,3,1,4,0,"AL",0.038
"15874",465,"200807.305.1330.4","NMFS",2008,10,25,299,21.07,43.219603,-66.368533,2,0,2,2,0,"AL",0.038
"15875",465,"200807.306.1330.3","NMFS",2008,10,25,299,30.02,43.341973,-66.584153,14,5,9,14,0,"AL",0.038
"15876",465,"200807.307.1340.2","NMFS",2008,10,25,299,30,43.400492,-66.839118,0,0,0,0,0,"AL",0.038
"15877",465,"200807.308.1360.8","NMFS",2008,10,26,300,30.05,43.480473,-67.17573,0,0,0,0,0,"AL",0.038
"15878",465,"200807.309.1340.5","NMFS",2008,10,26,300,30.08,43.627862,-67.00465,0,0,0,0,0,"AL",0.038
"15879",465,"200807.310.1340.1","NMFS",2008,10,26,300,30.03,43.805898,-67.023368,0,0,0,0,0,"AL",0.038
"15880",465,"200807.311.1340.6","NMFS",2008,10,26,300,30.03,43.839778,-66.82652,4,3,1,4,0,"AL",0.038
"15881",465,"200807.312.1330.1","NMFS",2008,10,26,300,30.03,43.804182,-66.597898,8,4,4,8,0,"AL",0.038
"15882",511,"200807.313.1340.4","NMFS",2008,10,26,300,30.02,43.945053,-66.853625,2,2,0,2,0,"AL",0.038
"15883",466,"200807.314.1330.2","NMFS",2008,10,27,301,30.08,44.103585,-66.645222,7,3,4,7,0,"AL",0.038
"15884",511,"200807.315.1351.2","NMFS",2008,10,27,301,30,44.11039,-66.85664,3,3,0,3,0,"AL",0.038
"15885",511,"200807.316.1351.1","NMFS",2008,10,27,301,30.02,44.384095,-67.107532,0,0,0,0,0,"AL",0.038
"15886",511,"200807.317.1390.4","NMFS",2008,10,27,301,30,44.346035,-67.48497,30,18,12,28,2,"AL",0.038
"15887",511,"200807.318.1340.3","NMFS",2008,10,27,301,30.28,43.992615,-67.402568,0,0,0,0,0,"AL",0.038
"15888",511,"200807.319.1360.2","NMFS",2008,10,27,301,30.05,44.026832,-67.608627,1,0,1,1,0,"AL",0.038
"15889",512,"200807.320.1390.5","NMFS",2008,10,28,302,29.97,44.163302,-67.88898,36,24,12,35,1,"AL",0.038
"15890",512,"200807.321.1390.1","NMFS",2008,10,28,302,30.02,44.010532,-68.242133,39,16,23,39,0,"AL",0.038
"15891",512,"200807.322.1380.1","NMFS",2008,10,28,302,30.02,43.651318,-68.411492,2,1,1,2,0,"AL",0.038
"15892",512,"200807.323.1390.2","NMFS",2008,10,28,302,29.95,43.843328,-68.51336,21,20,1,21,0,"AL",0.038
"15893",512,"200807.324.1390.3","NMFS",2008,10,28,302,29.97,43.801425,-68.636977,24,16,8,23,1,"AL",0.038
"15894",513,"200807.325.1400.3","NMFS",2008,10,30,304,30.03,43.708867,-69.523542,9,8,1,9,0,"AL",0.038
"15895",513,"200807.326.1400.1","NMFS",2008,10,30,304,30.03,43.4503,-70.08161,4,3,1,4,0,"AL",0.038
"15896",513,"200807.327.1270.3","NMFS",2008,10,30,304,30.02,43.016862,-70.313413,2,2,0,2,0,"AL",0.038
"15897",513,"200807.328.1400.2","NMFS",2008,10,30,304,30.2,42.87399,-70.625993,43,19,24,41,2,"AL",0.038
"15898",513,"200807.329.3650.1","NMFS",2008,10,30,304,30.05,42.869613,-70.708478,100,51,49,95,5,"AL",0.038
"15899",514,"200807.330.3660.2","NMFS",2008,10,30,304,26.98,42.727947,-70.54948,41,13,28,29,12,"AL",0.038
"15900",514,"200807.331.1260.4","NMFS",2008,10,31,305,29.88,42.553135,-70.43534,7,4,3,7,0,"AL",0.038
"15901",514,"200807.332.1260.1","NMFS",2008,11,4,309,30.1,42.312393,-70.239443,2,1,1,2,0,"AL",0.038
"15902",514,"200807.333.1260.5","NMFS",2008,11,4,309,29.98,42.282527,-70.333867,4,4,0,4,0,"AL",0.038
"15903",514,"200807.334.1260.2","NMFS",2008,11,4,309,30.05,42.35384,-70.304317,2,2,0,2,0,"AL",0.038
"15904",514,"200807.335.3660.1","NMFS",2008,11,4,309,30.03,42.349567,-70.672322,73,48,25,66,7,"AL",0.038
"15905",514,"200807.336.1280.1","NMFS",2008,11,4,309,30.4,42.734703,-69.947563,0,0,0,0,0,"AL",0.038
"15906",513,"200807.337.1270.1","NMFS",2008,11,4,309,30.03,42.83833,-70.04244,0,0,0,0,0,"AL",0.038
"15907",513,"200807.338.1260.3","NMFS",2008,11,4,309,30.03,43.059857,-70.078915,0,0,0,0,0,"AL",0.038
"15908",513,"200807.339.1270.4","NMFS",2008,11,4,309,30.05,43.080725,-70.109682,1,0,1,1,0,"AL",0.038
"15909",513,"200807.340.1380.3","NMFS",2008,11,4,309,29.92,43.354295,-69.914958,0,0,0,0,0,"AL",0.038
"15910",513,"200807.341.1380.5","NMFS",2008,11,5,310,30.1,43.399423,-69.384798,0,0,0,0,0,"AL",0.038
"15911",513,"200807.342.1370.4","NMFS",2008,11,5,310,30.05,43.227082,-69.092648,0,0,0,0,0,"AL",0.038
"15912",513,"200807.343.1380.4","NMFS",2008,11,5,310,30.13,43.27227,-69.395508,0,0,0,0,0,"AL",0.038
"15913",513,"200807.345.1370.6","NMFS",2008,11,5,310,30.15,43.172645,-69.735498,0,0,0,0,0,"AL",0.038
"15914",521,"200807.346.1230.2","NMFS",2008,11,8,313,29.93,41.381717,-69.33976,1,1,0,1,0,"AL",0.038
"15915",526,"200902.196.1100.7","NMFS",2009,4,1,91,20.02,40.232537,-69.892372,0,0,0,0,0,"HB",0.024
"15916",526,"200902.197.1100.10","NMFS",2009,4,1,91,20.02,40.153148,-69.679132,0,0,0,0,0,"HB",0.024
"15917",526,"200902.198.1100.1","NMFS",2009,4,1,91,20.05,40.099278,-69.656318,0,0,0,0,0,"HB",0.024
"15918",526,"200902.200.1110.2","NMFS",2009,4,2,92,20.02,39.933902,-69.704047,0,0,0,0,0,"HB",0.024
"15919",526,"200902.201.1110.4","NMFS",2009,4,2,92,20.03,39.960022,-69.43301,0,0,0,0,0,"HB",0.024
"15920",526,"200902.202.1100.9","NMFS",2009,4,2,92,20.03,40.276257,-69.312005,2,1,1,1,1,"HB",0.024
"15921",526,"200902.203.1110.5","NMFS",2009,4,2,92,20.02,40.104747,-69.19557,0,0,0,0,0,"HB",0.024
"15922",526,"200902.204.1110.3","NMFS",2009,4,2,92,20.02,40.176545,-68.96909,13,8,5,13,0,"HB",0.024
"15923",526,"200902.206.1100.11","NMFS",2009,4,2,92,20.02,40.469768,-69.05081,0,0,0,0,0,"HB",0.024
"15924",526,"200902.207.1100.4","NMFS",2009,4,2,92,20.03,40.610925,-69.041128,0,0,0,0,0,"HB",0.024
"15925",522,"200902.211.1190.3","NMFS",2009,4,3,93,20.02,41.012477,-68.623315,0,0,0,0,0,"HB",0.024
"15926",525,"200902.212.1190.1","NMFS",2009,4,3,93,20.03,40.897622,-68.374835,2,1,1,1,1,"HB",0.024
"15927",525,"200902.213.1190.7","NMFS",2009,4,3,93,20.03,40.83043,-68.487458,0,0,0,0,0,"HB",0.024
"15928",525,"200902.214.1130.4","NMFS",2009,4,3,93,20.02,40.69153,-68.709737,1,0,1,1,0,"HB",0.024
"15929",525,"200902.216.1130.12","NMFS",2009,4,3,93,20.02,40.349887,-68.819792,0,0,0,0,0,"HB",0.024
"15930",521,"200902.218.1230.1","NMFS",2009,4,3,93,20.02,41.013678,-68.894157,0,0,0,0,0,"HB",0.024
"15931",521,"200902.219.1240.1","NMFS",2009,4,4,94,20.02,41.514935,-69.118563,0,0,0,0,0,"HB",0.024
"15932",521,"200902.220.1240.6","NMFS",2009,4,4,94,20.05,41.682022,-69.509142,4,3,1,4,0,"HB",0.024
"15933",521,"200902.223.3560.1","NMFS",2009,4,4,94,20.02,41.824037,-69.902963,0,0,0,0,0,"HB",0.024
"15934",521,"200902.224.1230.6","NMFS",2009,4,4,94,20.02,41.987942,-69.816108,6,6,0,6,0,"HB",0.024
"15935",521,"200902.225.1270.2","NMFS",2009,4,4,94,20.05,42.156103,-69.801362,3,3,0,3,0,"HB",0.024
"15936",521,"200902.226.1280.7","NMFS",2009,4,4,94,20.03,42.019375,-69.542347,3,3,0,3,0,"HB",0.024
"15937",521,"200902.227.1280.4","NMFS",2009,4,5,95,20.02,41.927627,-69.189632,0,0,0,0,0,"HB",0.024
"15938",522,"200902.228.1240.5","NMFS",2009,4,5,95,20.02,42.018288,-68.820152,0,0,0,0,0,"HB",0.024
"15939",522,"200902.229.1240.3","NMFS",2009,4,5,95,20.03,42.04965,-68.481775,0,0,0,0,0,"HB",0.024
"15940",522,"200902.230.1200.2","NMFS",2009,4,5,95,20.12,41.68715,-68.32228,0,0,0,0,0,"HB",0.024
"15941",522,"200902.231.1220.3","NMFS",2009,4,5,95,20.02,41.806668,-68.260793,2,2,0,2,0,"HB",0.024
"15942",522,"200902.232.1220.1","NMFS",2009,4,5,95,20.03,41.901808,-68.086938,0,0,0,0,0,"HB",0.024
"15943",522,"200902.233.1210.2","NMFS",2009,4,5,95,20.05,41.817557,-68.04506,0,0,0,0,0,"HB",0.024
"15944",522,"200902.234.1200.5","NMFS",2009,4,5,95,20,41.816003,-67.993468,0,0,0,0,0,"HB",0.024
"15945",562,"200902.237.1190.6","NMFS",2009,4,6,96,20.03,41.549942,-67.516827,0,0,0,0,0,"HB",0.024
"15946",562,"200902.238.1190.5","NMFS",2009,4,6,96,20.02,41.428932,-67.507328,0,0,0,0,0,"HB",0.024
"15947",522,"200902.240.1200.1","NMFS",2009,4,6,96,20.03,41.285422,-68.306553,1,0,1,1,0,"HB",0.024
"15948",522,"200902.241.1230.4","NMFS",2009,4,6,96,20.02,41.273005,-68.687347,0,0,0,0,0,"HB",0.024
"15949",522,"200902.242.1230.2","NMFS",2009,4,6,96,20.03,41.187278,-68.782615,0,0,0,0,0,"HB",0.024
"15950",522,"200902.243.1230.3","NMFS",2009,4,6,96,20.03,41.260668,-68.808782,0,0,0,0,0,"HB",0.024
"15951",514,"200902.245.3610.1","NMFS",2009,4,7,97,20.03,42.120152,-70.146665,46,21,25,44,2,"HB",0.024
"15952",514,"200902.246.3610.3","NMFS",2009,4,7,97,20.03,42.065565,-70.293418,26,7,19,25,1,"HB",0.024
"15953",514,"200902.249.3590.2","NMFS",2009,4,7,97,20.02,41.867428,-70.241755,0,0,0,0,0,"HB",0.024
"15954",514,"200902.250.3590.1","NMFS",2009,4,7,97,20.02,41.82196,-70.344553,0,0,0,0,0,"HB",0.024
"15955",514,"200902.251.3600.3","NMFS",2009,4,7,97,20.03,41.89781,-70.399677,23,9,14,22,1,"HB",0.024
"15956",514,"200902.252.3610.2","NMFS",2009,4,7,97,20.03,42.115157,-70.47319,24,13,11,24,0,"HB",0.024
"15957",521,"200902.254.1270.4","NMFS",2009,4,8,98,20.03,42.184617,-69.998713,19,12,7,19,0,"HB",0.024
"15958",514,"200902.255.3560.3","NMFS",2009,4,8,98,20.05,42.025148,-70.01553,0,0,0,0,0,"HB",0.024
"15959",515,"200902.256.1280.5","NMFS",2009,4,8,98,20.03,42.395243,-69.356445,0,0,0,0,0,"HB",0.024
"15960",515,"200902.257.1280.3","NMFS",2009,4,8,98,20.05,42.551883,-69.145797,0,0,0,0,0,"HB",0.024
"15961",515,"200902.258.1280.6","NMFS",2009,4,8,98,20.03,42.42026,-69.12881,3,3,0,3,0,"HB",0.024
"15962",521,"200902.259.1240.7","NMFS",2009,4,8,98,20.13,42.185003,-69.022498,2,2,0,2,0,"HB",0.024
"15963",522,"200902.260.1240.2","NMFS",2009,4,8,98,20.03,42.259218,-68.761952,0,0,0,0,0,"HB",0.024
"15964",522,"200902.261.1240.4","NMFS",2009,4,9,99,20.03,42.20659,-68.731827,1,1,0,1,0,"HB",0.024
"15965",521,"200902.262.1240.8","NMFS",2009,4,9,99,20.02,41.716337,-69.012702,1,1,0,1,0,"HB",0.024
"15966",521,"200902.263.1250.4","NMFS",2009,4,9,99,20.02,41.566728,-69.528095,4,2,2,4,0,"HB",0.024
"15967",521,"200902.264.1230.5","NMFS",2009,4,9,99,20.08,41.480845,-69.32864,0,0,0,0,0,"HB",0.024
"15968",521,"200902.267.1250.1","NMFS",2009,4,9,99,20.02,41.45531,-69.464488,19,11,8,16,3,"HB",0.024
"15969",526,"200902.268.1090.5","NMFS",2009,4,9,99,20.08,40.643102,-69.660702,0,0,0,0,0,"HB",0.024
"15970",526,"200902.269.1090.4","NMFS",2009,4,9,99,20.02,40.726753,-69.908035,0,0,0,0,0,"HB",0.024
"15971",525,"200902.272.1140.4","NMFS",2009,4,15,105,20.03,40.224888,-68.696675,0,0,0,0,0,"HB",0.024
"15972",525,"200902.275.1130.9","NMFS",2009,4,15,105,20.02,40.52332,-68.164095,1,1,0,1,0,"HB",0.024
"15973",525,"200902.276.1130.2","NMFS",2009,4,15,105,20.02,40.718573,-67.847423,0,0,0,0,0,"HB",0.024
"15974",525,"200902.277.1130.5","NMFS",2009,4,15,105,20.18,40.685063,-67.597632,0,0,0,0,0,"HB",0.024
"15975",525,"200902.278.1140.2","NMFS",2009,4,16,106,20.02,40.431088,-67.574842,0,0,0,0,0,"HB",0.024
"15976",525,"200902.279.1150.2","NMFS",2009,4,16,106,20.07,40.450735,-67.334532,3,1,2,3,0,"HB",0.024
"15977",525,"200902.280.1150.1","NMFS",2009,4,17,107,20.03,40.499202,-67.14491,33,28,5,33,0,"HB",0.024
"15978",525,"200902.281.1140.3","NMFS",2009,4,17,107,20.17,40.600347,-67.219797,0,0,0,0,0,"HB",0.024
"15979",525,"200902.283.1130.8","NMFS",2009,4,17,107,20.02,40.853158,-67.216955,0,0,0,0,0,"HB",0.024
"15980",562,"200902.285.1150.4","NMFS",2009,4,17,107,20.02,40.726697,-66.808452,3,3,0,3,0,"HB",0.024
"15981",562,"200902.286.1170.2","NMFS",2009,4,17,107,20.03,40.819395,-66.751957,0,0,0,0,0,"HB",0.024
"15982",562,"200902.287.1160.2","NMFS",2009,4,17,107,20.03,40.97894,-66.683732,0,0,0,0,0,"HB",0.024
"15983",562,"200902.288.1180.1","NMFS",2009,4,17,107,20.03,41.038827,-66.436837,0,0,0,0,0,"HB",0.024
"15984",562,"200902.289.1170.1","NMFS",2009,4,18,108,20.1,41.092402,-66.45649,3,3,0,3,0,"HB",0.024
"15985",562,"200902.290.1160.11","NMFS",2009,4,18,108,20.02,41.259683,-66.487943,0,0,0,0,0,"HB",0.024
"15986",562,"200902.291.1160.6","NMFS",2009,4,18,108,20.03,41.05396,-66.736487,0,0,0,0,0,"HB",0.024
"15987",562,"200902.292.1160.5","NMFS",2009,4,18,108,20.03,41.07018,-67.12964,0,0,0,0,0,"HB",0.024
"15988",562,"200902.293.1160.1","NMFS",2009,4,18,108,20.02,41.282373,-66.982058,0,0,0,0,0,"HB",0.024
"15989",562,"200902.294.1160.7","NMFS",2009,4,18,108,20.02,41.34663,-66.891277,0,0,0,0,0,"HB",0.024
"15990",562,"200902.295.1190.8","NMFS",2009,4,18,108,20.02,41.381662,-67.184168,0,0,0,0,0,"HB",0.024
"15991",562,"200902.296.1190.4","NMFS",2009,4,18,108,20.02,41.69537,-67.289173,8,5,3,3,5,"HB",0.024
"15992",562,"200902.297.1190.2","NMFS",2009,4,18,108,20.03,41.720987,-67.295102,5,0,5,5,0,"HB",0.024
"15993",562,"200902.298.1160.9","NMFS",2009,4,18,108,20.05,41.5685,-66.91859,0,0,0,0,0,"HB",0.024
"15994",562,"200902.299.1160.13","NMFS",2009,4,18,108,20.02,41.53391,-66.772328,0,0,0,0,0,"HB",0.024
"15995",552,"200902.300.1160.10","NMFS",2009,4,19,109,20.05,41.658688,-66.575117,0,0,0,0,0,"HB",0.024
"15996",552,"200902.301.1160.12","NMFS",2009,4,19,109,20.03,41.801738,-66.50615,2,1,1,2,0,"HB",0.024
"15997",552,"200902.302.1160.4","NMFS",2009,4,19,109,20.05,41.311392,-66.28477,0,0,0,0,0,"HB",0.024
"15998",552,"200902.303.1180.2","NMFS",2009,4,19,109,20.02,41.366848,-66.034878,86,84,2,86,0,"HB",0.024
"15999",552,"200902.304.1170.3","NMFS",2009,4,19,109,20.03,41.760697,-65.87607,3,2,1,3,0,"HB",0.024
"16000",551,"200902.305.1180.3","NMFS",2009,4,19,109,20.03,41.928418,-65.725677,0,0,0,0,0,"HB",0.024
"16001",552,"200902.306.1160.8","NMFS",2009,4,19,109,20.05,41.80598,-66.013998,0,0,0,0,0,"HB",0.024
"16002",551,"200902.307.1160.14","NMFS",2009,4,19,109,20.02,41.86042,-66.255965,1,1,0,1,0,"HB",0.024
"16003",551,"200902.308.1160.3","NMFS",2009,4,20,110,20.02,42.068917,-66.26447,0,0,0,0,0,"HB",0.024
"16004",464,"200902.309.1290.6","NMFS",2009,4,20,110,20.07,42.195213,-65.78635,1,1,0,1,0,"HB",0.024
"16005",551,"200902.310.1290.8","NMFS",2009,4,20,110,20.02,42.191535,-66.066358,3,3,0,3,0,"HB",0.024
"16006",464,"200902.311.1290.1","NMFS",2009,4,20,110,20.03,42.381433,-66.285253,1,1,0,1,0,"HB",0.024
"16007",551,"200902.313.1290.4","NMFS",2009,4,20,110,20.02,42.308755,-66.528883,2,2,0,2,0,"HB",0.024
"16008",551,"200902.314.1210.4","NMFS",2009,4,20,110,20.02,42.102933,-66.606482,0,0,0,0,0,"HB",0.024
"16009",551,"200902.315.1220.4","NMFS",2009,4,20,110,20.05,42.188427,-66.975975,7,5,2,7,0,"HB",0.024
"16010",561,"200902.316.1210.1","NMFS",2009,4,20,110,20.03,42.116008,-67.327238,0,0,0,0,0,"HB",0.024
"16011",561,"200902.317.1200.4","NMFS",2009,4,21,111,20.02,41.987698,-67.505495,0,0,0,0,0,"HB",0.024
"16012",522,"200902.318.1210.3","NMFS",2009,4,21,111,20.03,42.01243,-67.783105,0,0,0,0,0,"HB",0.024
"16013",561,"200902.319.1220.2","NMFS",2009,4,21,111,20.02,42.150197,-67.550973,4,3,1,4,0,"HB",0.024
"16014",464,"200902.320.1290.2","NMFS",2009,4,21,111,20.02,42.475163,-67.582835,1,0,1,1,0,"HB",0.024
"16015",513,"200902.322.1260.3","NMFS",2009,4,21,111,20.07,43.177055,-70.003107,3,3,0,3,0,"HB",0.024
"16016",513,"200902.323.1260.4","NMFS",2009,4,22,112,20.05,42.867938,-70.186747,7,6,1,6,1,"HB",0.024
"16017",514,"200902.324.1260.1","NMFS",2009,4,22,112,20.02,42.731093,-70.27978,3,3,0,3,0,"HB",0.024
"16018",514,"200902.327.1270.1","NMFS",2009,4,22,112,20.03,42.701742,-69.998933,1,1,0,1,0,"HB",0.024
"16019",514,"200902.328.1270.5","NMFS",2009,4,22,112,20.05,42.594458,-70.030575,1,1,0,1,0,"HB",0.024
"16020",514,"200902.329.1270.3","NMFS",2009,4,22,112,20.03,42.350345,-70.021772,7,7,0,7,0,"HB",0.024
"16021",514,"200902.330.1260.5","NMFS",2009,4,22,112,20.03,42.313922,-70.327458,9,4,5,9,0,"HB",0.024
"16022",514,"200902.331.1260.2","NMFS",2009,4,22,112,20.03,42.39689,-70.531932,7,1,6,7,0,"HB",0.024
"16023",514,"200902.332.3640.2","NMFS",2009,4,22,112,20.03,42.347657,-70.82341,180,93,87,148,32,"HB",0.024
"16024",514,"200902.333.3650.1","NMFS",2009,4,23,113,20.03,42.36905,-70.723545,87,40,47,75,12,"HB",0.024
"16025",514,"200902.334.3660.3","NMFS",2009,4,23,113,20.03,42.410448,-70.677388,60,25,35,59,1,"HB",0.024
"16026",514,"200902.335.3660.2","NMFS",2009,4,23,113,20.02,42.53601,-70.605702,29,9,20,28,1,"HB",0.024
"16027",513,"200902.336.3640.1","NMFS",2009,4,23,113,20.02,42.835897,-70.762285,4,1,3,3,1,"HB",0.024
"16028",514,"200902.337.1400.3","NMFS",2009,4,23,113,20.03,42.77404,-70.59261,13,5,8,11,2,"HB",0.024
"16029",514,"200902.338.3660.1","NMFS",2009,4,23,113,20,42.733992,-70.575217,35,19,16,21,14,"HB",0.024
"16030",514,"200902.340.3650.3","NMFS",2009,4,23,113,16.05,42.704788,-70.568345,80,39,41,43,37,"HB",0.024
"16031",514,"200902.341.3650.4","NMFS",2009,4,23,113,20.02,42.314765,-70.709588,25,13,12,24,1,"HB",0.024
"16032",515,"200902.342.1280.1","NMFS",2009,4,28,118,20.05,42.684055,-69.491002,0,0,0,0,0,"HB",0.024
"16033",515,"200902.343.1370.6","NMFS",2009,4,29,119,20.07,42.944193,-68.903453,3,3,0,3,0,"HB",0.024
"16034",515,"200902.344.1370.1","NMFS",2009,4,29,119,20.03,42.97359,-68.825643,1,1,0,1,0,"HB",0.024
"16035",515,"200902.345.1280.2","NMFS",2009,4,29,119,20.12,42.647638,-68.62453,0,0,0,0,0,"HB",0.024
"16036",515,"200902.346.1290.10","NMFS",2009,4,29,119,20.02,42.544323,-68.272873,0,0,0,0,0,"HB",0.024
"16037",464,"200902.347.1290.11","NMFS",2009,4,29,119,20.08,42.563182,-67.658892,1,1,0,1,0,"HB",0.024
"16038",551,"200902.348.1300.2","NMFS",2009,4,29,119,20.03,42.329438,-67.245837,1,1,0,1,0,"HB",0.024
"16039",551,"200902.349.1290.7","NMFS",2009,4,29,119,20.2,42.307772,-67.212358,2,2,0,2,0,"HB",0.024
"16040",464,"200902.350.1300.1","NMFS",2009,4,29,119,20.05,42.520395,-66.933078,8,7,1,8,0,"HB",0.024
"16041",464,"200902.351.1300.3","NMFS",2009,4,30,120,20.03,42.513458,-67.113962,4,4,0,4,0,"HB",0.024
"16042",464,"200902.352.1290.9","NMFS",2009,4,30,120,20.03,42.727825,-67.300972,0,0,0,0,0,"HB",0.024
"16043",464,"200902.353.1360.9","NMFS",2009,4,30,120,20.02,42.881548,-67.037917,3,2,1,3,0,"HB",0.024
"16044",464,"200902.354.1360.11","NMFS",2009,4,30,120,20.03,42.917183,-67.308622,6,6,0,6,0,"HB",0.024
"16045",515,"200902.357.1360.13","NMFS",2009,4,30,120,20.02,43.146507,-67.844877,20,18,2,20,0,"HB",0.024
"16046",465,"200902.358.1360.8","NMFS",2009,4,30,120,20.07,43.10117,-67.29189,0,0,0,0,0,"HB",0.024
"16047",464,"200902.359.1340.4","NMFS",2009,5,1,121,20.05,42.952673,-66.889777,0,0,0,0,0,"HB",0.024
"16048",465,"200902.360.1340.3","NMFS",2009,5,1,121,20.03,43.37901,-66.639122,3,2,1,3,0,"HB",0.024
"16049",465,"200902.361.1340.5","NMFS",2009,5,1,121,20.13,43.459128,-66.588742,5,2,3,5,0,"HB",0.024
"16050",465,"200902.362.1340.6","NMFS",2009,5,1,121,20.02,43.681822,-66.640652,2,0,2,2,0,"HB",0.024
"16051",465,"200902.363.1340.2","NMFS",2009,5,1,121,20.02,43.690878,-66.864905,18,10,8,18,0,"HB",0.024
"16052",511,"200902.364.1351.4","NMFS",2009,5,1,121,20.4,44.387675,-67.016772,3,3,0,3,0,"HB",0.024
"16053",511,"200902.365.1351.1","NMFS",2009,5,2,122,20.02,44.314613,-66.84761,10,4,6,10,0,"HB",0.024
"16054",511,"200902.366.1351.3","NMFS",2009,5,2,122,20.03,44.18788,-67.182057,0,0,0,0,0,"HB",0.024
"16055",511,"200902.367.1340.1","NMFS",2009,5,2,122,20.02,44.030427,-67.171478,2,2,0,2,0,"HB",0.024
"16056",511,"200902.368.1340.7","NMFS",2009,5,2,122,20.05,43.941317,-67.298835,1,1,0,1,0,"HB",0.024
"16057",465,"200902.369.1360.3","NMFS",2009,5,2,122,20.03,43.805492,-67.509757,3,2,1,3,0,"HB",0.024
"16058",465,"200902.370.1360.2","NMFS",2009,5,2,122,20.07,43.81342,-67.551042,2,2,0,2,0,"HB",0.024
"16059",511,"200902.371.1360.5","NMFS",2009,5,2,122,20.02,43.904997,-67.635895,7,5,2,7,0,"HB",0.024
"16060",511,"200902.373.1380.9","NMFS",2009,5,2,122,20.02,44.23056,-67.519712,6,4,2,6,0,"HB",0.024
"16061",511,"200902.374.1351.2","NMFS",2009,5,2,122,20.05,44.347298,-67.220523,0,0,0,0,0,"HB",0.024
"16062",511,"200902.375.1390.5","NMFS",2009,5,3,123,20.02,44.282018,-67.661512,10,7,3,10,0,"HB",0.024
"16063",512,"200902.376.1380.7","NMFS",2009,5,3,123,20.03,44.061742,-67.86158,12,9,3,11,1,"HB",0.024
"16064",512,"200902.377.1390.3","NMFS",2009,5,3,123,20.03,44.14809,-67.89951,17,9,8,17,0,"HB",0.024
"16065",512,"200902.378.1390.1","NMFS",2009,5,3,123,20.03,44.164612,-68.025423,96,56,40,80,16,"HB",0.024
"16066",512,"200902.379.1390.2","NMFS",2009,5,3,123,19.23,43.916862,-68.511557,13,7,6,13,0,"HB",0.024
"16067",512,"200902.380.1380.2","NMFS",2009,5,3,123,20.02,43.868143,-68.219473,5,2,3,5,0,"HB",0.024
"16068",512,"200902.381.1380.5","NMFS",2009,5,3,123,20.02,43.863938,-68.174213,0,0,0,0,0,"HB",0.024
"16069",512,"200902.382.1360.6","NMFS",2009,5,3,123,20.03,43.724255,-68.01716,4,3,1,4,0,"HB",0.024
"16070",512,"200902.383.1360.1","NMFS",2009,5,4,124,20.02,43.644013,-67.911157,4,4,0,4,0,"HB",0.024
"16071",512,"200902.384.1360.7","NMFS",2009,5,4,124,20.03,43.475575,-68.044577,5,5,0,5,0,"HB",0.024
"16072",512,"200902.385.1360.10","NMFS",2009,5,4,124,20.03,43.396997,-68.164092,4,3,1,4,0,"HB",0.024
"16073",512,"200902.386.1380.8","NMFS",2009,5,4,124,20.03,43.61087,-68.350528,3,3,0,3,0,"HB",0.024
"16074",512,"200902.387.1380.4","NMFS",2009,5,4,124,20.03,43.583638,-68.573767,2,2,0,2,0,"HB",0.024
"16075",515,"200902.388.1370.2","NMFS",2009,5,4,124,20.03,43.237533,-68.637385,0,0,0,0,0,"HB",0.024
"16076",515,"200902.389.1370.5","NMFS",2009,5,4,124,20.02,43.18666,-68.855505,3,3,0,2,1,"HB",0.024
"16077",515,"200902.390.1370.4","NMFS",2009,5,4,124,20.08,43.186635,-68.965482,4,4,0,4,0,"HB",0.024
"16078",513,"200902.391.1370.7","NMFS",2009,5,4,124,20.03,43.155533,-69.282273,1,1,0,1,0,"HB",0.024
"16079",513,"200902.392.1370.3","NMFS",2009,5,4,124,20.02,43.27202,-69.298038,3,3,0,3,0,"HB",0.024
"16080",513,"200902.393.1380.6","NMFS",2009,5,5,125,20.05,43.48068,-69.114043,0,0,0,0,0,"HB",0.024
"16081",512,"200902.394.1380.3","NMFS",2009,5,5,125,20.03,43.449465,-68.8986,11,8,3,11,0,"HB",0.024
"16082",512,"200902.395.1390.4","NMFS",2009,5,5,125,20.02,43.833165,-69.064805,354,153,201,206,148,"HB",0.024
"16083",512,"200902.396.1400.4","NMFS",2009,5,5,125,20.25,43.78107,-69.097648,104,51,53,83,21,"HB",0.024
"16084",513,"200902.397.1400.2","NMFS",2009,5,5,125,20.02,43.77537,-69.386855,209,97,112,128,81,"HB",0.024
"16085",513,"200902.398.1400.1","NMFS",2009,5,5,125,20.08,43.568323,-69.95469,31,17,14,26,5,"HB",0.024
"16086",513,"200902.399.1270.7","NMFS",2009,5,6,126,20.05,43.229558,-70.135063,4,4,0,4,0,"HB",0.024
"16087",513,"200902.400.1270.6","NMFS",2009,5,6,126,20.02,43.02797,-70.156175,2,2,0,2,0,"HB",0.024
"16088",514,"200902.401.1260.8","NMFS",2009,5,6,126,20.08,42.564615,-70.23561,2,0,2,2,0,"HB",0.024
"16089",521,"200902.410.1230.9","NMFS",2009,5,7,127,20.03,41.6521,-69.581917,4,3,1,4,0,"HB",0.024
"16090",521,"200902.411.1230.8","NMFS",2009,5,7,127,20.02,41.269437,-69.268713,0,0,0,0,0,"HB",0.024
"16091",521,"200902.412.1230.7","NMFS",2009,5,7,127,20.02,41.191862,-69.097347,0,0,0,0,0,"HB",0.024
"16092",521,"200902.413.1250.7","NMFS",2009,5,7,127,20.02,41.078932,-69.29419,1,1,0,1,0,"HB",0.024
"16093",526,"200902.414.1100.13","NMFS",2009,5,7,127,20.05,40.940128,-69.056005,1,1,0,1,0,"HB",0.024
"16094",526,"200902.415.1100.12","NMFS",2009,5,8,128,20.03,40.653508,-69.16488,0,0,0,0,0,"HB",0.024
"16095",526,"200902.416.1090.7","NMFS",2009,5,8,128,20.02,40.691728,-69.383733,0,0,0,0,0,"HB",0.024
"16096",526,"200904.180.1110.2","NMFS",2009,10,4,277,20.07,40.073807,-69.990383,3,0,3,1,2,"HB",0.024
"16097",526,"200904.181.1100.1","NMFS",2009,10,4,277,20.05,40.09838,-69.66214,1,0,1,1,0,"HB",0.024
"16098",526,"200904.182.1100.2","NMFS",2009,10,4,277,20.02,40.34623,-69.281803,1,1,0,1,0,"HB",0.024
"16099",526,"200904.183.1100.6","NMFS",2009,10,4,277,20.03,40.433878,-69.321582,0,0,0,0,0,"HB",0.024
"16100",526,"200904.184.1100.3","NMFS",2009,10,5,278,20.02,40.308262,-69.996552,3,1,2,1,2,"HB",0.024
"16101",526,"200904.205.1090.5","NMFS",2009,10,20,293,20.02,40.643775,-69.268797,0,0,0,0,0,"HB",0.024
"16102",526,"200904.207.1100.11","NMFS",2009,10,20,293,20.03,40.838462,-69.13633,2,2,0,2,0,"HB",0.024
"16103",526,"200904.208.1100.7","NMFS",2009,10,20,293,35.13,40.816285,-68.960365,0,0,0,0,0,"HB",0.024
"16104",526,"200904.210.1100.12","NMFS",2009,10,20,293,20.02,40.684497,-68.943108,3,3,0,3,0,"HB",0.024
"16105",526,"200904.211.1100.9","NMFS",2009,10,20,293,20.02,40.590077,-69.035503,0,0,0,0,0,"HB",0.024
"16106",525,"200904.212.1130.1","NMFS",2009,10,20,293,20.02,40.47806,-68.758912,0,0,0,0,0,"HB",0.024
"16107",525,"200904.213.1110.4","NMFS",2009,10,20,293,20.03,40.228553,-68.82062,0,0,0,0,0,"HB",0.024
"16108",526,"200904.214.1120.1","NMFS",2009,10,20,293,20.05,40.049822,-68.895303,8,6,2,8,0,"HB",0.024
"16109",525,"200904.216.1140.5","NMFS",2009,10,21,294,20.03,40.180705,-68.752548,6,2,4,6,0,"HB",0.024
"16110",525,"200904.217.1140.4","NMFS",2009,10,21,294,20.03,40.431777,-68.286365,0,0,0,0,0,"HB",0.024
"16111",525,"200904.218.1130.9","NMFS",2009,10,21,294,20.02,40.552033,-68.010025,0,0,0,0,0,"HB",0.024
"16112",525,"200904.220.1140.6","NMFS",2009,10,21,294,20.03,40.445173,-67.547987,0,0,0,0,0,"HB",0.024
"16113",525,"200904.221.1150.2","NMFS",2009,10,21,294,20.03,40.451467,-67.323235,9,9,0,9,0,"HB",0.024
"16114",525,"200904.222.1150.1","NMFS",2009,10,21,294,20.07,40.554282,-67.099587,3,2,1,3,0,"HB",0.024
"16115",525,"200904.223.1140.1","NMFS",2009,10,21,294,20.02,40.642282,-67.131392,2,2,0,2,0,"HB",0.024
"16116",525,"200904.226.1130.4","NMFS",2009,10,22,295,20.03,40.748355,-67.310548,2,2,0,2,0,"HB",0.024
"16117",525,"200904.227.1130.2","NMFS",2009,10,22,295,20.05,40.81307,-67.3978,1,1,0,1,0,"HB",0.024
"16118",525,"200904.228.1130.3","NMFS",2009,10,22,295,20.02,40.894097,-67.234553,2,2,0,2,0,"HB",0.024
"16119",525,"200904.229.1130.5","NMFS",2009,10,22,295,20.02,40.93701,-67.76721,0,0,0,0,0,"HB",0.024
"16120",525,"200904.230.1130.10","NMFS",2009,10,22,295,20.03,40.772598,-67.98103,2,2,0,2,0,"HB",0.024
"16121",521,"200904.231.1230.5","NMFS",2009,10,22,295,20.02,41.057043,-69.095378,0,0,0,0,0,"HB",0.024
"16122",521,"200904.232.1230.7","NMFS",2009,10,22,295,20.07,41.260755,-69.157583,0,0,0,0,0,"HB",0.024
"16123",521,"200904.233.1230.2","NMFS",2009,10,22,295,20.02,41.33497,-69.271478,0,0,0,0,0,"HB",0.024
"16124",522,"200904.234.1230.1","NMFS",2009,10,28,301,20.07,41.235007,-68.623025,14,14,0,14,0,"HB",0.024
"16125",522,"200904.236.1230.3","NMFS",2009,10,28,301,20.03,41.476057,-68.482828,2,2,0,2,0,"HB",0.024
"16126",522,"200904.237.1200.4","NMFS",2009,10,28,301,20.03,41.389965,-68.227257,8,7,1,6,2,"HB",0.024
"16127",522,"200904.238.1200.5","NMFS",2009,10,28,301,20.05,41.29369,-68.292608,18,13,5,4,14,"HB",0.024
"16128",562,"200904.241.1190.1","NMFS",2009,10,30,303,20.03,41.204235,-67.660305,0,0,0,0,0,"HB",0.024
"16129",525,"200904.242.1190.10","NMFS",2009,10,30,303,20.03,41.33253,-67.853638,0,0,0,0,0,"HB",0.024
"16130",562,"200904.243.1190.6","NMFS",2009,10,30,303,20.02,41.440508,-67.413013,1,1,0,1,0,"HB",0.024
"16131",562,"200904.244.1190.3","NMFS",2009,10,30,303,20.02,41.177873,-67.446245,0,0,0,0,0,"HB",0.024
"16132",525,"200904.245.1130.8","NMFS",2009,10,30,303,20.15,41.103192,-67.251297,0,0,0,0,0,"HB",0.024
"16133",562,"200904.246.1180.2","NMFS",2009,10,30,303,NA,40.817715,-66.68071,16,14,2,15,1,"HB",0.024
"16134",562,"200904.247.1170.3","NMFS",2009,10,30,303,20.03,40.88889,-66.648288,1,1,0,1,0,"HB",0.024
"16135",562,"200904.248.1160.1","NMFS",2009,10,30,303,20.03,41.028695,-66.522067,2,2,0,2,0,"HB",0.024
"16136",562,"200904.249.1160.3","NMFS",2009,10,30,303,20.03,41.060223,-66.601117,4,4,0,4,0,"HB",0.024
"16137",562,"200904.250.1160.10","NMFS",2009,10,31,304,20.03,41.16252,-66.707272,2,2,0,2,0,"HB",0.024
"16138",562,"200904.251.1160.14","NMFS",2009,10,31,304,20.08,41.271437,-66.639853,2,2,0,2,0,"HB",0.024
"16139",562,"200904.252.1160.9","NMFS",2009,10,31,304,20.03,41.413727,-66.908222,2,2,0,2,0,"HB",0.024
"16140",562,"200904.253.1160.13","NMFS",2009,10,31,304,20.02,41.49626,-67.032905,1,0,1,1,0,"HB",0.024
"16141",562,"200904.254.1160.4","NMFS",2009,10,31,304,20.02,41.596828,-66.937288,63,63,0,63,0,"HB",0.024
"16142",562,"200904.255.1190.5","NMFS",2009,10,31,304,20.03,41.652778,-67.165233,13,6,7,11,2,"HB",0.024
"16143",562,"200904.256.1190.2","NMFS",2009,10,31,304,20.02,41.699267,-67.375593,1,1,0,1,0,"HB",0.024
"16144",562,"200904.257.1190.7","NMFS",2009,10,31,304,20.03,41.60892,-67.62568,0,0,0,0,0,"HB",0.024
"16145",561,"200904.258.1200.6","NMFS",2009,10,31,304,20.08,41.842688,-67.59489,0,0,0,0,0,"HB",0.024
"16146",561,"200904.259.1190.9","NMFS",2009,10,31,304,20.02,41.89834,-67.14297,0,0,0,0,0,"HB",0.024
"16147",562,"200904.260.1160.2","NMFS",2009,11,1,305,20.03,41.729162,-66.793527,1,1,0,1,0,"HB",0.024
"16148",551,"200904.261.1160.12","NMFS",2009,11,1,305,20.02,41.866132,-66.700442,7,7,0,7,0,"HB",0.024
"16149",552,"200904.262.1160.7","NMFS",2009,11,1,305,20.03,41.654382,-66.573377,7,5,2,7,0,"HB",0.024
"16150",552,"200904.263.1160.8","NMFS",2009,11,1,305,20.02,41.372633,-66.307802,4,4,0,4,0,"HB",0.024
"16151",552,"200904.266.1160.6","NMFS",2009,11,1,305,20.02,41.438362,-66.228313,3,2,1,3,0,"HB",0.024
"16152",552,"200904.268.1170.4","NMFS",2009,11,1,305,20.02,41.435198,-66.160792,2,2,0,2,0,"HB",0.024
"16153",552,"200904.269.1170.1","NMFS",2009,11,1,305,20.03,41.73024,-65.788448,0,0,0,0,0,"HB",0.024
"16154",551,"200904.271.1160.5","NMFS",2009,11,2,306,20.03,41.979095,-66.213675,4,4,0,4,0,"HB",0.024
"16155",464,"200904.272.1290.7","NMFS",2009,11,2,306,20.02,42.353333,-66.220448,0,0,0,0,0,"HB",0.024
"16156",464,"200904.273.1290.6","NMFS",2009,11,2,306,20.02,42.384218,-66.254192,0,0,0,0,0,"HB",0.024
"16157",464,"200904.275.1290.4","NMFS",2009,11,2,306,20.02,42.52058,-66.646947,5,4,1,5,0,"HB",0.024
"16158",464,"200904.276.1360.7","NMFS",2009,11,2,306,20.03,42.773508,-66.867493,2,2,0,2,0,"HB",0.024
"16159",465,"200904.279.1340.6","NMFS",2009,11,3,307,20.03,43.080367,-67.001458,1,1,0,1,0,"HB",0.024
"16160",465,"200904.280.1360.8","NMFS",2009,11,3,307,20.02,43.05405,-67.244458,0,0,0,0,0,"HB",0.024
"16161",464,"200904.282.1290.9","NMFS",2009,11,3,307,20.02,42.736947,-67.322242,0,0,0,0,0,"HB",0.024
"16162",464,"200904.283.1290.5","NMFS",2009,11,3,307,20.02,42.658127,-67.21989,0,0,0,0,0,"HB",0.024
"16163",464,"200904.284.1300.1","NMFS",2009,11,3,307,20.05,42.470373,-67.177057,0,0,0,0,0,"HB",0.024
"16164",464,"200904.285.1300.3","NMFS",2009,11,3,307,20.05,42.435622,-67.138378,2,1,1,2,0,"HB",0.024
"16165",551,"200904.286.1220.1","NMFS",2009,11,3,307,20.03,42.192547,-66.848203,3,3,0,3,0,"HB",0.024
"16166",551,"200904.287.1210.1","NMFS",2009,11,3,307,20.02,42.111893,-66.795312,2,2,0,2,0,"HB",0.024
"16167",551,"200904.288.1160.11","NMFS",2009,11,4,308,20.02,42.070278,-66.896625,1,1,0,1,0,"HB",0.024
"16168",551,"200904.289.1210.2","NMFS",2009,11,4,308,20.12,42.088943,-67.039305,3,3,0,3,0,"HB",0.024
"16169",551,"200904.290.1220.3","NMFS",2009,11,4,308,20.03,42.19083,-67.120293,0,0,0,0,0,"HB",0.024
"16170",561,"200904.292.1220.4","NMFS",2009,11,4,308,20.03,42.186987,-67.2237,3,2,1,2,1,"HB",0.024
"16171",464,"200904.293.1300.2","NMFS",2009,11,4,308,20.03,42.346853,-67.381313,0,0,0,0,0,"HB",0.024
"16172",561,"200904.294.1290.2","NMFS",2009,11,4,308,20.02,42.268843,-67.438637,0,0,0,0,0,"HB",0.024
"16173",561,"200904.295.1210.3","NMFS",2009,11,4,308,20.07,42.069705,-67.516085,20,18,2,20,0,"HB",0.024
"16174",522,"200904.296.1200.3","NMFS",2009,11,4,308,20.02,41.809967,-68.015212,2,2,0,2,0,"HB",0.024
"16175",522,"200904.297.1200.2","NMFS",2009,11,5,309,20.03,41.762187,-68.02324,6,3,3,6,0,"HB",0.024
"16176",522,"200904.298.1210.4","NMFS",2009,11,5,309,20.07,41.743837,-68.264362,0,0,0,0,0,"HB",0.024
"16177",522,"200904.299.1220.2","NMFS",2009,11,5,309,20.02,41.75778,-68.355445,0,0,0,0,0,"HB",0.024
"16178",522,"200904.300.1290.3","NMFS",2009,11,5,309,20.02,41.922945,-68.250292,0,0,0,0,0,"HB",0.024
"16179",522,"200904.301.1240.2","NMFS",2009,11,5,309,20.02,42.166187,-68.58605,0,0,0,0,0,"HB",0.024
"16180",522,"200904.302.1240.5","NMFS",2009,11,5,309,20.05,41.99527,-68.722472,0,0,0,0,0,"HB",0.024
"16181",521,"200904.303.1240.6","NMFS",2009,11,5,309,20.03,42.080432,-68.884675,0,0,0,0,0,"HB",0.024
"16182",521,"200904.304.1240.8","NMFS",2009,11,5,309,20.02,42.265632,-68.986558,0,0,0,0,0,"HB",0.024
"16183",515,"200904.305.1280.6","NMFS",2009,11,5,309,20.03,42.386127,-68.826332,0,0,0,0,0,"HB",0.024
"16184",515,"200904.306.1280.5","NMFS",2009,11,5,309,20.05,42.385933,-68.921292,0,0,0,0,0,"HB",0.024
"16185",515,"200904.307.1370.4","NMFS",2009,11,6,310,20.63,42.642673,-69.068625,0,0,0,0,0,"HB",0.024
"16186",514,"200904.308.3640.2","NMFS",2009,11,9,313,20.05,42.402338,-70.8242,67,41,26,59,8,"HB",0.024
"16187",514,"200904.310.3660.1","NMFS",2009,11,10,314,20.05,42.390165,-70.678533,65,36,29,61,4,"HB",0.024
"16188",514,"200904.311.3640.1","NMFS",2009,11,10,314,20.03,42.238627,-70.62947,67,40,27,61,6,"HB",0.024
"16189",514,"200904.312.1260.5","NMFS",2009,11,10,314,20.08,42.341025,-70.303147,11,8,3,11,0,"HB",0.024
"16190",514,"200904.314.1260.3","NMFS",2009,11,10,314,20.03,42.18525,-70.161845,0,0,0,0,0,"HB",0.024
"16191",521,"200904.315.1270.1","NMFS",2009,11,11,315,20.02,42.238138,-69.879773,0,0,0,0,0,"HB",0.024
"16192",521,"200904.316.1270.2","NMFS",2009,11,11,315,20.02,42.11005,-69.85612,1,1,0,1,0,"HB",0.024
"16193",521,"200904.317.1250.1","NMFS",2009,11,11,315,20.02,41.99215,-69.915593,60,46,14,59,1,"HB",0.024
"16194",521,"200904.318.3560.1","NMFS",2009,11,11,315,20.03,41.989875,-69.977115,2,1,1,2,0,"HB",0.024
"16195",521,"200904.319.3560.2","NMFS",2009,11,11,315,20.07,41.947868,-69.944978,4,3,1,4,0,"HB",0.024
"16196",521,"200904.323.1250.2","NMFS",2009,11,11,315,20.07,41.358052,-69.476717,5,2,3,5,0,"HB",0.024
"16197",521,"200904.324.1240.4","NMFS",2009,11,12,316,20.03,41.468818,-69.06716,0,0,0,0,0,"HB",0.024
"16198",521,"200904.325.1240.3","NMFS",2009,11,12,316,20.03,41.71452,-69.118463,0,0,0,0,0,"HB",0.024
"16199",521,"200904.326.1240.7","NMFS",2009,11,12,316,20.03,41.755655,-68.858443,0,0,0,0,0,"HB",0.024
"16200",521,"200904.327.1240.1","NMFS",2009,11,12,316,20.03,41.908103,-69.015885,0,0,0,0,0,"HB",0.024
"16201",521,"200904.328.1280.3","NMFS",2009,11,12,316,20.07,41.997877,-69.153875,0,0,0,0,0,"HB",0.024
"16202",515,"200904.330.1280.4","NMFS",2009,11,12,316,20.07,42.495898,-69.555718,1,1,0,1,0,"HB",0.024
"16203",515,"200904.331.1280.1","NMFS",2009,11,12,316,20.1,42.616407,-69.380388,0,0,0,0,0,"HB",0.024
"16204",513,"200904.332.1370.1","NMFS",2009,11,13,317,20.03,42.856913,-69.592522,0,0,0,0,0,"HB",0.024
"16205",515,"200904.333.1370.6","NMFS",2009,11,13,317,20.03,42.945367,-69.311755,0,0,0,0,0,"HB",0.024
"16206",515,"200904.334.1370.2","NMFS",2009,11,13,317,20.03,43.006878,-68.980402,0,0,0,0,0,"HB",0.024
"16207",515,"200904.336.1360.4","NMFS",2009,11,13,317,20.03,43.136018,-68.3225,0,0,0,0,0,"HB",0.024
"16208",515,"200904.337.1380.3","NMFS",2009,11,13,317,20.05,43.31244,-68.685603,0,0,0,0,0,"HB",0.024
"16209",512,"200904.338.1380.6","NMFS",2009,11,13,317,20.02,43.39402,-68.672038,5,5,0,5,0,"HB",0.024
"16210",512,"200904.339.1360.9","NMFS",2009,11,14,318,20.03,43.438158,-68.165948,0,0,0,0,0,"HB",0.024
"16211",512,"200904.340.1360.6","NMFS",2009,11,14,318,20.02,43.553703,-68.07302,1,1,0,1,0,"HB",0.024
"16212",515,"200904.341.1360.3","NMFS",2009,11,14,318,20.02,43.324215,-67.904163,0,0,0,0,0,"HB",0.024
"16213",465,"200904.343.1360.5","NMFS",2009,11,14,318,20.03,43.492563,-67.178215,2,2,0,2,0,"HB",0.024
"16214",465,"200904.344.1340.1","NMFS",2009,11,14,318,20.05,43.665663,-67.189425,1,1,0,1,0,"HB",0.024
"16215",465,"200904.345.1340.4","NMFS",2009,11,14,318,20.05,43.699138,-67.154825,6,5,1,6,0,"HB",0.024
"16216",511,"200904.347.1351.1","NMFS",2009,11,15,319,20.03,44.187978,-67.120887,2,0,2,2,0,"HB",0.024
"16217",511,"200904.348.1351.2","NMFS",2009,11,15,319,20.02,44.241153,-66.978057,1,1,0,1,0,"HB",0.024
"16218",511,"200904.349.1351.3","NMFS",2009,11,15,319,20.02,44.320102,-67.191137,1,1,0,1,0,"HB",0.024
"16219",511,"200904.350.1360.1","NMFS",2009,11,15,319,20.03,44.223702,-67.350535,0,0,0,0,0,"HB",0.024
"16220",511,"200904.351.1360.10","NMFS",2009,11,15,319,20.05,44.161455,-67.315982,0,0,0,0,0,"HB",0.024
"16221",512,"200904.353.1390.2","NMFS",2009,11,15,319,20.03,44.14564,-67.909008,101,62,39,98,3,"HB",0.024
"16222",512,"200904.354.1390.1","NMFS",2009,11,15,319,20.02,44.08479,-67.883755,47,33,14,46,1,"HB",0.024
"16223",512,"200904.355.1380.4","NMFS",2009,11,15,319,20.05,43.950577,-67.918952,17,15,2,17,0,"HB",0.024
"16224",511,"200904.356.1360.2","NMFS",2009,11,16,320,20.03,43.865845,-67.655963,1,1,0,1,0,"HB",0.024
"16225",512,"200904.357.1360.11","NMFS",2009,11,16,320,20.05,43.75053,-67.77521,2,1,1,2,0,"HB",0.024
"16226",512,"200904.358.1380.2","NMFS",2009,11,16,320,20.05,43.528643,-68.945135,26,22,4,25,1,"HB",0.024
"16227",513,"200904.359.1400.1","NMFS",2009,11,16,320,20.03,43.529165,-69.802062,18,16,2,18,0,"HB",0.024
"16228",513,"200904.360.1400.3","NMFS",2009,11,16,320,20.02,43.51167,-69.923272,30,21,9,29,1,"HB",0.024
"16229",513,"200904.361.1380.7","NMFS",2009,11,16,320,20.03,43.391048,-69.794338,11,11,0,11,0,"HB",0.024
"16230",513,"200904.362.1380.1","NMFS",2009,11,17,321,20.03,43.404547,-69.56329,4,4,0,4,0,"HB",0.024
"16231",513,"200904.363.1370.5","NMFS",2009,11,17,321,20.05,43.192885,-69.83799,0,0,0,0,0,"HB",0.024
"16232",513,"200904.365.1270.3","NMFS",2009,11,17,321,20.02,42.84008,-70.025775,0,0,0,0,0,"HB",0.024
"16233",513,"200904.366.1270.4","NMFS",2009,11,17,321,20.02,42.959322,-70.129025,0,0,0,0,0,"HB",0.024
"16234",513,"200904.367.1400.2","NMFS",2009,11,17,321,20.02,42.959052,-70.406667,48,44,4,48,0,"HB",0.024
"16235",514,"200904.368.1260.4","NMFS",2009,11,17,321,20.03,42.651335,-70.164935,0,0,0,0,0,"HB",0.024
"16236",514,"200904.369.1260.2","NMFS",2009,11,17,321,20.03,42.686172,-70.37593,3,3,0,3,0,"HB",0.024
"16237",514,"200904.370.3660.2","NMFS",2009,11,17,321,20.37,42.650573,-70.4639,14,6,8,14,0,"HB",0.024
"16238",514,"200904.371.3660.3","NMFS",2009,11,17,321,20.05,42.527688,-70.606637,164,74,90,147,17,"HB",0.024
"16239",514,"200904.372.3650.2","NMFS",2009,11,17,321,20.03,42.471308,-70.757338,223,126,97,201,22,"HB",0.024
"16240",514,"200904.373.3650.1","NMFS",2009,11,18,322,20.03,42.499772,-70.736382,137,65,72,117,20,"HB",0.024
"16241",514,"200904.374.3610.1","NMFS",2009,11,18,322,20.02,42.102738,-70.0695,85,31,54,85,0,"HB",0.024
"16242",514,"200904.375.3610.3","NMFS",2009,11,18,322,20.03,42.065265,-70.37504,71,25,46,66,5,"HB",0.024
"16243",514,"200904.376.3610.2","NMFS",2009,11,18,322,20.03,42.024752,-70.449728,56,33,23,47,9,"HB",0.024
"16244",514,"200904.377.3590.1","NMFS",2009,11,18,322,20.23,41.888803,-70.45569,21,14,7,6,15,"HB",0.024
"16245",514,"200904.378.3590.2","NMFS",2009,11,18,322,20.05,41.846588,-70.421422,18,8,10,13,5,"HB",0.024
"16246",514,"200904.379.3600.2","NMFS",2009,11,18,322,20.05,41.88531,-70.426202,8,4,4,7,1,"HB",0.024
"16247",514,"200904.380.3600.1","NMFS",2009,11,18,322,20.02,41.897817,-70.286453,9,1,8,7,2,"HB",0.024
"16248",526,"201001.208.1110.4","NMFS",2010,4,1,91,20.02,39.980697,-69.692638,0,0,0,0,0,"HB",0.024
"16249",526,"201001.209.1100.9","NMFS",2010,4,1,91,20.03,40.1834,-69.758873,0,0,0,0,0,"HB",0.024
"16250",526,"201001.210.1100.6","NMFS",2010,4,2,92,20.03,40.015605,-69.483932,0,0,0,0,0,"HB",0.024
"16251",526,"201001.211.1110.3","NMFS",2010,4,2,92,20.03,39.969328,-69.389782,0,0,0,0,0,"HB",0.024
"16252",526,"201001.212.1120.3","NMFS",2010,4,2,92,20.03,40.018372,-69.117488,4,3,1,3,1,"HB",0.024
"16253",526,"201001.213.1110.2","NMFS",2010,4,2,92,20.02,40.072428,-69.163953,0,0,0,0,0,"HB",0.024
"16254",526,"201001.214.1100.8","NMFS",2010,4,2,92,20.02,40.462978,-69.476545,0,0,0,0,0,"HB",0.024
"16255",526,"201001.215.1100.7","NMFS",2010,4,2,92,20.07,40.60214,-68.892182,0,0,0,0,0,"HB",0.024
"16256",525,"201001.216.1130.5","NMFS",2010,4,2,92,20.03,40.72486,-68.782795,0,0,0,0,0,"HB",0.024
"16257",525,"201001.218.1130.10","NMFS",2010,4,2,92,20.02,40.671977,-68.647428,0,0,0,0,0,"HB",0.024
"16258",525,"201001.219.1130.7","NMFS",2010,4,2,92,20.02,40.592293,-68.705848,0,0,0,0,0,"HB",0.024
"16259",525,"201001.220.1130.1","NMFS",2010,4,3,93,20.03,40.30182,-68.788198,0,0,0,0,0,"HB",0.024
"16260",525,"201001.221.1140.2","NMFS",2010,4,3,93,20.03,40.146523,-68.735977,0,0,0,0,0,"HB",0.024
"16261",525,"201001.223.1140.4","NMFS",2010,4,3,93,20.02,40.316633,-68.495852,0,0,0,0,0,"HB",0.024
"16262",525,"201001.224.1130.4","NMFS",2010,4,3,93,20.03,40.602762,-68.080463,0,0,0,0,0,"HB",0.024
"16263",525,"201001.225.1130.6","NMFS",2010,4,3,93,20.05,40.767197,-68.182362,0,0,0,0,0,"HB",0.024
"16264",525,"201001.226.1130.9","NMFS",2010,4,3,93,20.07,40.724565,-67.884408,0,0,0,0,0,"HB",0.024
"16265",525,"201001.227.1140.1","NMFS",2010,4,3,93,20.08,40.519512,-67.668395,0,0,0,0,0,"HB",0.024
"16266",525,"201001.228.1130.3","NMFS",2010,4,3,93,20.03,40.635355,-67.563608,0,0,0,0,0,"HB",0.024
"16267",525,"201001.229.1130.8","NMFS",2010,4,3,93,20.02,40.84946,-67.506495,0,0,0,0,0,"HB",0.024
"16268",525,"201001.230.1140.3","NMFS",2010,4,3,93,20.03,40.6186,-67.133043,0,0,0,0,0,"HB",0.024
"16269",525,"201001.231.1150.3","NMFS",2010,4,4,94,20.02,40.553525,-67.092895,0,0,0,0,0,"HB",0.024
"16270",525,"201001.232.1150.1","NMFS",2010,4,4,94,20.03,40.717165,-66.84881,0,0,0,0,0,"HB",0.024
"16271",562,"201001.233.1170.3","NMFS",2010,4,4,94,20.03,40.857895,-66.721262,4,3,1,4,0,"HB",0.024
"16272",562,"201001.234.1160.4","NMFS",2010,4,4,94,20.03,41.029898,-66.684793,0,0,0,0,0,"HB",0.024
"16273",562,"201001.235.1160.10","NMFS",2010,4,4,94,20.02,41.01138,-66.915743,0,0,0,0,0,"HB",0.024
"16274",562,"201001.236.1160.7","NMFS",2010,4,4,94,20.05,41.309727,-66.705632,1,1,0,1,0,"HB",0.024
"16275",562,"201001.237.1160.3","NMFS",2010,4,4,94,20.15,41.340907,-66.577865,0,0,0,0,0,"HB",0.024
"16276",562,"201001.238.1160.12","NMFS",2010,4,4,94,20.03,41.2483,-66.555907,0,0,0,0,0,"HB",0.024
"16277",562,"201001.239.1180.1","NMFS",2010,4,4,94,20.02,41.106193,-66.37969,0,0,0,0,0,"HB",0.024
"16278",552,"201001.240.1180.3","NMFS",2010,4,4,94,20.07,41.315962,-66.181033,3,3,0,3,0,"HB",0.024
"16279",552,"201001.241.1160.11","NMFS",2010,4,5,95,20.03,41.543508,-66.593668,0,0,0,0,0,"HB",0.024
"16280",552,"201001.242.1160.5","NMFS",2010,4,5,95,20.02,41.594693,-66.63834,0,0,0,0,0,"HB",0.024
"16281",551,"201001.243.1160.2","NMFS",2010,4,5,95,20.03,41.89414,-66.84838,0,0,0,0,0,"HB",0.024
"16282",551,"201001.244.1210.2","NMFS",2010,4,5,95,20.02,42.105098,-66.867732,1,0,1,1,0,"HB",0.024
"16283",551,"201001.245.1210.4","NMFS",2010,4,5,95,20.02,42.133718,-66.712933,11,7,4,11,0,"HB",0.024
"16284",551,"201001.246.1220.4","NMFS",2010,4,5,95,20.03,42.189613,-66.610837,17,15,2,17,0,"HB",0.024
"16285",551,"201001.247.1160.14","NMFS",2010,4,5,95,20.05,41.937595,-66.546242,3,2,1,3,0,"HB",0.024
"16286",551,"201001.248.1160.8","NMFS",2010,4,5,95,20.05,41.93415,-66.263485,0,0,0,0,0,"HB",0.024
"16287",552,"201001.249.1160.1","NMFS",2010,4,5,95,20.03,41.779075,-66.132303,0,0,0,0,0,"HB",0.024
"16288",552,"201001.250.1160.9","NMFS",2010,4,5,95,20.07,41.734673,-65.982908,2,2,0,2,0,"HB",0.024
"16289",552,"201001.251.1170.1","NMFS",2010,4,5,95,20.02,41.732065,-65.843855,4,4,0,4,0,"HB",0.024
"16290",552,"201001.252.1170.2","NMFS",2010,4,6,96,20.05,41.728515,-65.785138,0,0,0,0,0,"HB",0.024
"16291",551,"201001.254.1180.4","NMFS",2010,4,6,96,20.03,41.974587,-65.818372,1,1,0,1,0,"HB",0.024
"16292",464,"201001.255.1290.1","NMFS",2010,4,6,96,20.03,42.19045,-65.853393,0,0,0,0,0,"HB",0.024
"16293",464,"201001.256.1290.3","NMFS",2010,4,6,96,20.05,42.299697,-65.975467,6,6,0,6,0,"HB",0.024
"16294",464,"201001.257.1290.4","NMFS",2010,4,6,96,20.07,42.437687,-66.155765,2,2,0,2,0,"HB",0.024
"16295",464,"201001.258.1290.9","NMFS",2010,4,6,96,20.03,42.397355,-66.427907,9,9,0,9,0,"HB",0.024
"16296",464,"201001.259.1290.5","NMFS",2010,4,6,96,20.03,42.602438,-66.59181,0,0,0,0,0,"HB",0.024
"16297",464,"201001.260.1290.2","NMFS",2010,4,6,96,20.03,42.603322,-67.279495,6,4,2,6,0,"HB",0.024
"16298",464,"201001.261.1300.1","NMFS",2010,4,7,97,20.03,42.524112,-67.175655,4,2,2,4,0,"HB",0.024
"16299",464,"201001.262.1300.2","NMFS",2010,4,7,97,20.02,42.399025,-67.099492,17,15,2,17,0,"HB",0.024
"16300",464,"201001.263.1300.3","NMFS",2010,4,7,97,20.02,42.408275,-67.335355,11,10,1,11,0,"HB",0.024
"16301",551,"201001.264.1290.10","NMFS",2010,4,7,97,20.02,42.240815,-67.14612,7,7,0,7,0,"HB",0.024
"16302",561,"201001.265.1220.2","NMFS",2010,4,7,97,20.15,42.19153,-67.402108,9,8,1,9,0,"HB",0.024
"16303",561,"201001.266.1210.3","NMFS",2010,4,7,97,20.05,42.059533,-67.645485,2,1,1,2,0,"HB",0.024
"16304",526,"201001.268.1130.2","NMFS",2010,4,14,104,20.03,40.834655,-68.880443,1,0,1,1,0,"HB",0.024
"16305",526,"201001.269.1100.5","NMFS",2010,4,14,104,20.2,40.904058,-68.95807,0,0,0,0,0,"HB",0.024
"16306",521,"201001.270.1230.1","NMFS",2010,4,14,104,20.02,41.068533,-69.021647,0,0,0,0,0,"HB",0.024
"16307",521,"201001.271.1240.6","NMFS",2010,4,14,104,20.05,41.399503,-69.134383,1,0,1,1,0,"HB",0.024
"16308",521,"201001.272.1240.7","NMFS",2010,4,14,104,20.07,41.649163,-69.136292,8,8,0,8,0,"HB",0.024
"16309",522,"201001.273.1240.3","NMFS",2010,4,14,104,20.08,41.687038,-68.772783,6,6,0,6,0,"HB",0.024
"16310",522,"201001.274.1240.4","NMFS",2010,4,14,104,20.05,41.642695,-68.576043,15,12,3,15,0,"HB",0.024
"16311",522,"201001.275.1240.1","NMFS",2010,4,15,105,20.02,41.587543,-68.62267,0,0,0,0,0,"HB",0.024
"16312",522,"201001.276.1230.2","NMFS",2010,4,15,105,20.07,41.485147,-68.511203,0,0,0,0,0,"HB",0.024
"16313",522,"201001.277.1230.3","NMFS",2010,4,15,105,20.02,41.347322,-68.529803,1,0,1,1,0,"HB",0.024
"16314",522,"201001.278.1230.5","NMFS",2010,4,15,105,20.03,41.350475,-68.738132,0,0,0,0,0,"HB",0.024
"16315",522,"201001.279.1240.5","NMFS",2010,4,15,105,20.03,41.346047,-68.789725,8,4,4,8,0,"HB",0.024
"16316",522,"201001.280.1230.6","NMFS",2010,4,15,105,20.03,41.22456,-68.795722,0,0,0,0,0,"HB",0.024
"16317",522,"201001.281.1200.5","NMFS",2010,4,15,105,20.03,41.282848,-68.479168,0,0,0,0,0,"HB",0.024
"16318",522,"201001.282.1190.5","NMFS",2010,4,15,105,20.02,41.290917,-68.172185,1,1,0,1,0,"HB",0.024
"16319",525,"201001.283.1190.4","NMFS",2010,4,15,105,20.05,41.144605,-67.999957,0,0,0,0,0,"HB",0.024
"16320",525,"201001.284.1190.1","NMFS",2010,4,15,105,20.02,41.325187,-67.68018,0,0,0,0,0,"HB",0.024
"16321",525,"201001.285.1190.6","NMFS",2010,4,15,105,20.03,41.186875,-67.679997,0,0,0,0,0,"HB",0.024
"16322",562,"201001.286.1160.13","NMFS",2010,4,16,106,20.02,41.236258,-67.0536,0,0,0,0,0,"HB",0.024
"16323",562,"201001.287.1160.6","NMFS",2010,4,16,106,20.03,41.272695,-67.043935,0,0,0,0,0,"HB",0.024
"16324",562,"201001.288.1190.9","NMFS",2010,4,16,106,20.02,41.302947,-67.147432,0,0,0,0,0,"HB",0.024
"16325",562,"201001.289.1190.3","NMFS",2010,4,16,106,20.02,41.673912,-67.245212,5,2,3,4,1,"HB",0.024
"16326",562,"201001.290.1190.7","NMFS",2010,4,16,106,20.05,41.729208,-67.192352,2,2,0,2,0,"HB",0.024
"16327",561,"201001.293.1190.11","NMFS",2010,4,16,106,20.07,41.908623,-67.262877,1,1,0,1,0,"HB",0.024
"16328",561,"201001.294.1200.2","NMFS",2010,4,16,106,20.03,41.955938,-67.284218,1,1,0,1,0,"HB",0.024
"16329",561,"201001.295.1200.3","NMFS",2010,4,16,106,20.05,41.898938,-67.483702,1,0,1,1,0,"HB",0.024
"16330",522,"201001.296.1200.6","NMFS",2010,4,16,106,20.02,41.713838,-67.899612,0,0,0,0,0,"HB",0.024
"16331",522,"201001.298.1200.4","NMFS",2010,4,17,107,20.03,41.894472,-67.828192,0,0,0,0,0,"HB",0.024
"16332",522,"201001.299.1210.1","NMFS",2010,4,17,107,20.12,41.992473,-67.850163,0,0,0,0,0,"HB",0.024
"16333",522,"201001.300.1220.3","NMFS",2010,4,17,107,20.03,42.065647,-67.968603,4,4,0,4,0,"HB",0.024
"16334",522,"201001.301.1290.6","NMFS",2010,4,17,107,20.02,42.192382,-68.18382,1,1,0,1,0,"HB",0.024
"16335",522,"201001.302.1290.7","NMFS",2010,4,17,107,20,42.192722,-67.786957,13,13,0,13,0,"HB",0.024
"16336",515,"201001.303.1290.8","NMFS",2010,4,17,107,20.03,42.348472,-67.929532,3,2,1,3,0,"HB",0.024
"16337",515,"201001.304.1360.2","NMFS",2010,4,17,107,20.02,42.809767,-67.982773,2,1,1,2,0,"HB",0.024
"16338",515,"201001.305.1360.1","NMFS",2010,4,17,107,20.02,43.179227,-68.401577,6,5,1,6,0,"HB",0.024
"16339",515,"201001.306.1360.3","NMFS",2010,4,18,108,20,43.090472,-68.06783,8,8,0,8,0,"HB",0.024
"16340",515,"201001.307.1360.5","NMFS",2010,4,18,108,20.03,43.013945,-67.818665,2,2,0,2,0,"HB",0.024
"16341",465,"201001.308.1360.6","NMFS",2010,4,18,108,20.02,43.013582,-67.55792,0,0,0,0,0,"HB",0.024
"16342",464,"201001.309.1360.9","NMFS",2010,4,18,108,20.05,42.837328,-67.118838,2,1,1,2,0,"HB",0.024
"16343",465,"201001.310.1340.5","NMFS",2010,4,18,108,20.03,43.313385,-66.662657,39,15,24,37,2,"HB",0.024
"16344",465,"201001.311.1340.7","NMFS",2010,4,18,108,20.05,43.449405,-66.732245,4,3,1,4,0,"HB",0.024
"16345",465,"201001.312.1340.2","NMFS",2010,4,18,108,20.05,43.546917,-66.829885,2,0,2,2,0,"HB",0.024
"16346",465,"201001.313.1340.3","NMFS",2010,4,18,108,20.05,43.624095,-66.963067,11,7,4,11,0,"HB",0.024
"16347",465,"201001.314.1340.1","NMFS",2010,4,19,109,20.03,43.65719,-67.194455,1,1,0,1,0,"HB",0.024
"16348",465,"201001.315.1340.4","NMFS",2010,4,19,109,20.02,43.841237,-66.729165,13,7,6,13,0,"HB",0.024
"16349",466,"201001.316.1351.2","NMFS",2010,4,19,109,20.03,44.154477,-66.729423,8,4,4,8,0,"HB",0.024
"16350",466,"201001.317.1351.1","NMFS",2010,4,19,109,20.03,44.269908,-66.739757,9,4,5,9,0,"HB",0.024
"16351",511,"201001.318.1351.3","NMFS",2010,4,19,109,20.03,44.258082,-67.165272,9,6,3,9,0,"HB",0.024
"16352",511,"201001.319.1351.4","NMFS",2010,4,19,109,20.03,44.337065,-67.259865,10,8,2,10,0,"HB",0.024
"16353",511,"201001.320.1390.3","NMFS",2010,4,19,109,20.02,44.314708,-67.53978,20,9,11,19,1,"HB",0.024
"16354",511,"201001.321.1380.4","NMFS",2010,4,19,109,20.03,44.293547,-67.496972,2,2,0,2,0,"HB",0.024
"16355",511,"201001.322.1360.10","NMFS",2010,4,19,109,20.12,44.174992,-67.302005,7,5,2,7,0,"HB",0.024
"16356",511,"201001.323.1340.6","NMFS",2010,4,20,110,20.03,43.98839,-67.317925,9,8,1,9,0,"HB",0.024
"16357",511,"201001.325.1360.11","NMFS",2010,4,20,110,20.03,44.013012,-67.489432,4,2,2,4,0,"HB",0.024
"16358",512,"201001.326.1390.4","NMFS",2010,4,20,110,20.03,44.148582,-67.897607,16,10,6,16,0,"HB",0.024
"16359",512,"201001.327.1380.3","NMFS",2010,4,20,110,16.55,43.995915,-67.901595,2,1,1,2,0,"HB",0.024
"16360",512,"201001.328.1360.8","NMFS",2010,4,20,110,20.02,43.560127,-67.960978,0,0,0,0,0,"HB",0.024
"16361",512,"201001.329.1360.7","NMFS",2010,4,20,110,20.02,43.55245,-68.066555,17,13,4,17,0,"HB",0.024
"16362",512,"201001.330.1380.1","NMFS",2010,4,20,110,20.03,43.539418,-68.31101,1,1,0,1,0,"HB",0.024
"16363",512,"201001.331.1380.7","NMFS",2010,4,21,111,20.03,43.862812,-68.179088,1,0,1,1,0,"HB",0.024
"16364",512,"201001.332.1390.1","NMFS",2010,4,21,111,18.55,43.97122,-68.330432,9,5,4,8,1,"HB",0.024
"16365",512,"201001.333.1390.5","NMFS",2010,4,21,111,20.02,43.907022,-68.522985,34,23,11,34,0,"HB",0.024
"16366",512,"201001.334.1390.2","NMFS",2010,4,21,111,20.03,43.938772,-68.613095,137,65,72,106,31,"HB",0.024
"16367",513,"201001.335.1380.2","NMFS",2010,4,21,111,20.03,43.564803,-69.007008,6,4,2,6,0,"HB",0.024
"16368",513,"201001.336.1380.5","NMFS",2010,4,21,111,20.02,43.445935,-69.381608,0,0,0,0,0,"HB",0.024
"16369",513,"201001.338.1380.9","NMFS",2010,4,21,111,20.02,43.466745,-69.665972,11,8,3,11,0,"HB",0.024
"16370",513,"201001.339.1400.3","NMFS",2010,4,22,112,20.02,43.576052,-69.757893,9,6,3,9,0,"HB",0.024
"16371",513,"201001.340.1400.1","NMFS",2010,4,22,112,20.03,43.597493,-69.765042,8,2,6,7,1,"HB",0.024
"16372",513,"201001.341.1400.2","NMFS",2010,4,22,112,20.02,43.496845,-70.107078,112,52,60,55,57,"HB",0.024
"16373",513,"201001.342.1380.8","NMFS",2010,4,22,112,20.03,43.28449,-69.714585,11,10,1,11,0,"HB",0.024
"16374",513,"201001.343.1370.6","NMFS",2010,4,22,112,20.03,43.23634,-69.206173,0,0,0,0,0,"HB",0.024
"16375",515,"201001.344.1370.2","NMFS",2010,4,22,112,20.02,43.148478,-68.913218,2,1,1,2,0,"HB",0.024
"16376",515,"201001.345.1370.3","NMFS",2010,4,22,112,20.05,42.930702,-68.740965,1,1,0,1,0,"HB",0.024
"16377",515,"201001.346.1370.4","NMFS",2010,4,22,112,20.03,42.842518,-68.713273,0,0,0,0,0,"HB",0.024
"16378",515,"201001.347.1370.1","NMFS",2010,4,23,113,20.02,42.668625,-68.810177,1,1,0,1,0,"HB",0.024
"16379",515,"201001.348.1370.5","NMFS",2010,4,23,113,20.03,42.860025,-69.031892,1,1,0,1,0,"HB",0.024
"16380",514,"201001.349.3640.3","NMFS",2010,4,26,116,20.03,42.342263,-70.776905,102,73,29,96,6,"HB",0.024
"16381",514,"201001.350.3650.2","NMFS",2010,4,26,116,20.02,42.33871,-70.688335,114,73,41,107,7,"HB",0.024
"16382",514,"201001.351.3660.1","NMFS",2010,4,26,116,20.02,42.347638,-70.63269,23,11,12,18,5,"HB",0.024
"16383",514,"201001.352.1260.4","NMFS",2010,4,27,117,20.03,42.442558,-70.255095,0,0,0,0,0,"HB",0.024
"16384",514,"201001.354.1260.7","NMFS",2010,4,27,117,20.03,42.427838,-70.163847,3,3,0,3,0,"HB",0.024
"16385",514,"201001.355.1270.1","NMFS",2010,4,27,117,20.03,42.377523,-70.002413,4,4,0,4,0,"HB",0.024
"16386",515,"201001.356.1280.5","NMFS",2010,4,27,117,20.03,42.424535,-69.601507,0,0,0,0,0,"HB",0.024
"16387",521,"201001.357.1280.2","NMFS",2010,4,27,117,20.05,42.326317,-69.336832,1,1,0,1,0,"HB",0.024
"16388",521,"201001.358.1240.2","NMFS",2010,4,27,117,20.03,42.169908,-69.221927,3,3,0,3,0,"HB",0.024
"16389",521,"201001.359.1240.8","NMFS",2010,4,27,117,20.02,42.225012,-68.880102,0,0,0,0,0,"HB",0.024
"16390",515,"201001.360.1280.3","NMFS",2010,4,28,118,20.02,42.572733,-69.460565,0,0,0,0,0,"HB",0.024
"16391",515,"201001.361.1280.7","NMFS",2010,4,28,118,20.03,42.658822,-69.330042,0,0,0,0,0,"HB",0.024
"16392",513,"201001.362.1370.7","NMFS",2010,4,28,118,20.02,42.969263,-69.520183,0,0,0,0,0,"HB",0.024
"16393",514,"201001.363.1280.1","NMFS",2010,4,28,118,20.03,42.560937,-69.803397,1,1,0,1,0,"HB",0.024
"16394",514,"201001.364.1260.3","NMFS",2010,4,28,118,20.01,42.570782,-70.08665,1,1,0,1,0,"HB",0.024
"16395",514,"201001.365.1270.4","NMFS",2010,4,28,118,20.02,42.745223,-70.114217,9,9,0,9,0,"HB",0.024
"16396",513,"201001.366.1270.2","NMFS",2010,4,28,118,20.02,42.858273,-70.095458,1,1,0,1,0,"HB",0.024
"16397",514,"201001.367.1270.5","NMFS",2010,4,28,118,20.03,42.826755,-70.384283,6,5,1,6,0,"HB",0.024
"16398",514,"201001.368.3650.1","NMFS",2010,4,29,119,20.03,42.798495,-70.68849,26,7,19,25,1,"HB",0.024
"16399",514,"201001.369.3640.1","NMFS",2010,4,29,119,20.02,42.820988,-70.743678,10,6,4,10,0,"HB",0.024
"16400",514,"201001.370.1260.1","NMFS",2010,4,29,119,20.02,42.536043,-70.535783,11,3,8,11,0,"HB",0.024
"16401",514,"201001.373.3640.2","NMFS",2010,4,29,119,20.03,42.223745,-70.597618,2,0,2,2,0,"HB",0.024
"16402",514,"201001.375.3660.3","NMFS",2010,4,29,119,20.02,42.236438,-70.503518,9,4,5,8,1,"HB",0.024
"16403",514,"201001.376.1260.5","NMFS",2010,4,29,119,20.03,42.22983,-70.425548,22,3,19,22,0,"HB",0.024
"16404",514,"201001.377.3610.1","NMFS",2010,4,29,119,20,42.10166,-70.432228,79,19,60,67,12,"HB",0.024
"16405",514,"201001.378.3590.1","NMFS",2010,4,29,119,20.03,42.018847,-70.560248,47,26,21,39,8,"HB",0.024
"16406",514,"201001.379.3600.3","NMFS",2010,4,30,120,20.03,42.019488,-70.47362,44,23,21,39,5,"HB",0.024
"16407",514,"201001.380.3610.2","NMFS",2010,4,30,120,20.03,41.982,-70.31045,35,7,28,28,7,"HB",0.024
"16408",514,"201001.381.3600.1","NMFS",2010,4,30,120,20.02,41.947365,-70.337907,168,52,116,123,45,"HB",0.024
"16409",514,"201001.382.3590.3","NMFS",2010,4,30,120,20.03,41.850367,-70.33907,7,4,3,3,4,"HB",0.024
"16410",514,"201001.383.3590.2","NMFS",2010,4,30,120,20.05,41.951965,-70.150492,12,4,8,9,3,"HB",0.024
"16411",514,"201001.384.3600.2","NMFS",2010,4,30,120,20.05,41.976853,-70.241197,21,4,17,18,3,"HB",0.024
"16412",514,"201001.386.1260.8","NMFS",2010,4,30,120,20.05,42.222082,-70.147325,0,0,0,0,0,"HB",0.024
"16413",514,"201001.387.3610.3","NMFS",2010,4,30,120,20.05,42.116387,-70.148295,7,2,5,7,0,"HB",0.024
"16414",521,"201001.388.1270.3","NMFS",2010,4,30,120,20.05,42.225192,-69.89132,7,6,1,7,0,"HB",0.024
"16415",521,"201001.389.1280.4","NMFS",2010,5,1,121,20.03,42.208,-69.758955,1,1,0,1,0,"HB",0.024
"16416",521,"201001.390.1280.6","NMFS",2010,5,1,121,20,41.970392,-69.603578,1,1,0,1,0,"HB",0.024
"16417",521,"201001.391.3560.1","NMFS",2010,5,1,121,20.03,41.74875,-69.879883,6,3,3,6,0,"HB",0.024
"16418",521,"201001.392.3560.2","NMFS",2010,5,1,121,20.03,41.780145,-69.887508,0,0,0,0,0,"HB",0.024
"16419",521,"201001.393.3560.3","NMFS",2010,5,1,121,20.12,41.793608,-69.891918,4,2,2,4,0,"HB",0.024
"16420",521,"201001.394.1230.4","NMFS",2010,5,1,121,20.03,41.697182,-69.662198,6,6,0,6,0,"HB",0.024
"16421",521,"201001.396.1250.5","NMFS",2010,5,1,121,20.02,41.540265,-69.594417,9,5,4,9,0,"HB",0.024
"16422",521,"201001.402.1250.2","NMFS",2010,5,2,122,20.05,41.065157,-69.24115,0,0,0,0,0,"HB",0.024
"16423",526,"201004.201.1100.1","NMFS",2010,10,18,291,20.02,40.604365,-69.961295,0,0,0,0,0,"HB",0.024
"16424",526,"201004.202.1100.3","NMFS",2010,10,18,291,20.02,40.391738,-69.985965,2,0,2,2,0,"HB",0.024
"16425",526,"201004.206.1100.5","NMFS",2010,10,18,291,20.02,40.119643,-69.86886,2,2,0,2,0,"HB",0.024
"16426",526,"201004.207.1110.3","NMFS",2010,10,18,291,20.03,40.015587,-69.82145,0,0,0,0,0,"HB",0.024
"16427",526,"201004.208.1110.4","NMFS",2010,10,18,291,20.02,40.015712,-69.554473,2,0,2,2,0,"HB",0.024
"16428",526,"201004.209.1120.3","NMFS",2010,10,18,291,20.02,40.021852,-69.140252,11,1,10,10,1,"HB",0.024
"16429",526,"201004.210.1100.9","NMFS",2010,10,19,292,20.02,40.234235,-69.12807,1,0,1,1,0,"HB",0.024
"16430",526,"201004.211.1120.2","NMFS",2010,10,19,292,20.02,40.063938,-68.949202,0,0,0,0,0,"HB",0.024
"16431",526,"201004.212.1110.1","NMFS",2010,10,19,292,20.02,40.138462,-68.884787,0,0,0,0,0,"HB",0.024
"16432",525,"201004.213.1140.1","NMFS",2010,10,19,292,20.02,40.152535,-68.653052,0,0,0,0,0,"HB",0.024
"16433",525,"201004.214.1150.2","NMFS",2010,10,19,292,20.03,40.260743,-68.306442,1,1,0,1,0,"HB",0.024
"16434",525,"201004.215.1140.4","NMFS",2010,10,19,292,20.07,40.359053,-68.276728,0,0,0,0,0,"HB",0.024
"16435",525,"201004.216.1130.9","NMFS",2010,10,19,292,20.02,40.427067,-68.37934,0,0,0,0,0,"HB",0.024
"16436",525,"201004.217.1130.8","NMFS",2010,10,19,292,20.03,40.593345,-68.495867,0,0,0,0,0,"HB",0.024
"16437",525,"201004.218.1130.1","NMFS",2010,10,19,292,20.03,40.633202,-68.090665,0,0,0,0,0,"HB",0.024
"16438",525,"201004.219.1140.3","NMFS",2010,10,19,292,20.02,40.488005,-67.902253,2,2,0,2,0,"HB",0.024
"16439",525,"201004.220.1130.7","NMFS",2010,10,19,292,20.02,40.586533,-67.737903,2,2,0,2,0,"HB",0.024
"16440",525,"201004.221.1140.2","NMFS",2010,10,20,293,20.03,40.528593,-67.478722,1,1,0,1,0,"HB",0.024
"16441",525,"201004.222.1130.5","NMFS",2010,10,20,293,20.02,40.843915,-67.290233,0,0,0,0,0,"HB",0.024
"16442",525,"201004.223.1130.10","NMFS",2010,10,20,293,20.02,40.86203,-67.185732,0,0,0,0,0,"HB",0.024
"16443",562,"201004.224.1130.4","NMFS",2010,10,20,293,20.02,40.842142,-66.925247,1,1,0,1,0,"HB",0.024
"16444",562,"201004.225.1160.2","NMFS",2010,10,20,293,20.03,40.84983,-66.790422,1,1,0,1,0,"HB",0.024
"16445",562,"201004.227.1150.4","NMFS",2010,10,20,293,20.02,40.721913,-66.771518,5,5,0,5,0,"HB",0.024
"16446",562,"201004.228.1170.4","NMFS",2010,10,20,293,20.02,40.891715,-66.616845,3,3,0,3,0,"HB",0.024
"16447",562,"201004.229.1160.6","NMFS",2010,10,20,293,20.07,41.009377,-66.593577,1,1,0,1,0,"HB",0.024
"16448",562,"201004.230.1180.3","NMFS",2010,10,20,293,20.02,41.009112,-66.423412,4,4,0,4,0,"HB",0.024
"16449",562,"201004.231.1180.1","NMFS",2010,10,21,294,20,41.143273,-66.339128,19,18,1,19,0,"HB",0.024
"16450",562,"201004.232.1170.3","NMFS",2010,10,21,294,20.02,41.134395,-66.417092,4,4,0,4,0,"HB",0.024
"16451",562,"201004.233.1160.14","NMFS",2010,10,21,294,20.03,41.310912,-66.723773,2,2,0,2,0,"HB",0.024
"16452",562,"201004.234.1160.9","NMFS",2010,10,21,294,20.03,41.105288,-66.806495,1,1,0,1,0,"HB",0.024
"16453",525,"201004.235.1130.3","NMFS",2010,10,21,294,20.03,41.111377,-67.410722,3,3,0,3,0,"HB",0.024
"16454",525,"201004.236.1190.2","NMFS",2010,10,21,294,20,41.098248,-67.806322,1,0,1,1,0,"HB",0.024
"16455",525,"201004.237.1130.6","NMFS",2010,10,21,294,20.02,40.534972,-68.827007,0,0,0,0,0,"HB",0.024
"16456",526,"201004.238.1100.2","NMFS",2010,10,21,294,20.02,40.47126,-69.02497,0,0,0,0,0,"HB",0.024
"16457",526,"201004.242.1090.1","NMFS",2010,10,27,300,20.13,40.724947,-69.712542,1,1,0,1,0,"HB",0.024
"16458",526,"201004.243.1090.3","NMFS",2010,10,27,300,20.02,40.764488,-69.607953,0,0,0,0,0,"HB",0.024
"16459",526,"201004.244.1090.4","NMFS",2010,10,27,300,20.03,40.780855,-69.379293,0,0,0,0,0,"HB",0.024
"16460",526,"201004.245.1100.10","NMFS",2010,10,27,300,20.02,40.772398,-68.973097,2,2,0,2,0,"HB",0.024
"16461",525,"201004.246.1130.2","NMFS",2010,10,27,300,20.07,40.727332,-68.762878,1,1,0,1,0,"HB",0.024
"16462",525,"201004.247.1190.6","NMFS",2010,10,27,300,20.07,40.843308,-68.607893,0,0,0,0,0,"HB",0.024
"16463",525,"201004.248.1190.3","NMFS",2010,10,27,300,20.23,40.893805,-68.621045,0,0,0,0,0,"HB",0.024
"16464",522,"201004.249.1230.2","NMFS",2010,10,27,300,20.02,41.063262,-68.770798,2,2,0,1,1,"HB",0.024
"16465",525,"201004.250.1190.8","NMFS",2010,10,27,300,20.03,41.105577,-68.331918,1,1,0,1,0,"HB",0.024
"16466",522,"201004.251.1230.5","NMFS",2010,10,28,301,20.05,41.44514,-68.345573,0,0,0,0,0,"HB",0.024
"16467",522,"201004.252.1200.4","NMFS",2010,10,28,301,20.02,41.458013,-68.12078,1,0,1,0,1,"HB",0.024
"16468",522,"201004.253.1240.3","NMFS",2010,10,28,301,20.03,41.68609,-68.543137,2,1,1,2,0,"HB",0.024
"16469",522,"201004.254.1200.3","NMFS",2010,10,28,301,20.02,41.680683,-68.286577,2,2,0,2,0,"HB",0.024
"16470",522,"201004.255.1210.1","NMFS",2010,10,28,301,20.03,41.890718,-68.051243,0,0,0,0,0,"HB",0.024
"16471",522,"201004.256.1200.5","NMFS",2010,10,28,301,20.02,41.859542,-67.855193,11,8,3,11,0,"HB",0.024
"16472",562,"201004.257.1200.1","NMFS",2010,10,28,301,20.02,41.798015,-67.659507,0,0,0,0,0,"HB",0.024
"16473",562,"201004.258.1200.2","NMFS",2010,10,28,301,20.02,41.74006,-67.620863,0,0,0,0,0,"HB",0.024
"16474",562,"201004.259.1190.1","NMFS",2010,10,29,302,20.05,41.644858,-67.394183,0,0,0,0,0,"HB",0.024
"16475",562,"201004.260.1190.4","NMFS",2010,10,29,302,20.03,41.488467,-67.28163,1,1,0,1,0,"HB",0.024
"16476",522,"201004.261.1190.7","NMFS",2010,10,29,302,20.02,41.402532,-67.74471,0,0,0,0,0,"HB",0.024
"16477",562,"201004.262.1190.5","NMFS",2010,10,29,302,20.02,41.318355,-67.20701,1,1,0,1,0,"HB",0.024
"16478",562,"201004.263.1160.4","NMFS",2010,10,29,302,20.02,41.429362,-67.099883,1,1,0,1,0,"HB",0.024
"16479",562,"201004.264.1160.7","NMFS",2010,10,29,302,20.03,41.644557,-66.927628,1,1,0,1,0,"HB",0.024
"16480",562,"201004.265.1160.3","NMFS",2010,10,29,302,20.03,41.582443,-66.750497,10,10,0,10,0,"HB",0.024
"16481",552,"201004.266.1170.1","NMFS",2010,10,29,302,20.02,41.297268,-66.257838,1,1,0,1,0,"HB",0.024
"16482",552,"201004.267.1160.12","NMFS",2010,10,29,302,20.03,41.4286,-66.281597,13,13,0,13,0,"HB",0.024
"16483",552,"201004.268.1170.2","NMFS",2010,10,30,303,20.07,41.432918,-66.144613,0,0,0,0,0,"HB",0.024
"16484",552,"201004.269.1160.1","NMFS",2010,10,30,303,20.03,41.546378,-66.160412,3,3,0,3,0,"HB",0.024
"16485",552,"201004.270.1160.5","NMFS",2010,10,30,303,20.02,41.59133,-66.138743,1,1,0,1,0,"HB",0.024
"16486",552,"201004.272.1180.5","NMFS",2010,10,30,303,20.02,41.633937,-65.861557,16,16,0,16,0,"HB",0.024
"16487",552,"201004.273.1160.10","NMFS",2010,10,30,303,20.07,41.734975,-65.952625,4,4,0,4,0,"HB",0.024
"16488",551,"201004.274.1160.8","NMFS",2010,10,30,303,20.03,41.903717,-65.976263,4,4,0,4,0,"HB",0.024
"16489",551,"201004.276.1180.2","NMFS",2010,10,30,303,20.05,42.01584,-65.872957,2,2,0,2,0,"HB",0.024
"16490",551,"201004.277.1220.1","NMFS",2010,10,31,304,20.05,42.100272,-66.015602,0,0,0,0,0,"HB",0.024
"16491",464,"201004.280.1290.6","NMFS",2010,10,31,304,20.03,42.402982,-66.055137,0,0,0,0,0,"HB",0.024
"16492",464,"201004.281.1290.1","NMFS",2010,10,31,304,20.07,42.568847,-66.680095,3,3,0,3,0,"HB",0.024
"16493",464,"201004.283.1300.4","NMFS",2010,10,31,304,20.03,42.444197,-66.779238,1,1,0,1,0,"HB",0.024
"16494",551,"201004.284.1220.3","NMFS",2010,10,31,304,20.02,42.180517,-66.63952,7,7,0,7,0,"HB",0.024
"16495",551,"201004.285.1210.3","NMFS",2010,11,1,305,20.03,42.100978,-66.832375,3,3,0,3,0,"HB",0.024
"16496",551,"201004.286.1210.4","NMFS",2010,11,1,305,20.05,42.109135,-67.017657,8,7,1,8,0,"HB",0.024
"16497",561,"201004.287.1210.2","NMFS",2010,11,1,305,20.02,42.144072,-67.319352,1,0,1,1,0,"HB",0.024
"16498",561,"201004.288.1290.4","NMFS",2010,11,1,305,20.02,42.233175,-67.229232,2,2,0,2,0,"HB",0.024
"16499",464,"201004.290.1300.1","NMFS",2010,11,1,305,20.08,42.438048,-67.51355,1,1,0,1,0,"HB",0.024
"16500",522,"201004.292.1290.11","NMFS",2010,11,1,305,20.02,42.264728,-67.682253,0,0,0,0,0,"HB",0.024
"16501",561,"201004.293.1220.2","NMFS",2010,11,1,305,20.02,42.186255,-67.642918,2,2,0,2,0,"HB",0.024
"16502",522,"201004.294.1220.4","NMFS",2010,11,2,306,20.03,42.10103,-67.745725,0,0,0,0,0,"HB",0.024
"16503",515,"201004.295.1290.3","NMFS",2010,11,2,306,20.03,42.390325,-68.365155,1,1,0,1,0,"HB",0.024
"16504",515,"201004.296.1280.3","NMFS",2010,11,2,306,20.03,42.487815,-68.610727,0,0,0,0,0,"HB",0.024
"16505",522,"201004.297.1240.2","NMFS",2010,11,2,306,20.03,42.251343,-68.649237,0,0,0,0,0,"HB",0.024
"16506",522,"201004.298.1240.1","NMFS",2010,11,2,306,20.03,42.152198,-68.786998,0,0,0,0,0,"HB",0.024
"16507",521,"201004.299.1240.4","NMFS",2010,11,2,306,20.02,42.188483,-69.072432,1,1,0,1,0,"HB",0.024
"16508",521,"201004.300.1280.4","NMFS",2010,11,2,306,20.03,42.245613,-69.224043,0,0,0,0,0,"HB",0.024
"16509",521,"201004.301.1240.6","NMFS",2010,11,3,307,20.03,41.93803,-68.846698,1,1,0,1,0,"HB",0.024
"16510",521,"201004.302.1240.7","NMFS",2010,11,3,307,20.03,41.636955,-69.12151,0,0,0,0,0,"HB",0.024
"16511",521,"201004.303.1240.5","NMFS",2010,11,3,307,20.02,41.432162,-69.076623,0,0,0,0,0,"HB",0.024
"16512",521,"201004.304.1230.4","NMFS",2010,11,3,307,20.02,41.23314,-68.950708,0,0,0,0,0,"HB",0.024
"16513",521,"201004.305.1250.1","NMFS",2010,11,3,307,20.03,41.107973,-69.294017,10,6,4,10,0,"HB",0.024
"16514",521,"201004.306.1250.3","NMFS",2010,11,3,307,20.03,41.176902,-69.375628,5,4,1,5,0,"HB",0.024
"16515",521,"201004.308.1230.7","NMFS",2010,11,3,307,20,41.395473,-69.285938,0,0,0,0,0,"HB",0.024
"16516",521,"201004.312.3560.1","NMFS",2010,11,4,308,20.02,41.782948,-69.891818,1,1,0,1,0,"HB",0.024
"16517",521,"201004.313.3560.2","NMFS",2010,11,4,308,20.02,41.818883,-69.905857,6,3,3,6,0,"HB",0.024
"16518",521,"201004.314.1230.3","NMFS",2010,11,4,308,20.02,41.913545,-69.792752,1,1,0,1,0,"HB",0.024
"16519",521,"201004.315.1250.4","NMFS",2010,11,4,308,20.03,41.98772,-69.91824,0,0,0,0,0,"HB",0.024
"16520",521,"201004.317.1280.6","NMFS",2010,11,13,317,20.05,42.222457,-69.54022,1,1,0,1,0,"HB",0.024
"16521",464,"201004.319.1290.2","NMFS",2010,11,13,317,20.02,42.780613,-67.337462,10,9,1,10,0,"HB",0.024
"16522",464,"201004.320.1360.3","NMFS",2010,11,13,317,20.02,42.968662,-67.12503,19,15,4,19,0,"HB",0.024
"16523",465,"201004.321.1340.2","NMFS",2010,11,14,318,20.03,43.225278,-66.810697,26,15,11,26,0,"HB",0.024
"16524",465,"201004.322.1340.7","NMFS",2010,11,14,318,20.02,43.658875,-66.554968,49,23,26,48,1,"HB",0.024
"16525",465,"201004.323.1340.4","NMFS",2010,11,14,318,20.02,43.635492,-66.867638,15,9,6,15,0,"HB",0.024
"16526",465,"201004.324.1340.1","NMFS",2010,11,14,318,20.02,43.599985,-67.092487,13,10,3,13,0,"HB",0.024
"16527",465,"201004.325.1360.2","NMFS",2010,11,14,318,20.05,43.632165,-67.363118,8,8,0,8,0,"HB",0.024
"16528",511,"201004.326.1340.3","NMFS",2010,11,14,318,20.03,43.853405,-67.141613,6,6,0,6,0,"HB",0.024
"16529",466,"201004.327.1351.4","NMFS",2010,11,14,318,20.02,44.11152,-66.744585,24,14,10,24,0,"HB",0.024
"16530",466,"201004.328.1351.3","NMFS",2010,11,14,318,20.03,44.272255,-66.637297,2,1,1,2,0,"HB",0.024
"16531",511,"201004.329.1351.2","NMFS",2010,11,15,319,20.03,44.177093,-67.021307,1,1,0,1,0,"HB",0.024
"16532",511,"201004.330.1340.5","NMFS",2010,11,15,319,20.01,44.13879,-67.279188,1,1,0,1,0,"HB",0.024
"16533",511,"201004.331.1390.5","NMFS",2010,11,15,319,20.03,44.256413,-67.66511,95,55,40,95,0,"HB",0.024
"16534",511,"201004.332.1380.2","NMFS",2010,11,15,319,20.02,44.229472,-67.679967,96,62,34,96,0,"HB",0.024
"16535",511,"201004.333.1390.4","NMFS",2010,11,15,319,20.03,44.22922,-67.739123,55,33,22,55,0,"HB",0.024
"16536",511,"201004.334.1360.9","NMFS",2010,11,15,319,20.02,43.861178,-67.663085,5,5,0,5,0,"HB",0.024
"16537",465,"201004.335.1360.4","NMFS",2010,11,15,319,20.02,43.580342,-67.59214,0,0,0,0,0,"HB",0.024
"16538",515,"201004.336.1360.8","NMFS",2010,11,15,319,20.1,43.322785,-68.112963,0,0,0,0,0,"HB",0.024
"16539",515,"201004.337.1360.7","NMFS",2010,11,16,320,20.02,43.244298,-68.144233,0,0,0,0,0,"HB",0.024
"16540",515,"201004.338.1380.4","NMFS",2010,11,16,320,20.02,43.309623,-68.466172,1,1,0,1,0,"HB",0.024
"16541",512,"201004.339.1380.1","NMFS",2010,11,16,320,20.02,43.552973,-68.609528,17,17,0,17,0,"HB",0.024
"16542",512,"201004.340.1360.6","NMFS",2010,11,16,320,20.03,43.51929,-68.113017,0,0,0,0,0,"HB",0.024
"16543",512,"201004.341.1360.5","NMFS",2010,11,16,320,20.02,43.771525,-67.959422,4,4,0,4,0,"HB",0.024
"16544",512,"201004.342.1380.5","NMFS",2010,11,16,320,20.03,43.765235,-68.06214,3,3,0,3,0,"HB",0.024
"16545",512,"201004.343.1380.6","NMFS",2010,11,16,320,20.02,43.87063,-68.19726,16,14,2,16,0,"HB",0.024
"16546",512,"201004.344.1390.6","NMFS",2010,11,17,321,20.02,44.00904,-68.242897,80,38,42,79,1,"HB",0.024
"16547",513,"201004.345.1380.7","NMFS",2010,11,17,321,20.02,43.522538,-69.300322,13,13,0,13,0,"HB",0.024
"16548",513,"201004.347.1370.7","NMFS",2010,11,17,321,20.02,43.087833,-69.171387,0,0,0,0,0,"HB",0.024
"16549",513,"201004.348.1370.5","NMFS",2010,11,17,321,20,43.146725,-69.341425,0,0,0,0,0,"HB",0.024
"16550",513,"201004.349.1400.1","NMFS",2010,11,18,322,20.03,43.325543,-70.171262,28,14,14,28,0,"HB",0.024
"16551",513,"201004.350.1400.3","NMFS",2010,11,18,322,20.02,43.294603,-70.200443,27,15,12,26,1,"HB",0.024
"16552",513,"201004.351.1270.5","NMFS",2010,11,18,322,20.05,43.269653,-70.131497,32,30,2,32,0,"HB",0.024
"16553",513,"201004.353.1280.7","NMFS",2010,11,18,322,20.03,43.070145,-69.917367,0,0,0,0,0,"HB",0.024
"16554",513,"201004.354.1270.4","NMFS",2010,11,18,322,20.05,42.948888,-70.132198,0,0,0,0,0,"HB",0.024
"16555",513,"201004.355.1400.4","NMFS",2010,11,18,322,20.02,42.957397,-70.41763,68,44,24,68,0,"HB",0.024
"16556",514,"201004.356.3660.2","NMFS",2010,11,18,322,20.1,42.820088,-70.660023,41,16,25,31,10,"HB",0.024
"16557",514,"201004.357.3650.2","NMFS",2010,11,19,323,20.03,42.783002,-70.686892,61,32,29,61,0,"HB",0.024
"16558",514,"201004.358.3640.1","NMFS",2010,11,19,323,20,42.792558,-70.740658,7,2,5,6,1,"HB",0.024
"16559",515,"201004.359.1280.2","NMFS",2010,12,1,335,20.03,42.632507,-69.593435,1,1,0,1,0,"HB",0.024
"16560",515,"201004.360.1370.6","NMFS",2010,12,1,335,20.03,42.777772,-69.201467,0,0,0,0,0,"HB",0.024
"16561",515,"201004.361.1370.2","NMFS",2010,12,1,335,20.03,42.845607,-69.163965,0,0,0,0,0,"HB",0.024
"16562",513,"201004.362.1370.4","NMFS",2010,12,1,335,20.05,42.892845,-69.336892,2,2,0,2,0,"HB",0.024
"16563",514,"201004.363.1280.1","NMFS",2010,12,1,335,20.12,42.721153,-69.942663,0,0,0,0,0,"HB",0.024
"16564",514,"201004.364.1270.3","NMFS",2010,12,1,335,20.07,42.686238,-70.030882,1,1,0,1,0,"HB",0.024
"16565",514,"201004.366.3640.2","NMFS",2010,12,2,336,19.05,42.337132,-70.777887,175,103,72,163,12,"HB",0.024
"16566",514,"201004.367.3660.3","NMFS",2010,12,2,336,20.05,42.358375,-70.641752,22,16,6,21,1,"HB",0.024
"16567",514,"201004.368.3650.1","NMFS",2010,12,2,336,18.15,42.345087,-70.70531,118,93,25,114,4,"HB",0.024
"16568",514,"201004.369.1260.1","NMFS",2010,12,2,336,20.02,42.1899,-70.430287,10,2,8,9,1,"HB",0.024
"16569",514,"201004.370.1260.6","NMFS",2010,12,2,336,20.02,42.176718,-70.124502,18,8,10,18,0,"HB",0.024
"16570",521,"201004.371.1270.2","NMFS",2010,12,3,337,20.02,42.322168,-69.974632,1,1,0,1,0,"HB",0.024
"16571",526,"201102.178.1110.4","NMFS",2011,3,27,86,20.02,40.022042,-69.876162,0,0,0,0,0,"HB",0.024
"16572",526,"201102.179.1100.3","NMFS",2011,3,27,86,20.03,40.308058,-69.935993,0,0,0,0,0,"HB",0.024
"16573",526,"201102.180.1100.2","NMFS",2011,3,28,87,20.02,40.303763,-69.60229,0,0,0,0,0,"HB",0.024
"16574",526,"201102.181.1100.8","NMFS",2011,3,28,87,20.03,40.099482,-69.37537,0,0,0,0,0,"HB",0.024
"16575",525,"201102.182.1140.4","NMFS",2011,3,28,87,20.02,40.309237,-68.448323,0,0,0,0,0,"HB",0.024
"16576",525,"201102.183.1130.10","NMFS",2011,3,29,88,20.02,40.598198,-68.47129,0,0,0,0,0,"HB",0.024
"16577",525,"201102.184.1130.2","NMFS",2011,3,29,88,20.02,40.526375,-68.592067,0,0,0,0,0,"HB",0.024
"16578",526,"201102.185.1100.6","NMFS",2011,3,29,88,20.02,40.481868,-68.952955,0,0,0,0,0,"HB",0.024
"16579",525,"201102.186.1130.5","NMFS",2011,3,29,88,20.02,40.27392,-68.760293,0,0,0,0,0,"HB",0.024
"16580",526,"201102.187.1110.2","NMFS",2011,3,29,88,20.02,40.109523,-69.111128,0,0,0,0,0,"HB",0.024
"16581",526,"201102.188.1120.1","NMFS",2011,3,29,88,20.02,40.005218,-69.09702,83,28,55,79,4,"HB",0.024
"16582",526,"201102.189.1110.1","NMFS",2011,3,29,88,20.03,39.97863,-69.554843,0,0,0,0,0,"HB",0.024
"16583",526,"201102.190.1090.2","NMFS",2011,3,29,88,20.03,40.597472,-69.471578,0,0,0,0,0,"HB",0.024
"16584",526,"201102.191.1100.4","NMFS",2011,3,30,89,20.02,40.610875,-69.757835,0,0,0,0,0,"HB",0.024
"16585",526,"201102.192.1090.5","NMFS",2011,3,30,89,20,40.683025,-69.840632,0,0,0,0,0,"HB",0.024
"16586",521,"201102.202.1230.4","NMFS",2011,4,7,97,20.02,41.112808,-69.048642,0,0,0,0,0,"HB",0.024
"16587",522,"201102.203.1230.3","NMFS",2011,4,7,97,20.03,41.139283,-68.771185,1,0,1,0,1,"HB",0.024
"16588",522,"201102.204.1190.6","NMFS",2011,4,7,97,20,41.083493,-68.422365,0,0,0,0,0,"HB",0.024
"16589",525,"201102.206.1190.5","NMFS",2011,4,7,97,20.02,40.982567,-67.927417,0,0,0,0,0,"HB",0.024
"16590",525,"201102.207.1190.8","NMFS",2011,4,7,97,20.03,40.90493,-68.031355,0,0,0,0,0,"HB",0.024
"16591",525,"201102.208.1130.3","NMFS",2011,4,8,98,20,40.718927,-68.254132,0,0,0,0,0,"HB",0.024
"16592",525,"201102.209.1130.1","NMFS",2011,4,8,98,20.02,40.73605,-68.052643,0,0,0,0,0,"HB",0.024
"16593",525,"201102.210.1130.7","NMFS",2011,4,8,98,20.02,40.523418,-68.131607,0,0,0,0,0,"HB",0.024
"16594",525,"201102.211.1140.1","NMFS",2011,4,8,98,20.02,40.48082,-68.057405,0,0,0,0,0,"HB",0.024
"16595",525,"201102.212.1130.6","NMFS",2011,4,8,98,20.03,40.59391,-67.83469,0,0,0,0,0,"HB",0.024
"16596",525,"201102.213.1150.3","NMFS",2011,4,8,98,20,40.37798,-67.594432,0,0,0,0,0,"HB",0.024
"16597",525,"201102.215.1150.4","NMFS",2011,4,8,98,20.03,40.47055,-67.420005,5,5,0,5,0,"HB",0.024
"16598",525,"201102.216.1130.8","NMFS",2011,4,8,98,20.03,40.56927,-67.475887,0,0,0,0,0,"HB",0.024
"16599",525,"201102.217.1140.2","NMFS",2011,4,8,98,20.03,40.558922,-67.415255,0,0,0,0,0,"HB",0.024
"16600",525,"201102.218.1150.2","NMFS",2011,4,9,99,20.02,40.695935,-66.857038,1,1,0,1,0,"HB",0.024
"16601",562,"201102.219.1140.3","NMFS",2011,4,9,99,20.02,40.785265,-66.8323,1,0,1,1,0,"HB",0.024
"16602",562,"201102.220.1180.2","NMFS",2011,4,9,99,20.02,40.769748,-66.744303,0,0,0,0,0,"HB",0.024
"16603",562,"201102.221.1160.1","NMFS",2011,4,9,99,20.03,41.063285,-66.554048,0,0,0,0,0,"HB",0.024
"16604",562,"201102.223.1170.5","NMFS",2011,4,9,99,20.02,41.03174,-66.44685,2,2,0,2,0,"HB",0.024
"16605",562,"201102.224.1180.1","NMFS",2011,4,9,99,20,41.117447,-66.345727,30,24,6,30,0,"HB",0.024
"16606",562,"201102.225.1170.1","NMFS",2011,4,9,99,20.02,41.151143,-66.387505,0,0,0,0,0,"HB",0.024
"16607",552,"201102.226.1160.5","NMFS",2011,4,9,99,20.02,41.31245,-66.304585,4,4,0,4,0,"HB",0.024
"16608",562,"201102.227.1160.4","NMFS",2011,4,9,99,20.03,41.228348,-66.628467,0,0,0,0,0,"HB",0.024
"16609",562,"201102.228.1160.3","NMFS",2011,4,9,99,20.02,41.316955,-66.713595,0,0,0,0,0,"HB",0.024
"16610",562,"201102.229.1160.11","NMFS",2011,4,10,100,20.02,41.276202,-66.875022,0,0,0,0,0,"HB",0.024
"16611",562,"201102.230.1160.2","NMFS",2011,4,10,100,20.02,40.974297,-66.94957,0,0,0,0,0,"HB",0.024
"16612",525,"201102.231.1130.9","NMFS",2011,4,10,100,20.02,41.016005,-67.200605,0,0,0,0,0,"HB",0.024
"16613",525,"201102.232.1130.4","NMFS",2011,4,10,100,20.02,40.938643,-67.553305,0,0,0,0,0,"HB",0.024
"16614",562,"201102.233.1190.4","NMFS",2011,4,10,100,20.02,41.26047,-67.518402,0,0,0,0,0,"HB",0.024
"16615",562,"201102.234.1160.7","NMFS",2011,4,10,100,20.02,41.316658,-67.111667,0,0,0,0,0,"HB",0.024
"16616",562,"201102.235.1190.3","NMFS",2011,4,10,100,20.02,41.522228,-67.111895,0,0,0,0,0,"HB",0.024
"16617",562,"201102.236.1160.8","NMFS",2011,4,10,100,20.02,41.651265,-67.08582,0,0,0,0,0,"HB",0.024
"16618",562,"201102.237.1190.2","NMFS",2011,4,10,100,20.03,41.55588,-67.295177,0,0,0,0,0,"HB",0.024
"16619",562,"201102.238.1190.1","NMFS",2011,4,11,101,20.02,41.708193,-67.523927,0,0,0,0,0,"HB",0.024
"16620",562,"201102.239.1190.9","NMFS",2011,4,11,101,20,41.332717,-67.63718,0,0,0,0,0,"HB",0.024
"16621",522,"201102.240.1200.3","NMFS",2011,4,11,101,20.02,41.442023,-68.093827,0,0,0,0,0,"HB",0.024
"16622",522,"201102.241.1200.1","NMFS",2011,4,11,101,20.02,41.45759,-68.266838,0,0,0,0,0,"HB",0.024
"16623",522,"201102.242.1230.5","NMFS",2011,4,11,101,20,41.438058,-68.352135,0,0,0,0,0,"HB",0.024
"16624",522,"201102.243.1200.7","NMFS",2011,4,11,101,20,41.296243,-68.407722,0,0,0,0,0,"HB",0.024
"16625",522,"201102.244.1230.1","NMFS",2011,4,11,101,20.02,41.439567,-68.510962,0,0,0,0,0,"HB",0.024
"16626",521,"201102.245.1240.4","NMFS",2011,4,11,101,20.03,41.43702,-68.983025,1,1,0,1,0,"HB",0.024
"16627",521,"201102.246.1230.6","NMFS",2011,4,12,102,20.02,41.380965,-69.286495,2,1,1,2,0,"HB",0.024
"16628",521,"201102.252.1250.9","NMFS",2011,4,12,102,20.02,41.243162,-69.357865,1,1,0,1,0,"HB",0.024
"16629",521,"201102.254.1230.2","NMFS",2011,4,13,103,20.03,41.882587,-69.798708,1,1,0,1,0,"HB",0.024
"16630",521,"201102.257.1280.5","NMFS",2011,4,20,110,20.03,42.104278,-69.671453,1,1,0,1,0,"HB",0.024
"16631",521,"201102.258.1280.2","NMFS",2011,4,20,110,20.03,42.063565,-69.301633,0,0,0,0,0,"HB",0.024
"16632",521,"201102.259.1240.1","NMFS",2011,4,20,110,20.02,41.85496,-69.462868,0,0,0,0,0,"HB",0.024
"16633",522,"201102.260.1240.5","NMFS",2011,4,20,110,20.02,41.61634,-68.80533,3,3,0,3,0,"HB",0.024
"16634",521,"201102.262.1240.8","NMFS",2011,4,21,111,20.02,41.703082,-68.842968,2,1,1,2,0,"HB",0.024
"16635",521,"201102.263.1240.7","NMFS",2011,4,21,111,20.02,41.808823,-68.96352,0,0,0,0,0,"HB",0.024
"16636",522,"201102.264.1240.6","NMFS",2011,4,21,111,20.03,42.147747,-68.772112,3,3,0,3,0,"HB",0.024
"16637",522,"201102.265.1240.3","NMFS",2011,4,21,111,20.02,42.030327,-68.571372,1,1,0,1,0,"HB",0.024
"16638",522,"201102.266.1240.2","NMFS",2011,4,21,111,20.02,42.146392,-68.410953,0,0,0,0,0,"HB",0.024
"16639",522,"201102.267.1210.1","NMFS",2011,4,21,111,20,41.84657,-68.000353,0,0,0,0,0,"HB",0.024
"16640",522,"201102.268.1200.6","NMFS",2011,4,21,111,20.02,41.853937,-67.788947,2,1,1,2,0,"HB",0.024
"16641",522,"201102.269.1220.1","NMFS",2011,4,22,112,20.03,42.09153,-67.848752,2,2,0,2,0,"HB",0.024
"16642",561,"201102.270.1210.2","NMFS",2011,4,22,112,20.03,42.057978,-67.66297,1,1,0,0,1,"HB",0.024
"16643",522,"201102.271.1220.2","NMFS",2011,4,22,112,20.12,42.175672,-67.738838,0,0,0,0,0,"HB",0.024
"16644",551,"201102.275.1160.14","NMFS",2011,4,22,112,20.03,41.840583,-66.623952,0,0,0,0,0,"HB",0.024
"16645",552,"201102.277.1160.9","NMFS",2011,4,23,113,20.02,41.792282,-66.145225,0,0,0,0,0,"HB",0.024
"16646",552,"201102.278.1160.6","NMFS",2011,4,23,113,20.02,41.724982,-66.055107,1,1,0,1,0,"HB",0.024
"16647",552,"201102.279.1170.3","NMFS",2011,4,23,113,20.03,41.522303,-65.980598,19,17,2,19,0,"HB",0.024
"16648",552,"201102.280.1180.4","NMFS",2011,4,23,113,20.03,41.502718,-65.945763,7,6,1,7,0,"HB",0.024
"16649",552,"201102.281.1170.2","NMFS",2011,4,23,113,20.02,41.684037,-65.817523,4,4,0,4,0,"HB",0.024
"16650",551,"201102.282.1180.3","NMFS",2011,4,23,113,20.02,41.902495,-65.761338,25,22,3,25,0,"HB",0.024
"16651",464,"201102.283.1290.8","NMFS",2011,4,23,113,20.02,42.275028,-65.98396,2,1,1,2,0,"HB",0.024
"16652",551,"201102.285.1290.1","NMFS",2011,4,24,114,20,42.228598,-66.35052,1,1,0,1,0,"HB",0.024
"16653",551,"201102.286.1210.4","NMFS",2011,4,24,114,20.02,42.105833,-66.262137,38,24,14,38,0,"HB",0.024
"16654",551,"201102.287.1160.13","NMFS",2011,4,24,114,20.02,42.069643,-66.38201,0,0,0,0,0,"HB",0.024
"16655",551,"201102.288.1220.3","NMFS",2011,4,24,114,20.02,42.151408,-66.477378,6,5,1,6,0,"HB",0.024
"16656",551,"201102.289.1210.3","NMFS",2011,4,24,114,20.02,42.146207,-66.802108,3,2,1,3,0,"HB",0.024
"16657",551,"201102.290.1220.4","NMFS",2011,4,24,114,20.02,42.218765,-67.09568,37,35,2,37,0,"HB",0.024
"16658",464,"201102.291.1300.2","NMFS",2011,4,25,115,20.02,42.435703,-67.153128,6,5,1,6,0,"HB",0.024
"16659",464,"201102.292.1300.1","NMFS",2011,4,25,115,20,42.433567,-67.195378,11,8,3,11,0,"HB",0.024
"16660",464,"201102.293.1300.3","NMFS",2011,4,25,115,20.03,42.606448,-67.082867,7,4,3,7,0,"HB",0.024
"16661",464,"201102.294.1290.6","NMFS",2011,4,25,115,20.02,42.664407,-67.495367,0,0,0,0,0,"HB",0.024
"16662",465,"201102.295.1360.3","NMFS",2011,4,25,115,20.02,43.064378,-67.218158,2,1,1,2,0,"HB",0.024
"16663",465,"201102.297.1360.6","NMFS",2011,4,25,115,20,43.232683,-67.457962,0,0,0,0,0,"HB",0.024
"16664",465,"201102.298.1360.4","NMFS",2011,4,25,115,20.02,43.395422,-67.155105,3,3,0,3,0,"HB",0.024
"16665",465,"201102.299.1340.3","NMFS",2011,4,26,116,20.02,43.263623,-66.896417,15,12,3,15,0,"HB",0.024
"16666",465,"201102.300.1340.1","NMFS",2011,4,26,116,20.02,43.646633,-66.580652,10,4,6,10,0,"HB",0.024
"16667",465,"201102.301.1340.4","NMFS",2011,4,26,116,20.03,43.742788,-66.867267,10,8,2,10,0,"HB",0.024
"16668",511,"201102.302.1340.5","NMFS",2011,4,26,116,20.02,43.985938,-67.070843,2,0,2,2,0,"HB",0.024
"16669",511,"201102.303.1340.2","NMFS",2011,4,26,116,20.02,44.003738,-67.001983,5,3,2,5,0,"HB",0.024
"16670",511,"201102.304.1351.1","NMFS",2011,4,26,116,20,44.138865,-66.89694,5,3,2,5,0,"HB",0.024
"16671",511,"201102.305.1351.4","NMFS",2011,4,26,116,20.02,44.272527,-66.944035,9,5,4,9,0,"HB",0.024
"16672",467,"201102.306.1351.3","NMFS",2011,4,26,116,20.03,44.41122,-66.867197,190,92,98,156,34,"HB",0.024
"16673",511,"201102.307.1351.2","NMFS",2011,4,26,116,20.02,44.255693,-67.168798,31,28,3,31,0,"HB",0.024
"16674",511,"201102.308.1390.5","NMFS",2011,4,27,117,20.02,44.35189,-67.681555,338,121,217,288,50,"HB",0.024
"16675",512,"201102.309.1390.1","NMFS",2011,4,27,117,20.03,44.1791,-68.025778,400,175,225,286,114,"HB",0.024
"16676",511,"201102.310.1380.3","NMFS",2011,4,27,117,20.08,44.19648,-67.55193,2,1,1,2,0,"HB",0.024
"16677",511,"201102.311.1360.1","NMFS",2011,4,27,117,20.02,43.868138,-67.55041,14,13,1,14,0,"HB",0.024
"16678",512,"201102.312.1360.2","NMFS",2011,4,27,117,20.02,43.864335,-67.879743,5,3,2,5,0,"HB",0.024
"16679",465,"201102.313.1360.8","NMFS",2011,4,27,117,20.05,43.569533,-67.601887,2,1,1,2,0,"HB",0.024
"16680",512,"201102.314.1360.7","NMFS",2011,4,27,117,20.03,43.481588,-67.805552,1,0,1,1,0,"HB",0.024
"16681",514,"201102.315.3610.3","NMFS",2011,4,28,118,20.03,42.101778,-70.150533,18,4,14,16,2,"HB",0.024
"16682",514,"201102.316.3610.1","NMFS",2011,4,28,118,20,42.006132,-70.305982,41,9,32,36,5,"HB",0.024
"16683",514,"201102.318.3600.3","NMFS",2011,4,28,118,20.02,41.982967,-70.151042,19,3,16,18,1,"HB",0.024
"16684",514,"201102.319.3590.1","NMFS",2011,4,28,118,20,41.82981,-70.277193,13,8,5,9,4,"HB",0.024
"16685",514,"201102.320.3590.2","NMFS",2011,4,28,118,20.05,41.854932,-70.330208,5,1,4,3,2,"HB",0.024
"16686",514,"201102.321.3600.2","NMFS",2011,4,28,118,20.03,41.931843,-70.328435,83,38,45,72,11,"HB",0.024
"16687",514,"201102.322.1260.1","NMFS",2011,5,4,124,20.02,42.309388,-70.093665,0,0,0,0,0,"HB",0.024
"16688",521,"201102.323.3560.2","NMFS",2011,5,4,124,20.02,41.807117,-69.900767,0,0,0,0,0,"HB",0.024
"16689",521,"201102.324.3560.1","NMFS",2011,5,4,124,20.02,41.736803,-69.881998,2,0,2,2,0,"HB",0.024
"16690",521,"201102.325.1250.7","NMFS",2011,5,4,124,20,41.633567,-69.705925,0,0,0,0,0,"HB",0.024
"16691",521,"201102.326.1280.3","NMFS",2011,5,5,125,20.02,42.317767,-69.509118,0,0,0,0,0,"HB",0.024
"16692",515,"201102.327.1280.6","NMFS",2011,5,5,125,20.03,42.48861,-69.039618,0,0,0,0,0,"HB",0.024
"16693",515,"201102.328.1280.1","NMFS",2011,5,5,125,20.02,42.560498,-68.913822,0,0,0,0,0,"HB",0.024
"16694",515,"201102.329.1280.4","NMFS",2011,5,5,125,20.02,42.679538,-68.608837,0,0,0,0,0,"HB",0.024
"16695",515,"201102.330.1290.7","NMFS",2011,5,5,125,20,42.566448,-68.320608,4,4,0,4,0,"HB",0.024
"16696",515,"201102.331.1290.3","NMFS",2011,5,5,125,20.05,42.475168,-68.027528,0,0,0,0,0,"HB",0.024
"16697",515,"201102.332.1290.4","NMFS",2011,5,6,126,20.03,42.520967,-67.777787,2,2,0,2,0,"HB",0.024
"16698",515,"201102.333.1290.2","NMFS",2011,5,6,126,20.02,42.715607,-68.004093,2,1,1,2,0,"HB",0.024
"16699",515,"201102.334.1360.9","NMFS",2011,5,6,126,20.03,42.846318,-68.260827,2,2,0,2,0,"HB",0.024
"16700",515,"201102.335.1370.4","NMFS",2011,5,6,126,20.03,42.893795,-68.640777,0,0,0,0,0,"HB",0.024
"16701",515,"201102.336.1370.1","NMFS",2011,5,6,126,20.03,42.799515,-69.065588,0,0,0,0,0,"HB",0.024
"16702",513,"201102.337.1370.2","NMFS",2011,5,7,127,20.02,43.070495,-69.533397,3,2,1,3,0,"HB",0.024
"16703",513,"201102.338.1370.5","NMFS",2011,5,7,127,20,43.229152,-69.196355,0,0,0,0,0,"HB",0.024
"16704",515,"201102.339.1380.7","NMFS",2011,5,7,127,20.02,43.323643,-68.777115,2,2,0,2,0,"HB",0.024
"16705",512,"201102.340.1380.6","NMFS",2011,5,7,127,20.02,43.478108,-68.546953,6,5,1,6,0,"HB",0.024
"16706",512,"201102.341.1380.5","NMFS",2011,5,7,127,20.03,43.470018,-68.405472,5,5,0,5,0,"HB",0.024
"16707",512,"201102.342.1390.4","NMFS",2011,5,7,127,20.02,43.999803,-68.264757,33,16,17,29,4,"HB",0.024
"16708",512,"201102.343.1390.3","NMFS",2011,5,7,127,20.02,43.991612,-68.441032,305,136,169,239,66,"HB",0.024
"16709",512,"201102.344.1390.2","NMFS",2011,5,7,127,20.02,43.945602,-68.587368,377,187,190,239,138,"HB",0.024
"16710",513,"201102.345.1380.4","NMFS",2011,5,8,128,20,43.532193,-69.374018,12,10,2,11,1,"HB",0.024
"16711",513,"201102.346.1380.1","NMFS",2011,5,8,128,20.55,43.438063,-69.532893,0,0,0,0,0,"HB",0.024
"16712",513,"201102.347.1400.3","NMFS",2011,5,8,128,20.02,43.610002,-69.72072,39,14,25,30,9,"HB",0.024
"16713",513,"201102.348.1400.2","NMFS",2011,5,8,128,20.43,43.47037,-70.051137,16,7,9,15,1,"HB",0.024
"16714",513,"201102.349.1380.2","NMFS",2011,5,8,128,20.02,43.326445,-69.814048,5,5,0,5,0,"HB",0.024
"16715",513,"201102.350.1370.3","NMFS",2011,5,8,128,20.02,43.229393,-69.804678,6,4,2,6,0,"HB",0.024
"16716",513,"201102.351.1270.2","NMFS",2011,5,8,128,20.02,43.117457,-70.176337,9,5,4,9,0,"HB",0.024
"16717",513,"201102.352.1270.4","NMFS",2011,5,8,128,20.03,42.948903,-69.993597,16,16,0,16,0,"HB",0.024
"16718",513,"201102.353.1270.3","NMFS",2011,5,8,128,20.37,42.952398,-70.23039,6,5,1,6,0,"HB",0.024
"16719",513,"201102.354.1400.1","NMFS",2011,5,9,129,20,42.934867,-70.39561,12,4,8,12,0,"HB",0.024
"16720",513,"201102.355.3640.1","NMFS",2011,5,9,129,20.02,42.846462,-70.751485,44,24,20,44,0,"HB",0.024
"16721",514,"201102.356.1260.5","NMFS",2011,5,9,129,20.02,42.738435,-70.416728,24,15,9,24,0,"HB",0.024
"16722",514,"201102.357.1260.6","NMFS",2011,5,9,129,20.05,42.731077,-70.189585,5,4,1,5,0,"HB",0.024
"16723",514,"201102.358.1270.1","NMFS",2011,5,9,129,20.03,42.676145,-70.012052,12,12,0,12,0,"HB",0.024
"16724",514,"201102.360.1260.7","NMFS",2011,5,9,129,20.02,42.573443,-70.088702,1,1,0,1,0,"HB",0.024
"16725",514,"201102.363.1260.2","NMFS",2011,5,9,129,20.03,42.398018,-70.389557,1,0,1,1,0,"HB",0.024
"16726",514,"201102.364.3650.1","NMFS",2011,5,10,130,20.02,42.57629,-70.606063,34,16,18,26,8,"HB",0.024
"16727",514,"201102.365.3660.1","NMFS",2011,5,10,130,20.02,42.497047,-70.68731,140,75,65,123,17,"HB",0.024
"16728",514,"201102.367.3650.2","NMFS",2011,5,10,130,20.05,42.320213,-70.727433,110,56,54,97,13,"HB",0.024
"16729",514,"201102.368.3640.3","NMFS",2011,5,10,130,20.02,42.327625,-70.754603,228,145,83,201,27,"HB",0.024
"16730",514,"201102.370.3660.3","NMFS",2011,5,10,130,20.03,42.242033,-70.521072,22,15,7,21,1,"HB",0.024
"16731",514,"201102.371.3660.2","NMFS",2011,5,10,130,20.15,42.215543,-70.49101,7,2,5,6,1,"HB",0.024
"16732",514,"201102.372.3610.2","NMFS",2011,5,11,131,20.02,42.14051,-70.463393,43,15,28,37,6,"HB",0.024
"16733",526,"201105.195.1120.1","NMFS",2011,10,3,276,19.93,39.92762,-69.756182,20,6,14,16,4,"HB",0.024
"16734",526,"201105.196.1120.3","NMFS",2011,10,3,276,20.03,39.954098,-69.577258,9,4,5,9,0,"HB",0.024
"16735",526,"201105.197.1120.2","NMFS",2011,10,3,276,20.02,39.925532,-69.474247,32,14,18,31,1,"HB",0.024
"16736",526,"201105.198.1110.2","NMFS",2011,10,3,276,20,40.002308,-69.329423,1,0,1,1,0,"HB",0.024
"16737",526,"201105.199.1100.7","NMFS",2011,10,4,277,20,40.093483,-69.470852,1,0,1,1,0,"HB",0.024
"16738",526,"201105.200.1100.3","NMFS",2011,10,4,277,20,40.25218,-69.327158,4,4,0,4,0,"HB",0.024
"16739",526,"201105.201.1100.2","NMFS",2011,10,4,277,20.13,40.301217,-69.174812,5,1,4,4,1,"HB",0.024
"16740",526,"201105.202.1100.9","NMFS",2011,10,4,277,20.02,40.381187,-69.662477,1,1,0,1,0,"HB",0.024
"16741",526,"201105.203.1100.8","NMFS",2011,10,4,277,20.02,40.48135,-69.911562,3,0,3,3,0,"HB",0.024
"16742",526,"201105.204.1090.4","NMFS",2011,10,4,277,20.02,40.690328,-69.659663,2,2,0,2,0,"HB",0.024
"16743",526,"201105.207.1090.2","NMFS",2011,10,4,277,20.02,40.667043,-69.491835,0,0,0,0,0,"HB",0.024
"16744",526,"201105.208.1100.1","NMFS",2011,10,5,278,20,40.7466,-69.1604,1,1,0,1,0,"HB",0.024
"16745",526,"201105.209.1100.4","NMFS",2011,10,5,278,20.02,40.712247,-69.000662,3,2,1,3,0,"HB",0.024
"16746",525,"201105.210.1130.3","NMFS",2011,10,5,278,20.02,40.756175,-68.691208,8,7,1,7,1,"HB",0.024
"16747",526,"201105.214.1110.3","NMFS",2011,10,12,285,20,40.09776,-68.976937,0,0,0,0,0,"HB",0.024
"16748",525,"201105.215.1150.2","NMFS",2011,10,12,285,20.02,40.114608,-68.662635,0,0,0,0,0,"HB",0.024
"16749",525,"201105.216.1150.1","NMFS",2011,10,12,285,20.02,40.15241,-68.566165,0,0,0,0,0,"HB",0.024
"16750",525,"201105.217.1130.1","NMFS",2011,10,12,285,20,40.307853,-68.757935,0,0,0,0,0,"HB",0.024
"16751",525,"201105.218.1130.8","NMFS",2011,10,12,285,20.02,40.362317,-68.65957,0,0,0,0,0,"HB",0.024
"16752",525,"201105.219.1140.2","NMFS",2011,10,12,285,20.02,40.278032,-68.342997,0,0,0,0,0,"HB",0.024
"16753",525,"201105.220.1140.4","NMFS",2011,10,13,286,20,40.372187,-68.053152,3,3,0,3,0,"HB",0.024
"16754",525,"201105.221.1140.3","NMFS",2011,10,13,286,20.02,40.475652,-67.987527,3,3,0,3,0,"HB",0.024
"16755",525,"201105.222.1130.7","NMFS",2011,10,13,286,20.02,40.711875,-68.044983,0,0,0,0,0,"HB",0.024
"16756",525,"201105.224.1140.1","NMFS",2011,10,13,286,20.02,40.526037,-67.615177,3,3,0,3,0,"HB",0.024
"16757",525,"201105.225.1130.5","NMFS",2011,10,13,286,19.98,40.824897,-67.464772,2,2,0,2,0,"HB",0.024
"16758",525,"201105.226.1130.9","NMFS",2011,10,13,286,20.02,40.860048,-67.760652,5,5,0,5,0,"HB",0.024
"16759",525,"201105.227.1130.4","NMFS",2011,10,13,286,20.03,40.970613,-67.734633,2,2,0,2,0,"HB",0.024
"16760",525,"201105.228.1130.2","NMFS",2011,10,13,286,20,41.018002,-67.517112,3,3,0,3,0,"HB",0.024
"16761",525,"201105.229.1130.6","NMFS",2011,10,14,287,20,41.087123,-67.5386,3,3,0,3,0,"HB",0.024
"16762",562,"201105.230.1190.2","NMFS",2011,10,14,287,20,41.307727,-67.289185,2,2,0,2,0,"HB",0.024
"16763",562,"201105.231.1160.6","NMFS",2011,10,14,287,20,41.172283,-67.00471,6,6,0,6,0,"HB",0.024
"16764",562,"201105.232.1160.4","NMFS",2011,10,14,287,20.02,41.005282,-66.865923,0,0,0,0,0,"HB",0.024
"16765",562,"201105.233.1150.3","NMFS",2011,10,14,287,20,40.732555,-66.808205,12,10,2,12,0,"HB",0.024
"16766",562,"201105.234.1180.1","NMFS",2011,10,14,287,20,40.780407,-66.737953,16,14,2,14,2,"HB",0.024
"16767",562,"201105.235.1180.2","NMFS",2011,10,14,287,20.07,40.960623,-66.482863,64,58,6,64,0,"HB",0.024
"16768",562,"201105.236.1170.3","NMFS",2011,10,14,287,20,41.006503,-66.493555,0,0,0,0,0,"HB",0.024
"16769",562,"201105.237.1170.2","NMFS",2011,10,15,288,19.98,41.183182,-66.331447,0,0,0,0,0,"HB",0.024
"16770",562,"201105.238.1160.3","NMFS",2011,10,15,288,20.02,41.479123,-66.628625,11,11,0,11,0,"HB",0.024
"16771",562,"201105.239.1160.1","NMFS",2011,10,15,288,19.98,41.575368,-66.780525,51,51,0,51,0,"HB",0.024
"16772",562,"201105.240.1160.8","NMFS",2011,10,15,288,20,41.530063,-67.073612,1,1,0,1,0,"HB",0.024
"16773",551,"201105.241.1160.9","NMFS",2011,10,15,288,20,42.021895,-66.844903,13,11,2,13,0,"HB",0.024
"16774",551,"201105.242.1160.10","NMFS",2011,10,16,289,20.02,41.952248,-66.784767,12,10,2,12,0,"HB",0.024
"16775",552,"201105.243.1160.12","NMFS",2011,10,16,289,20,41.812353,-66.584763,9,7,2,9,0,"HB",0.024
"16776",552,"201105.244.1160.13","NMFS",2011,10,16,289,20.02,41.590565,-66.460897,8,8,0,8,0,"HB",0.024
"16777",552,"201105.246.1160.11","NMFS",2011,10,16,289,20.02,41.593522,-66.124942,0,0,0,0,0,"HB",0.024
"16778",552,"201105.247.1170.4","NMFS",2011,10,16,289,20,41.607088,-65.963408,3,0,3,3,0,"HB",0.024
"16779",552,"201105.248.1170.1","NMFS",2011,10,16,289,20.02,41.687155,-65.854767,1,1,0,1,0,"HB",0.024
"16780",552,"201105.250.1180.4","NMFS",2011,10,17,290,20.02,41.798127,-65.732117,13,13,0,13,0,"HB",0.024
"16781",551,"201105.251.1180.3","NMFS",2011,10,17,290,20,42.038923,-65.892928,3,3,0,3,0,"HB",0.024
"16782",551,"201105.252.1160.2","NMFS",2011,10,17,290,20,42.049825,-66.040055,0,0,0,0,0,"HB",0.024
"16783",551,"201105.254.1210.4","NMFS",2011,10,17,290,20,42.13036,-66.194923,2,1,1,2,0,"HB",0.024
"16784",551,"201105.255.1290.4","NMFS",2011,10,17,290,20.03,42.234108,-66.097467,0,0,0,0,0,"HB",0.024
"16785",551,"201105.256.1220.1","NMFS",2011,10,17,290,20.02,42.149045,-66.27793,5,4,1,5,0,"HB",0.024
"16786",551,"201105.257.1220.4","NMFS",2011,10,17,290,20,42.169847,-66.403663,2,1,1,2,0,"HB",0.024
"16787",551,"201105.258.1210.3","NMFS",2011,10,18,291,20,42.161465,-67.079048,0,0,0,0,0,"HB",0.024
"16788",561,"201105.259.1210.1","NMFS",2011,10,18,291,20.02,42.138233,-67.178695,2,1,1,2,0,"HB",0.024
"16789",562,"201105.261.1190.6","NMFS",2011,10,18,291,20.02,41.74096,-67.204667,7,7,0,7,0,"HB",0.024
"16790",561,"201105.263.1200.4","NMFS",2011,10,18,291,20,41.877997,-67.495723,3,2,1,3,0,"HB",0.024
"16791",522,"201105.265.1200.1","NMFS",2011,10,18,291,20.05,41.94653,-67.784627,3,3,0,3,0,"HB",0.024
"16792",522,"201105.266.1220.3","NMFS",2011,10,18,291,20,41.859012,-68.122888,0,0,0,0,0,"HB",0.024
"16793",522,"201105.267.1240.4","NMFS",2011,10,19,292,20,41.90541,-68.392225,0,0,0,0,0,"HB",0.024
"16794",522,"201105.268.1240.3","NMFS",2011,10,19,292,20.02,42.060915,-68.785248,0,0,0,0,0,"HB",0.024
"16795",522,"201105.269.1240.7","NMFS",2011,10,19,292,20,41.951062,-68.828702,0,0,0,0,0,"HB",0.024
"16796",521,"201105.270.1280.1","NMFS",2011,10,19,292,20,42.278222,-69.802007,0,0,0,0,0,"HB",0.024
"16797",521,"201105.271.1270.2","NMFS",2011,10,19,292,20,42.244302,-69.979715,1,1,0,1,0,"HB",0.024
"16798",514,"201105.272.1270.4","NMFS",2011,10,19,292,20.02,42.283208,-70.014722,0,0,0,0,0,"HB",0.024
"16799",514,"201105.273.3610.3","NMFS",2011,10,19,292,20.03,42.16945,-70.116533,0,0,0,0,0,"HB",0.024
"16800",514,"201105.274.1260.6","NMFS",2011,10,20,293,20,42.371772,-70.587153,18,4,14,18,0,"HB",0.024
"16801",514,"201105.276.3640.3","NMFS",2011,10,20,293,20.02,42.337467,-70.779903,408,239,169,290,118,"HB",0.024
"16802",514,"201105.278.3660.2","NMFS",2011,10,20,293,20,42.209333,-70.479728,5,4,1,4,1,"HB",0.024
"16803",514,"201105.279.3600.3","NMFS",2011,10,20,293,20.02,42.121243,-70.521788,158,102,56,150,8,"HB",0.024
"16804",514,"201105.280.3600.1","NMFS",2011,10,20,293,20,42.039367,-70.517542,163,97,66,125,38,"HB",0.024
"16805",521,"201105.286.1250.4","NMFS",2011,10,26,299,20.08,41.137282,-69.237983,23,15,8,22,1,"HB",0.024
"16806",521,"201105.287.1250.1","NMFS",2011,10,26,299,20.03,41.235697,-69.364135,3,3,0,3,0,"HB",0.024
"16807",521,"201105.288.1240.1","NMFS",2011,10,26,299,19.98,41.33891,-69.177177,1,1,0,1,0,"HB",0.024
"16808",521,"201105.289.1230.4","NMFS",2011,10,26,299,20.02,41.204988,-68.854645,0,0,0,0,0,"HB",0.024
"16809",522,"201105.290.1230.2","NMFS",2011,10,26,299,20,41.149688,-68.823838,0,0,0,0,0,"HB",0.024
"16810",522,"201105.292.1190.8","NMFS",2011,10,27,300,19.13,41.11905,-68.458483,2,1,1,1,1,"HB",0.024
"16811",525,"201105.293.1190.5","NMFS",2011,10,27,300,20,41.090607,-68.319423,0,0,0,0,0,"HB",0.024
"16812",522,"201105.296.1190.10","NMFS",2011,10,27,300,20.02,41.40039,-67.692462,0,0,0,0,0,"HB",0.024
"16813",522,"201105.297.1200.5","NMFS",2011,10,27,300,19.98,41.606445,-67.890668,0,0,0,0,0,"HB",0.024
"16814",522,"201105.298.1190.3","NMFS",2011,10,27,300,20.02,41.431328,-67.972323,1,1,0,1,0,"HB",0.024
"16815",522,"201105.300.1200.2","NMFS",2011,10,27,300,20.02,41.317992,-68.239653,5,2,3,0,5,"HB",0.024
"16816",522,"201105.302.1230.5","NMFS",2011,10,28,301,20,41.463543,-68.44867,29,26,3,29,0,"HB",0.024
"16817",522,"201105.304.1220.2","NMFS",2011,10,28,301,20,41.736872,-68.389665,2,1,1,2,0,"HB",0.024
"16818",522,"201105.305.1210.2","NMFS",2011,10,28,301,20.02,41.711275,-68.36006,1,1,0,1,0,"HB",0.024
"16819",522,"201105.306.1290.6","NMFS",2011,10,28,301,19.98,42.050745,-68.142928,1,0,1,1,0,"HB",0.024
"16820",515,"201105.307.1290.1","NMFS",2011,10,29,302,20,42.650095,-67.899083,1,1,0,1,0,"HB",0.024
"16821",512,"201105.308.1360.3","NMFS",2011,10,29,302,19.98,43.642197,-67.824775,2,0,2,2,0,"HB",0.024
"16822",467,"201105.311.1351.3","NMFS",2011,10,31,304,20.02,44.40563,-66.961813,84,37,47,84,0,"HB",0.024
"16823",511,"201105.312.1351.2","NMFS",2011,10,31,304,20.02,44.163593,-67.07455,15,7,8,11,4,"HB",0.024
"16824",511,"201105.313.1340.7","NMFS",2011,10,31,304,20.02,44.066628,-67.121105,4,3,1,4,0,"HB",0.024
"16825",465,"201105.314.1340.6","NMFS",2011,11,1,305,20.02,43.450322,-66.589897,84,34,50,84,0,"HB",0.024
"16826",465,"201105.315.1360.1","NMFS",2011,11,1,305,20,43.376773,-67.048838,1,1,0,1,0,"HB",0.024
"16827",465,"201105.316.1340.2","NMFS",2011,11,1,305,20,43.232702,-66.745787,27,20,7,27,0,"HB",0.024
"16828",465,"201105.317.1340.3","NMFS",2011,11,1,305,20.02,43.076068,-66.563758,23,17,6,23,0,"HB",0.024
"16829",464,"201105.318.1290.8","NMFS",2011,11,1,305,20,42.542315,-66.598813,6,3,3,6,0,"HB",0.024
"16830",464,"201105.319.1300.2","NMFS",2011,11,1,305,20.02,42.405727,-66.736022,1,1,0,1,0,"HB",0.024
"16831",464,"201105.322.1300.1","NMFS",2011,11,2,306,20.02,42.55411,-67.119337,9,6,3,9,0,"HB",0.024
"16832",515,"201105.324.1360.6","NMFS",2011,11,2,306,20,42.80185,-67.669122,0,0,0,0,0,"HB",0.024
"16833",515,"201105.325.1290.9","NMFS",2011,11,2,306,20.02,42.373222,-67.720825,1,0,1,1,0,"HB",0.024
"16834",522,"201105.326.1290.5","NMFS",2011,11,2,306,20.02,42.212732,-67.948197,0,0,0,0,0,"HB",0.024
"16835",522,"201105.327.1290.3","NMFS",2011,11,2,306,20,42.243335,-68.118012,0,0,0,0,0,"HB",0.024
"16836",515,"201105.328.1240.8","NMFS",2011,11,2,306,20.65,42.350685,-68.476763,0,0,0,0,0,"HB",0.024
"16837",521,"201105.330.1240.6","NMFS",2011,11,3,307,19.98,41.616763,-69.185695,1,1,0,1,0,"HB",0.024
"16838",521,"201105.331.1230.1","NMFS",2011,11,3,307,20,41.616588,-69.451433,2,2,0,2,0,"HB",0.024
"16839",521,"201105.334.1230.6","NMFS",2011,11,3,307,20,41.668845,-69.64865,9,7,2,9,0,"HB",0.024
"16840",514,"201105.339.3590.3","NMFS",2011,11,7,311,20,41.845923,-70.423533,45,28,17,26,19,"HB",0.024
"16841",514,"201105.341.3590.5","NMFS",2011,11,7,311,20.02,41.81812,-70.331443,50,30,20,20,30,"HB",0.024
"16842",514,"201105.342.3600.2","NMFS",2011,11,8,312,20,41.94331,-70.344208,332,150,182,270,62,"HB",0.024
"16843",514,"201105.343.3610.2","NMFS",2011,11,8,312,20.02,42.088025,-70.462228,57,29,28,45,12,"HB",0.024
"16844",514,"201105.345.3650.1","NMFS",2011,11,8,312,20.02,42.470428,-70.769087,560,321,239,477,83,"HB",0.024
"16845",514,"201105.347.1260.3","NMFS",2011,11,8,312,20.02,42.54578,-70.467667,59,27,32,54,5,"HB",0.024
"16846",514,"201105.348.3660.1","NMFS",2011,11,8,312,20,42.621245,-70.528007,380,196,184,273,107,"HB",0.024
"16847",514,"201105.349.3660.3","NMFS",2011,11,8,312,19.98,42.654375,-70.445593,53,22,31,51,2,"HB",0.024
"16848",514,"201105.351.3640.2","NMFS",2011,11,8,312,20.02,42.706862,-70.671062,55,31,24,47,8,"HB",0.024
"16849",514,"201105.352.3650.3","NMFS",2011,11,8,312,20,42.790792,-70.695197,252,137,115,239,13,"HB",0.024
"16850",513,"201105.353.1400.4","NMFS",2011,11,9,313,20.02,42.841073,-70.494457,6,3,3,6,0,"HB",0.024
"16851",513,"201105.356.1260.1","NMFS",2011,11,9,313,19.63,42.85866,-70.194738,1,0,1,1,0,"HB",0.024
"16852",514,"201105.357.1280.4","NMFS",2011,11,9,313,19.98,42.791392,-69.958002,1,1,0,1,0,"HB",0.024
"16853",514,"201105.358.1280.5","NMFS",2011,11,9,313,20.08,42.800983,-69.959237,0,0,0,0,0,"HB",0.024
"16854",513,"201105.359.1270.3","NMFS",2011,11,9,313,20.02,42.985607,-70.079028,2,2,0,2,0,"HB",0.024
"16855",513,"201105.362.1370.6","NMFS",2011,11,10,314,20.02,43.05325,-69.482082,1,1,0,1,0,"HB",0.024
"16856",513,"201105.363.1370.1","NMFS",2011,11,10,314,20,43.16258,-69.211605,0,0,0,0,0,"HB",0.024
"16857",513,"201105.364.1370.2","NMFS",2011,11,10,314,20.02,43.273328,-69.142548,0,0,0,0,0,"HB",0.024
"16858",513,"201105.365.1380.6","NMFS",2011,11,10,314,20,43.377093,-69.069487,2,1,1,2,0,"HB",0.024
"16859",513,"201105.367.1380.9","NMFS",2011,11,10,314,20,43.382985,-69.821008,3,3,0,3,0,"HB",0.024
"16860",513,"201105.368.1400.3","NMFS",2011,11,10,314,20,43.515605,-69.918538,51,27,24,47,4,"HB",0.024
"16861",513,"201105.369.1400.2","NMFS",2011,11,10,314,20.02,43.473712,-70.037267,25,17,8,24,1,"HB",0.024
"16862",513,"201105.370.1380.3","NMFS",2011,11,11,315,20.02,43.54854,-69.514068,2,2,0,2,0,"HB",0.024
"16863",512,"201105.372.1390.5","NMFS",2011,11,11,315,20.02,43.855485,-68.583745,341,193,148,323,18,"HB",0.024
"16864",512,"201105.375.1390.4","NMFS",2011,11,11,315,20,43.85845,-68.419663,128,85,43,127,1,"HB",0.024
"16865",512,"201105.376.1380.7","NMFS",2011,11,11,315,20,43.581112,-68.396858,7,7,0,7,0,"HB",0.024
"16866",512,"201105.377.1380.8","NMFS",2011,11,11,315,20.02,43.523852,-68.205858,1,1,0,1,0,"HB",0.024
"16867",515,"201105.378.1380.4","NMFS",2011,11,12,316,20,43.320907,-68.449348,1,1,0,1,0,"HB",0.024
"16868",515,"201105.379.1370.3","NMFS",2011,11,12,316,19.98,43.028738,-68.589347,0,0,0,0,0,"HB",0.024
"16869",515,"201105.380.1370.7","NMFS",2011,11,12,316,20.02,42.820542,-68.72167,0,0,0,0,0,"HB",0.024
"16870",515,"201105.382.1280.7","NMFS",2011,11,13,317,20.02,42.510712,-69.002707,0,0,0,0,0,"HB",0.024
"16871",515,"201105.383.1280.2","NMFS",2011,11,13,317,20,42.39442,-69.121945,0,0,0,0,0,"HB",0.024
"16872",515,"201105.384.1280.3","NMFS",2011,11,13,317,20.02,42.415947,-69.66089,0,0,0,0,0,"HB",0.024
"16873",515,"201105.385.1280.6","NMFS",2011,11,13,317,20,42.56392,-69.59726,1,1,0,1,0,"HB",0.024
"16874",514,"201105.386.1270.5","NMFS",2011,11,13,317,20.02,42.553045,-70.025897,2,2,0,2,0,"HB",0.024
"16875",514,"201105.387.1270.1","NMFS",2011,11,13,317,20.02,42.561348,-70.063482,0,0,0,0,0,"HB",0.024
"16876",514,"201105.388.1260.5","NMFS",2011,11,14,318,20,42.385035,-70.20561,0,0,0,0,0,"HB",0.024
"16877",521,"201105.390.3610.1","NMFS",2011,11,14,318,20,42.060072,-69.967035,45,36,9,45,0,"HB",0.024
"16878",521,"201105.391.1250.2","NMFS",2011,11,14,318,20,41.989188,-69.908708,63,45,18,63,0,"HB",0.024
"16879",521,"201105.394.3560.3","NMFS",2011,11,14,318,20,41.768692,-69.891518,2,2,0,2,0,"HB",0.024
"16880",521,"201105.395.3560.1","NMFS",2011,11,14,318,20,41.70971,-69.877423,2,1,1,2,0,"HB",0.024
"16881",526,"201202.173.1090.4","NMFS",2012,3,28,88,20.02,40.710727,-69.785247,0,0,0,0,0,"HB",0.024
"16882",526,"201202.174.1090.1","NMFS",2012,3,28,88,20,40.645158,-69.928857,0,0,0,0,0,"HB",0.024
"16883",526,"201202.175.1100.5","NMFS",2012,3,28,88,20,40.56236,-69.880192,0,0,0,0,0,"HB",0.024
"16884",526,"201202.178.1120.2","NMFS",2012,3,28,88,20.02,39.950045,-69.959432,0,0,0,0,0,"HB",0.024
"16885",526,"201202.184.1120.3","NMFS",2012,4,3,94,20.02,39.919477,-69.76295,0,0,0,0,0,"HB",0.024
"16886",526,"201202.185.1120.1","NMFS",2012,4,3,94,20.02,39.941917,-69.569048,0,0,0,0,0,"HB",0.024
"16887",526,"201202.186.1100.3","NMFS",2012,4,3,94,20.02,40.139767,-69.656635,0,0,0,0,0,"HB",0.024
"16888",526,"201202.187.1100.8","NMFS",2012,4,3,94,20,40.207887,-69.326075,1,0,1,1,0,"HB",0.024
"16889",526,"201202.188.1110.4","NMFS",2012,4,3,94,20,40.073648,-69.206148,0,0,0,0,0,"HB",0.024
"16890",526,"201202.189.1110.2","NMFS",2012,4,3,94,20,40.160595,-69.003568,0,0,0,0,0,"HB",0.024
"16891",526,"201202.190.1100.7","NMFS",2012,4,3,94,20.02,40.398503,-69.113175,0,0,0,0,0,"HB",0.024
"16892",525,"201202.191.1150.1","NMFS",2012,4,4,95,19.98,40.163392,-68.548708,3,1,2,3,0,"HB",0.024
"16893",525,"201202.192.1140.3","NMFS",2012,4,4,95,20,40.321463,-68.372813,0,0,0,0,0,"HB",0.024
"16894",525,"201202.193.1140.1","NMFS",2012,4,4,95,20.02,40.353923,-68.265353,0,0,0,0,0,"HB",0.024
"16895",525,"201202.194.1140.4","NMFS",2012,4,4,95,20.02,40.430472,-68.208977,0,0,0,0,0,"HB",0.024
"16896",525,"201202.195.1130.9","NMFS",2012,4,4,95,20,40.52096,-68.080275,0,0,0,0,0,"HB",0.024
"16897",525,"201202.196.1130.1","NMFS",2012,4,4,95,20.02,40.580137,-68.21229,0,0,0,0,0,"HB",0.024
"16898",525,"201202.197.1190.9","NMFS",2012,4,4,95,20.02,40.778295,-68.29166,0,0,0,0,0,"HB",0.024
"16899",525,"201202.199.1190.5","NMFS",2012,4,4,95,20,40.92164,-68.438563,0,0,0,0,0,"HB",0.024
"16900",526,"201202.204.1100.6","NMFS",2012,4,5,96,20.02,40.7563,-69.003013,5,5,0,5,0,"HB",0.024
"16901",526,"201202.205.1090.5","NMFS",2012,4,5,96,20,40.76334,-69.414918,0,0,0,0,0,"HB",0.024
"16902",521,"201202.211.1230.7","NMFS",2012,4,5,96,20,41.032113,-69.105168,0,0,0,0,0,"HB",0.024
"16903",521,"201202.212.1230.11","NMFS",2012,4,5,96,20.02,41.166965,-69.150245,2,1,1,2,0,"HB",0.024
"16904",521,"201202.213.1230.6","NMFS",2012,4,6,97,20,41.277102,-69.173878,0,0,0,0,0,"HB",0.024
"16905",521,"201202.214.1230.3","NMFS",2012,4,6,97,20,41.278653,-69.308052,10,4,6,10,0,"HB",0.024
"16906",521,"201202.217.1250.2","NMFS",2012,4,6,97,20.02,41.383815,-69.391457,0,0,0,0,0,"HB",0.024
"16907",521,"201202.219.1250.1","NMFS",2012,4,6,97,20.02,41.39524,-69.443718,0,0,0,0,0,"HB",0.024
"16908",521,"201202.221.3560.2","NMFS",2012,4,6,97,20.02,41.799168,-69.902657,0,0,0,0,0,"HB",0.024
"16909",514,"201202.224.3560.3","NMFS",2012,4,7,98,20,42.034063,-70.027123,0,0,0,0,0,"HB",0.024
"16910",521,"201202.225.3610.2","NMFS",2012,4,7,98,20.02,42.059835,-69.990282,0,0,0,0,0,"HB",0.024
"16911",521,"201202.226.1280.2","NMFS",2012,4,7,98,20,41.874423,-69.382535,2,2,0,2,0,"HB",0.024
"16912",521,"201202.228.1240.1","NMFS",2012,4,7,98,20,41.62195,-69.12369,6,6,0,6,0,"HB",0.024
"16913",521,"201202.229.1240.7","NMFS",2012,4,7,98,20,41.659305,-68.97998,1,1,0,1,0,"HB",0.024
"16914",521,"201202.230.1240.6","NMFS",2012,4,7,98,20.02,41.605075,-68.860085,2,2,0,2,0,"HB",0.024
"16915",522,"201202.232.1200.9","NMFS",2012,4,8,99,20,41.542862,-68.39077,0,0,0,0,0,"HB",0.024
"16916",522,"201202.233.1230.1","NMFS",2012,4,8,99,20,41.298168,-68.505545,1,1,0,1,0,"HB",0.024
"16917",522,"201202.234.1230.5","NMFS",2012,4,8,99,20.02,41.203493,-68.5918,0,0,0,0,0,"HB",0.024
"16918",522,"201202.237.1200.3","NMFS",2012,4,8,99,20.02,41.703923,-68.30581,0,0,0,0,0,"HB",0.024
"16919",522,"201202.238.1210.1","NMFS",2012,4,8,99,20.02,41.746512,-68.235987,0,0,0,0,0,"HB",0.024
"16920",522,"201202.239.1210.2","NMFS",2012,4,8,99,20.02,41.808133,-68.07533,0,0,0,0,0,"HB",0.024
"16921",522,"201202.240.1200.6","NMFS",2012,4,9,100,20.02,41.94746,-67.71108,1,0,1,1,0,"HB",0.024
"16922",522,"201202.242.1290.6","NMFS",2012,4,9,100,20,42.261863,-68.306507,0,0,0,0,0,"HB",0.024
"16923",515,"201202.243.1290.4","NMFS",2012,4,9,100,20,42.514468,-68.298248,0,0,0,0,0,"HB",0.024
"16924",515,"201202.244.1290.9","NMFS",2012,4,9,100,20.02,42.527543,-68.371985,1,1,0,1,0,"HB",0.024
"16925",515,"201202.245.1290.1","NMFS",2012,4,9,100,20,42.702907,-68.234165,2,2,0,2,0,"HB",0.024
"16926",515,"201202.246.1290.5","NMFS",2012,4,10,101,20,42.52389,-67.93121,0,0,0,0,0,"HB",0.024
"16927",464,"201202.247.1360.4","NMFS",2012,4,10,101,20.02,42.86057,-67.609823,20,20,0,20,0,"HB",0.024
"16928",464,"201202.249.1290.3","NMFS",2012,4,10,101,20,42.750355,-67.339663,2,0,2,2,0,"HB",0.024
"16929",464,"201202.250.1290.8","NMFS",2012,4,10,101,20,42.67643,-67.404395,7,6,1,7,0,"HB",0.024
"16930",464,"201202.251.1300.1","NMFS",2012,4,10,101,20,42.598582,-67.071438,13,10,3,13,0,"HB",0.024
"16931",464,"201202.252.1300.3","NMFS",2012,4,10,101,20.02,42.572378,-67.095265,11,10,1,11,0,"HB",0.024
"16932",464,"201202.254.1300.2","NMFS",2012,4,11,102,20,42.38868,-67.448247,13,11,2,13,0,"HB",0.024
"16933",561,"201202.255.1200.4","NMFS",2012,4,11,102,20,42.03431,-67.205893,0,0,0,0,0,"HB",0.024
"16934",561,"201202.256.1190.4","NMFS",2012,4,11,102,20.02,41.938752,-67.094993,8,4,4,3,5,"HB",0.024
"16935",522,"201202.257.1200.5","NMFS",2012,4,11,102,20,41.724478,-67.72381,0,0,0,0,0,"HB",0.024
"16936",562,"201202.258.1190.8","NMFS",2012,4,11,102,20,41.56013,-67.518745,0,0,0,0,0,"HB",0.024
"16937",522,"201202.259.1190.2","NMFS",2012,4,11,102,20,41.407055,-67.808142,0,0,0,0,0,"HB",0.024
"16938",562,"201202.261.1190.3","NMFS",2012,4,12,103,20,41.383543,-67.469557,0,0,0,0,0,"HB",0.024
"16939",562,"201202.262.1190.10","NMFS",2012,4,12,103,19.12,41.328857,-67.546897,0,0,0,0,0,"HB",0.024
"16940",562,"201202.263.1190.1","NMFS",2012,4,12,103,20.02,41.2724,-67.398048,0,0,0,0,0,"HB",0.024
"16941",562,"201202.264.1130.6","NMFS",2012,4,12,103,20,41.174223,-67.340818,0,0,0,0,0,"HB",0.024
"16942",525,"201202.265.1130.2","NMFS",2012,4,12,103,20.02,41.002692,-67.220332,0,0,0,0,0,"HB",0.024
"16943",525,"201202.266.1130.4","NMFS",2012,4,12,103,20.02,40.970878,-67.762695,0,0,0,0,0,"HB",0.024
"16944",525,"201202.267.1130.7","NMFS",2012,4,12,103,20.02,40.85025,-67.813958,0,0,0,0,0,"HB",0.024
"16945",525,"201202.268.1130.8","NMFS",2012,4,12,103,20.02,40.863425,-68.130955,0,0,0,0,0,"HB",0.024
"16946",525,"201202.269.1130.5","NMFS",2012,4,12,103,20.03,40.819977,-68.138648,0,0,0,0,0,"HB",0.024
"16947",525,"201202.270.1130.3","NMFS",2012,4,12,103,20,40.659955,-67.985242,0,0,0,0,0,"HB",0.024
"16948",525,"201202.271.1140.2","NMFS",2012,4,13,104,20,40.541978,-67.443223,0,0,0,0,0,"HB",0.024
"16949",525,"201202.272.1150.2","NMFS",2012,4,13,104,20.02,40.591423,-67.08476,2,2,0,2,0,"HB",0.024
"16950",525,"201202.273.1150.3","NMFS",2012,4,13,104,20.02,40.660263,-66.926697,2,2,0,2,0,"HB",0.024
"16951",562,"201202.274.1180.2","NMFS",2012,4,13,104,20.02,40.811222,-66.689167,7,7,0,7,0,"HB",0.024
"16952",562,"201202.275.1160.8","NMFS",2012,4,13,104,20,41.02469,-66.57813,0,0,0,0,0,"HB",0.024
"16953",562,"201202.276.1180.1","NMFS",2012,4,13,104,20.02,40.963893,-66.482265,6,5,1,6,0,"HB",0.024
"16954",562,"201202.277.1170.1","NMFS",2012,4,13,104,20.25,41.03061,-66.4614,1,1,0,1,0,"HB",0.024
"16955",562,"201202.278.1170.2","NMFS",2012,4,13,104,20,41.070953,-66.454558,0,0,0,0,0,"HB",0.024
"16956",562,"201202.279.1160.11","NMFS",2012,4,13,104,20,41.256738,-66.998103,0,0,0,0,0,"HB",0.024
"16957",562,"201202.280.1160.10","NMFS",2012,4,14,105,20,41.329747,-66.93601,0,0,0,0,0,"HB",0.024
"16958",562,"201202.281.1160.9","NMFS",2012,4,14,105,20.02,41.242752,-66.699962,0,0,0,0,0,"HB",0.024
"16959",552,"201202.282.1180.3","NMFS",2012,4,14,105,20.02,41.217273,-66.249933,118,108,10,117,1,"HB",0.024
"16960",552,"201202.283.1170.3","NMFS",2012,4,14,105,20,41.401783,-66.102418,24,22,2,24,0,"HB",0.024
"16961",552,"201202.284.1160.3","NMFS",2012,4,14,105,20.02,41.801447,-65.947408,1,1,0,1,0,"HB",0.024
"16962",551,"201202.285.1170.4","NMFS",2012,4,14,105,19.98,41.840757,-65.891315,59,51,8,59,0,"HB",0.024
"16963",551,"201202.286.1180.4","NMFS",2012,4,14,105,20,42.000598,-65.856535,6,5,1,6,0,"HB",0.024
"16964",551,"201202.287.1160.2","NMFS",2012,4,14,105,20.02,41.99723,-66.519228,0,0,0,0,0,"HB",0.024
"16965",552,"201202.288.1160.12","NMFS",2012,4,14,105,20,41.818743,-66.482225,0,0,0,0,0,"HB",0.024
"16966",552,"201202.289.1160.5","NMFS",2012,4,15,106,20.02,41.765208,-66.755785,0,0,0,0,0,"HB",0.024
"16967",562,"201202.290.1160.1","NMFS",2012,4,15,106,20.02,41.62509,-66.756492,0,0,0,0,0,"HB",0.024
"16968",562,"201202.291.1160.4","NMFS",2012,4,15,106,20,41.657543,-66.960122,0,0,0,0,0,"HB",0.024
"16969",562,"201202.292.1190.6","NMFS",2012,4,15,106,20,41.766785,-67.10343,13,8,5,7,6,"HB",0.024
"16970",562,"201202.293.1160.6","NMFS",2012,4,15,106,20.02,41.808953,-66.947317,1,1,0,0,1,"HB",0.024
"16971",551,"201202.295.1160.7","NMFS",2012,4,15,106,20.02,41.902857,-66.807492,0,0,0,0,0,"HB",0.024
"16972",551,"201202.296.1210.4","NMFS",2012,4,15,106,20.02,42.120227,-66.95058,1,1,0,1,0,"HB",0.024
"16973",551,"201202.297.1220.4","NMFS",2012,4,15,106,20,42.204175,-66.893117,39,37,2,39,0,"HB",0.024
"16974",551,"201202.298.1210.3","NMFS",2012,4,15,106,20.02,42.115313,-66.791088,5,4,1,5,0,"HB",0.024
"16975",551,"201202.299.1220.5","NMFS",2012,4,15,106,20.02,42.174847,-66.651182,5,4,1,5,0,"HB",0.024
"16976",551,"201202.300.1220.3","NMFS",2012,4,15,106,20.02,42.176325,-66.582962,4,2,2,4,0,"HB",0.024
"16977",464,"201202.302.1290.2","NMFS",2012,4,16,107,20.02,42.413583,-66.093232,15,13,2,15,0,"HB",0.024
"16978",464,"201202.304.1290.7","NMFS",2012,4,16,107,20,42.593487,-66.771017,2,2,0,2,0,"HB",0.024
"16979",465,"201202.305.1340.5","NMFS",2012,4,16,107,20.02,43.052178,-66.783508,2,0,2,2,0,"HB",0.024
"16980",465,"201202.307.1340.7","NMFS",2012,4,16,107,20.02,43.46921,-66.81542,8,4,4,8,0,"HB",0.024
"16981",465,"201202.308.1340.1","NMFS",2012,4,16,107,20,43.54143,-66.785372,6,3,3,6,0,"HB",0.024
"16982",465,"201202.309.1340.3","NMFS",2012,4,17,108,20,43.622798,-67.00052,4,1,3,4,0,"HB",0.024
"16983",465,"201202.310.1340.2","NMFS",2012,4,17,108,20.02,43.690957,-66.908102,14,9,5,14,0,"HB",0.024
"16984",465,"201202.311.1340.4","NMFS",2012,4,17,108,20,43.734368,-67.134423,5,3,2,5,0,"HB",0.024
"16985",465,"201202.312.1360.1","NMFS",2012,4,17,108,20,43.764522,-67.384477,9,8,1,9,0,"HB",0.024
"16986",465,"201202.313.1360.6","NMFS",2012,4,17,108,20.02,43.673865,-67.548233,2,2,0,2,0,"HB",0.024
"16987",512,"201202.314.1360.7","NMFS",2012,4,17,108,20.02,43.525345,-67.715292,1,0,1,1,0,"HB",0.024
"16988",465,"201202.315.1360.5","NMFS",2012,4,17,108,20.02,43.397602,-67.5002,4,4,0,4,0,"HB",0.024
"16989",465,"201202.316.1360.8","NMFS",2012,4,17,108,20,43.298032,-67.462385,1,0,1,1,0,"HB",0.024
"16990",515,"201202.317.1360.2","NMFS",2012,4,18,109,20.02,43.12684,-67.948105,18,18,0,18,0,"HB",0.024
"16991",515,"201202.318.1370.3","NMFS",2012,4,18,109,20.02,42.918275,-68.694363,6,6,0,6,0,"HB",0.024
"16992",515,"201202.319.1370.4","NMFS",2012,4,18,109,19.98,42.813525,-68.731727,4,4,0,4,0,"HB",0.024
"16993",515,"201202.320.1280.4","NMFS",2012,4,18,109,20,42.640593,-68.633307,0,0,0,0,0,"HB",0.024
"16994",515,"201202.321.1280.7","NMFS",2012,4,18,109,20.02,42.459858,-68.843832,1,1,0,1,0,"HB",0.024
"16995",522,"201202.322.1240.3","NMFS",2012,4,18,109,20,42.221653,-68.714858,0,0,0,0,0,"HB",0.024
"16996",522,"201202.323.1240.8","NMFS",2012,4,19,110,20,42.172238,-68.753777,2,1,1,2,0,"HB",0.024
"16997",522,"201202.324.1240.4","NMFS",2012,4,19,110,20.02,41.979903,-68.698073,1,1,0,1,0,"HB",0.024
"16998",521,"201202.325.1240.2","NMFS",2012,4,19,110,20.02,42.064242,-68.946378,0,0,0,0,0,"HB",0.024
"16999",521,"201202.326.1240.5","NMFS",2012,4,19,110,20,42.110253,-69.189228,0,0,0,0,0,"HB",0.024
"17000",521,"201202.327.1280.1","NMFS",2012,4,19,110,20.02,42.22187,-69.397085,0,0,0,0,0,"HB",0.024
"17001",521,"201202.328.1280.5","NMFS",2012,4,19,110,20,42.199123,-69.57576,0,0,0,0,0,"HB",0.024
"17002",514,"201202.330.3590.2","NMFS",2012,4,25,116,20.02,41.863698,-70.455337,24,9,15,7,17,"HB",0.024
"17003",514,"201202.332.3600.4","NMFS",2012,4,25,116,20.02,41.884887,-70.355675,71,34,37,57,14,"HB",0.024
"17004",514,"201202.333.3590.3","NMFS",2012,4,25,116,20.02,41.862897,-70.251587,5,1,4,4,1,"HB",0.024
"17005",514,"201202.334.3600.1","NMFS",2012,4,25,116,20.02,41.948565,-70.241145,24,9,15,24,0,"HB",0.024
"17006",514,"201202.335.3600.3","NMFS",2012,4,25,116,20,41.957128,-70.429603,121,40,81,89,32,"HB",0.024
"17007",514,"201202.336.1260.3","NMFS",2012,4,25,116,20.02,42.11369,-70.324223,3,1,2,3,0,"HB",0.024
"17008",514,"201202.337.3610.1","NMFS",2012,4,25,116,20.02,42.06926,-70.276483,21,7,14,21,0,"HB",0.024
"17009",514,"201202.338.3610.3","NMFS",2012,4,25,116,20.02,42.14829,-70.132542,2,1,1,2,0,"HB",0.024
"17010",521,"201202.339.1270.5","NMFS",2012,4,25,116,20.02,42.198295,-69.87151,10,9,1,10,0,"HB",0.024
"17011",514,"201202.340.1270.1","NMFS",2012,4,25,116,20.02,42.34191,-70.016097,63,62,1,63,0,"HB",0.024
"17012",514,"201202.342.1260.12","NMFS",2012,4,26,117,20.13,42.21159,-70.241873,0,0,0,0,0,"HB",0.024
"17013",514,"201202.343.1260.6","NMFS",2012,4,26,117,20,42.283287,-70.24071,0,0,0,0,0,"HB",0.024
"17014",514,"201202.345.1260.13","NMFS",2012,4,26,117,20.02,42.403835,-70.343998,6,2,4,6,0,"HB",0.024
"17015",514,"201202.346.1260.9","NMFS",2012,4,26,117,20.05,42.261515,-70.487945,30,12,18,30,0,"HB",0.024
"17016",514,"201202.347.3590.1","NMFS",2012,4,26,117,20,42.125595,-70.560357,18,8,10,12,6,"HB",0.024
"17017",514,"201202.348.3640.2","NMFS",2012,4,26,117,20.02,42.412795,-70.790993,61,29,32,56,5,"HB",0.024
"17018",514,"201202.349.3640.3","NMFS",2012,4,26,117,19.98,42.404547,-70.813793,39,17,22,30,9,"HB",0.024
"17019",514,"201202.350.3660.1","NMFS",2012,4,26,117,20,42.391782,-70.728888,133,95,38,130,3,"HB",0.024
"17020",514,"201202.351.1260.8","NMFS",2012,4,26,117,20,42.488073,-70.49064,32,9,23,31,1,"HB",0.024
"17021",514,"201202.352.3650.2","NMFS",2012,4,27,118,20,42.589177,-70.592878,28,11,17,22,6,"HB",0.024
"17022",514,"201202.354.3660.4","NMFS",2012,4,27,118,20.02,42.622215,-70.506823,456,192,264,370,86,"HB",0.024
"17023",514,"201202.355.1260.10","NMFS",2012,4,27,118,20.02,42.668792,-70.320087,19,11,8,19,0,"HB",0.024
"17024",514,"201202.356.1260.2","NMFS",2012,4,27,118,20,42.669198,-70.214503,2,2,0,2,0,"HB",0.024
"17025",514,"201202.357.1260.11","NMFS",2012,4,27,118,20.02,42.789603,-70.353327,29,27,2,29,0,"HB",0.024
"17026",514,"201202.358.3660.2","NMFS",2012,4,27,118,20.02,42.723407,-70.559277,105,35,70,80,25,"HB",0.024
"17027",514,"201202.359.3650.1","NMFS",2012,4,27,118,20.05,42.781653,-70.682368,42,16,26,41,1,"HB",0.024
"17028",514,"201202.360.3640.1","NMFS",2012,4,27,118,20,42.763648,-70.746843,11,4,7,10,1,"HB",0.024
"17029",513,"201202.361.3650.3","NMFS",2012,4,27,118,20,42.847702,-70.693387,226,126,100,219,7,"HB",0.024
"17030",513,"201202.362.1400.5","NMFS",2012,4,28,119,20,42.956093,-70.422763,39,18,21,39,0,"HB",0.024
"17031",513,"201202.363.1270.4","NMFS",2012,4,28,119,20,42.840855,-70.096673,6,6,0,6,0,"HB",0.024
"17032",513,"201202.364.1270.6","NMFS",2012,4,28,119,20.02,42.990265,-69.969813,2,2,0,2,0,"HB",0.024
"17033",513,"201202.365.1260.7","NMFS",2012,4,28,119,20,43.1415,-70.058527,20,14,6,20,0,"HB",0.024
"17034",513,"201202.367.1270.8","NMFS",2012,4,28,119,20.02,43.123898,-70.141308,7,3,4,7,0,"HB",0.024
"17035",513,"201202.368.1400.6","NMFS",2012,4,28,119,20,43.139583,-70.323108,39,22,17,36,3,"HB",0.024
"17036",513,"201202.369.1400.2","NMFS",2012,4,28,119,20.02,43.218193,-70.185958,36,19,17,32,4,"HB",0.024
"17037",513,"201202.370.1270.9","NMFS",2012,4,29,120,20,43.269415,-70.11657,9,3,6,9,0,"HB",0.024
"17038",513,"201202.371.1270.10","NMFS",2012,4,29,120,20,43.247742,-70.03444,6,6,0,6,0,"HB",0.024
"17039",513,"201202.372.1270.3","NMFS",2012,4,29,120,20.02,43.251253,-70.022928,8,8,0,8,0,"HB",0.024
"17040",513,"201202.373.1400.3","NMFS",2012,4,29,120,20.02,43.394743,-70.121662,124,62,62,108,16,"HB",0.024
"17041",513,"201202.374.1380.4","NMFS",2012,4,29,120,20.02,43.387118,-69.820817,11,8,3,10,1,"HB",0.024
"17042",513,"201202.375.1380.1","NMFS",2012,4,29,120,20,43.407662,-69.378403,2,2,0,2,0,"HB",0.024
"17043",513,"201202.376.1400.4","NMFS",2012,4,30,121,20,43.701262,-69.52416,209,93,116,152,57,"HB",0.024
"17044",513,"201202.377.1400.7","NMFS",2012,4,30,121,20,43.743308,-69.47638,436,208,228,259,177,"HB",0.024
"17045",512,"201202.379.1390.3","NMFS",2012,4,30,121,20.02,43.932688,-68.502887,233,117,116,180,53,"HB",0.024
"17046",512,"201202.380.1390.2","NMFS",2012,4,30,121,20,43.928877,-68.493128,212,111,101,135,77,"HB",0.024
"17047",512,"201202.381.1390.1","NMFS",2012,4,30,121,20,43.938815,-68.447695,228,123,105,196,32,"HB",0.024
"17048",512,"201202.382.1390.8","NMFS",2012,4,30,121,20.02,43.959352,-68.353238,212,112,100,182,30,"HB",0.024
"17049",512,"201202.383.1380.2","NMFS",2012,5,1,122,20.02,43.938137,-68.104137,67,39,28,63,4,"HB",0.024
"17050",512,"201202.384.1380.9","NMFS",2012,5,1,122,20,43.91931,-68.07428,15,15,0,15,0,"HB",0.024
"17051",512,"201202.385.1390.9","NMFS",2012,5,1,122,20.02,44.105028,-68.079848,220,110,110,150,70,"HB",0.024
"17052",511,"201202.386.1380.8","NMFS",2012,5,1,122,20.92,44.299722,-67.374925,11,7,4,10,1,"HB",0.024
"17053",511,"201202.387.1351.2","NMFS",2012,5,1,122,20.02,44.282502,-67.181018,11,9,2,11,0,"HB",0.024
"17054",466,"201202.390.1351.3","NMFS",2012,5,1,122,20,44.136598,-66.7283,22,9,13,19,3,"HB",0.024
"17055",511,"201202.391.1351.5","NMFS",2012,5,2,123,20,44.178257,-67.121757,4,2,2,3,1,"HB",0.024
"17056",511,"201202.392.1340.6","NMFS",2012,5,2,123,20.02,44.147038,-67.27135,7,6,1,7,0,"HB",0.024
"17057",511,"201202.393.1360.3","NMFS",2012,5,2,123,20.03,44.051762,-67.552357,2,2,0,2,0,"HB",0.024
"17058",511,"201202.394.1380.7","NMFS",2012,5,2,123,20.02,44.01038,-67.72177,5,3,2,5,0,"HB",0.024
"17059",512,"201202.395.1380.6","NMFS",2012,5,2,123,20.02,43.659972,-68.255202,8,5,3,8,0,"HB",0.024
"17060",512,"201202.396.1380.5","NMFS",2012,5,2,123,20,43.366513,-68.571728,4,3,1,4,0,"HB",0.024
"17061",513,"201202.397.1370.2","NMFS",2012,5,3,124,20.03,43.19629,-69.102192,4,4,0,4,0,"HB",0.024
"17062",513,"201202.399.1370.7","NMFS",2012,5,3,124,16.63,43.167368,-69.597203,19,19,0,19,0,"HB",0.024
"17063",513,"201202.400.1370.6","NMFS",2012,5,3,124,20,43.024912,-69.596803,5,5,0,5,0,"HB",0.024
"17064",513,"201202.401.1370.1","NMFS",2012,5,3,124,20,42.842697,-69.446493,1,0,1,1,0,"HB",0.024
"17065",515,"201202.402.1280.6","NMFS",2012,5,3,124,20.02,42.628173,-69.39338,0,0,0,0,0,"HB",0.024
"17066",514,"201202.403.1280.3","NMFS",2012,5,3,124,20,42.633038,-69.892767,1,1,0,1,0,"HB",0.024
"17067",514,"201202.404.1270.2","NMFS",2012,5,4,125,20.02,42.525253,-69.918817,1,1,0,1,0,"HB",0.024
"17068",514,"201202.405.1270.7","NMFS",2012,5,4,125,20.02,42.548462,-70.024598,10,9,1,10,0,"HB",0.024
"17069",526,"201204.193.1090.1","NMFS",2012,10,1,275,20,40.89962,-69.778223,0,0,0,0,0,"HB",0.024
"17070",526,"201204.194.1090.3","NMFS",2012,10,1,275,20.02,40.682803,-69.584095,0,0,0,0,0,"HB",0.024
"17071",526,"201204.196.1090.6","NMFS",2012,10,1,275,20.02,40.732812,-69.246488,0,0,0,0,0,"HB",0.024
"17072",526,"201204.197.1090.5","NMFS",2012,10,1,275,20,40.969345,-69.344328,10,10,0,10,0,"HB",0.024
"17073",521,"201204.199.1230.7","NMFS",2012,10,1,275,20,41.152358,-69.160952,9,9,0,9,0,"HB",0.024
"17074",521,"201204.200.1230.3","NMFS",2012,10,1,275,19.97,41.175867,-68.982693,1,0,1,1,0,"HB",0.024
"17075",521,"201204.201.1230.5","NMFS",2012,10,1,275,20.02,41.264895,-69.247083,0,0,0,0,0,"HB",0.024
"17076",521,"201204.203.1250.1","NMFS",2012,10,2,276,20,41.333623,-69.456037,5,4,1,5,0,"HB",0.024
"17077",521,"201204.204.1250.2","NMFS",2012,10,2,276,18.35,41.37671,-69.391627,0,0,0,0,0,"HB",0.024
"17078",521,"201204.205.1250.3","NMFS",2012,10,2,276,20.02,41.409192,-69.51514,39,27,12,31,8,"HB",0.024
"17079",521,"201204.206.1240.4","NMFS",2012,10,2,276,20.02,41.647168,-69.353385,0,0,0,0,0,"HB",0.024
"17080",521,"201204.207.1230.1","NMFS",2012,10,2,276,20.02,41.776572,-69.820637,0,0,0,0,0,"HB",0.024
"17081",521,"201204.208.3560.3","NMFS",2012,10,2,276,19.95,41.763655,-69.895567,6,5,1,6,0,"HB",0.024
"17082",521,"201204.210.1280.3","NMFS",2012,10,3,277,20,42.03402,-69.67029,0,0,0,0,0,"HB",0.024
"17083",521,"201204.211.1280.5","NMFS",2012,10,3,277,20,42.09706,-69.367963,0,0,0,0,0,"HB",0.024
"17084",521,"201204.212.1280.7","NMFS",2012,10,3,277,19.98,42.008202,-69.529673,0,0,0,0,0,"HB",0.024
"17085",521,"201204.213.1240.1","NMFS",2012,10,3,277,20.02,41.89194,-69.530447,0,0,0,0,0,"HB",0.024
"17086",521,"201204.214.1240.3","NMFS",2012,10,3,277,20,41.856543,-68.967995,1,0,1,1,0,"HB",0.024
"17087",521,"201204.215.1240.5","NMFS",2012,10,3,277,20.02,41.614712,-69.146753,0,0,0,0,0,"HB",0.024
"17088",521,"201204.216.1240.7","NMFS",2012,10,3,277,19.95,41.540815,-69.08795,2,1,1,2,0,"HB",0.024
"17089",521,"201204.217.1240.6","NMFS",2012,10,3,277,19.97,41.435345,-68.98435,1,1,0,1,0,"HB",0.024
"17090",521,"201204.218.1240.8","NMFS",2012,10,3,277,20,41.370845,-68.995438,0,0,0,0,0,"HB",0.024
"17091",521,"201204.219.1230.6","NMFS",2012,10,3,277,20.02,41.288723,-68.847653,0,0,0,0,0,"HB",0.024
"17092",522,"201204.220.1200.6","NMFS",2012,10,4,278,20,41.252145,-68.480365,1,0,1,1,0,"HB",0.024
"17093",525,"201204.223.1190.6","NMFS",2012,10,4,278,17.03,40.884623,-68.234685,1,1,0,1,0,"HB",0.024
"17094",525,"201204.224.1190.1","NMFS",2012,10,4,278,20.02,40.713508,-68.582147,0,0,0,0,0,"HB",0.024
"17095",526,"201204.225.1100.6","NMFS",2012,10,4,278,20,40.584752,-68.892267,0,0,0,0,0,"HB",0.024
"17096",526,"201204.226.1100.1","NMFS",2012,10,4,278,19.97,40.50773,-68.91527,0,0,0,0,0,"HB",0.024
"17097",525,"201204.227.1130.6","NMFS",2012,10,4,278,19.95,40.407983,-68.810943,0,0,0,0,0,"HB",0.024
"17098",526,"201204.228.1100.5","NMFS",2012,10,4,278,20,40.39859,-68.942183,0,0,0,0,0,"HB",0.024
"17099",526,"201204.229.1100.3","NMFS",2012,10,4,278,20,40.429838,-69.23184,0,0,0,0,0,"HB",0.024
"17100",526,"201204.239.1110.4","NMFS",2012,10,12,286,19.97,40.020118,-69.903462,6,2,4,6,0,"HB",0.024
"17101",526,"201204.240.1120.2","NMFS",2012,10,12,286,20,39.930638,-69.479682,18,6,12,14,4,"HB",0.024
"17102",526,"201204.241.1120.1","NMFS",2012,10,12,286,20.02,39.938465,-69.371232,9,5,4,8,1,"HB",0.024
"17103",526,"201204.242.1120.3","NMFS",2012,10,12,286,19.98,39.951,-69.326855,11,0,11,8,3,"HB",0.024
"17104",526,"201204.243.1110.3","NMFS",2012,10,12,286,20,40.075168,-69.12916,1,1,0,1,0,"HB",0.024
"17105",526,"201204.244.1110.1","NMFS",2012,10,12,286,19.97,40.157575,-68.867323,0,0,0,0,0,"HB",0.024
"17106",526,"201204.245.1110.2","NMFS",2012,10,12,286,19.98,40.22646,-68.844563,0,0,0,0,0,"HB",0.024
"17107",525,"201204.246.1150.2","NMFS",2012,10,12,286,20.02,40.134447,-68.615925,0,0,0,0,0,"HB",0.024
"17108",525,"201204.247.1130.4","NMFS",2012,10,13,287,20.02,40.465945,-68.434213,2,2,0,2,0,"HB",0.024
"17109",525,"201204.248.1130.1","NMFS",2012,10,13,287,20,40.625343,-68.224517,0,0,0,0,0,"HB",0.024
"17110",525,"201204.249.1130.2","NMFS",2012,10,13,287,19.97,40.518528,-68.143512,0,0,0,0,0,"HB",0.024
"17111",525,"201204.250.1140.1","NMFS",2012,10,13,287,20.02,40.463842,-67.971698,1,1,0,1,0,"HB",0.024
"17112",525,"201204.251.1150.1","NMFS",2012,10,13,287,20.22,40.350888,-67.83013,1,1,0,1,0,"HB",0.024
"17113",525,"201204.252.1140.2","NMFS",2012,10,13,287,20,40.462433,-67.716678,0,0,0,0,0,"HB",0.024
"17114",525,"201204.253.1130.5","NMFS",2012,10,14,288,20,40.611245,-67.822048,2,1,1,2,0,"HB",0.024
"17115",525,"201204.254.1130.9","NMFS",2012,10,14,288,20,40.722567,-68.140875,0,0,0,0,0,"HB",0.024
"17116",525,"201204.255.1130.3","NMFS",2012,10,14,288,19.98,40.770408,-68.180793,0,0,0,0,0,"HB",0.024
"17117",525,"201204.256.1130.8","NMFS",2012,10,14,288,19.97,40.905758,-67.891818,0,0,0,0,0,"HB",0.024
"17118",525,"201204.258.1190.12","NMFS",2012,10,14,288,20.02,41.028083,-67.990787,2,2,0,2,0,"HB",0.024
"17119",525,"201204.259.1190.4","NMFS",2012,10,14,288,20,41.15116,-67.999803,0,0,0,0,0,"HB",0.024
"17120",525,"201204.260.1130.10","NMFS",2012,10,14,288,19.93,41.106323,-67.378702,1,1,0,1,0,"HB",0.024
"17121",525,"201204.261.1160.4","NMFS",2012,10,14,288,19.98,40.981832,-67.010175,2,2,0,2,0,"HB",0.024
"17122",525,"201204.262.1130.7","NMFS",2012,10,14,288,20,40.933885,-67.01115,1,1,0,1,0,"HB",0.024
"17123",525,"201204.263.1140.4","NMFS",2012,10,14,288,20.02,40.671092,-67.039033,1,1,0,1,0,"HB",0.024
"17124",525,"201204.264.1150.3","NMFS",2012,10,15,289,20,40.581168,-67.093778,1,0,1,1,0,"HB",0.024
"17125",525,"201204.265.1140.3","NMFS",2012,10,15,289,19.93,40.77076,-66.853017,2,2,0,2,0,"HB",0.024
"17126",562,"201204.266.1170.2","NMFS",2012,10,15,289,19.95,40.836408,-66.713952,0,0,0,0,0,"HB",0.024
"17127",562,"201204.267.1180.1","NMFS",2012,10,15,289,18.4,40.847945,-66.636377,22,17,5,21,1,"HB",0.024
"17128",562,"201204.269.1160.1","NMFS",2012,10,15,289,19.95,40.967888,-66.58152,14,13,1,14,0,"HB",0.024
"17129",562,"201204.270.1170.1","NMFS",2012,10,15,289,20.03,41.038448,-66.472647,2,2,0,2,0,"HB",0.024
"17130",562,"201204.271.1180.5","NMFS",2012,10,15,289,20.02,41.038155,-66.410017,7,6,1,7,0,"HB",0.024
"17131",552,"201204.272.1170.3","NMFS",2012,10,15,289,20,41.210863,-66.311285,2,1,1,2,0,"HB",0.024
"17132",552,"201204.273.1160.2","NMFS",2012,10,16,290,20,41.252115,-66.345128,3,3,0,3,0,"HB",0.024
"17133",562,"201204.274.1160.8","NMFS",2012,10,16,290,20.02,41.345348,-66.505413,0,0,0,0,0,"HB",0.024
"17134",562,"201204.275.1160.7","NMFS",2012,10,16,290,19.95,41.373127,-66.831,5,5,0,5,0,"HB",0.024
"17135",562,"201204.276.1160.13","NMFS",2012,10,16,290,20,41.451675,-66.850572,1,1,0,1,0,"HB",0.024
"17136",562,"201204.277.1160.5","NMFS",2012,10,16,290,20,41.576143,-67.05978,0,0,0,0,0,"HB",0.024
"17137",562,"201204.278.1160.6","NMFS",2012,10,16,290,20,41.513367,-66.84164,0,0,0,0,0,"HB",0.024
"17138",552,"201204.280.1160.14","NMFS",2012,10,16,290,20.02,41.573188,-66.60007,18,18,0,18,0,"HB",0.024
"17139",552,"201204.281.1170.4","NMFS",2012,10,16,290,20,41.54225,-65.993032,3,3,0,3,0,"HB",0.024
"17140",551,"201204.284.1160.9","NMFS",2012,10,17,291,19.95,41.85204,-66.039092,6,6,0,6,0,"HB",0.024
"17141",464,"201204.289.1290.14","NMFS",2012,10,17,291,19.93,42.45532,-66.342135,3,2,1,3,0,"HB",0.024
"17142",551,"201204.292.1300.2","NMFS",2012,10,18,292,20,42.311612,-66.652117,3,3,0,3,0,"HB",0.024
"17143",551,"201204.293.1220.4","NMFS",2012,10,18,292,19.97,42.189787,-66.669508,20,19,1,20,0,"HB",0.024
"17144",551,"201204.294.1220.3","NMFS",2012,10,18,292,19.97,42.169515,-66.586525,13,11,2,13,0,"HB",0.024
"17145",551,"201204.295.1210.4","NMFS",2012,10,18,292,20,42.090987,-66.701013,11,10,1,11,0,"HB",0.024
"17146",551,"201204.296.1160.3","NMFS",2012,10,18,292,20.02,41.947028,-66.818288,6,5,1,5,1,"HB",0.024
"17147",551,"201204.297.1160.12","NMFS",2012,10,18,292,20.02,41.971305,-66.978705,6,6,0,6,0,"HB",0.024
"17148",551,"201204.298.1160.10","NMFS",2012,10,18,292,20.02,42.06638,-67.00347,6,5,1,5,1,"HB",0.024
"17149",551,"201204.299.1210.3","NMFS",2012,10,18,292,18.32,42.117308,-67.029733,12,12,0,12,0,"HB",0.024
"17150",551,"201204.300.1290.15","NMFS",2012,10,18,292,20,42.264745,-67.071545,7,7,0,7,0,"HB",0.024
"17151",464,"201204.301.1300.3","NMFS",2012,10,18,292,20.02,42.428265,-66.980237,4,4,0,4,0,"HB",0.024
"17152",464,"201204.302.1300.1","NMFS",2012,10,19,293,20.02,42.499752,-67.04575,9,7,2,9,0,"HB",0.024
"17153",464,"201204.304.1290.11","NMFS",2012,10,19,293,19.97,42.559213,-66.939705,7,6,1,7,0,"HB",0.024
"17154",464,"201204.305.1290.5","NMFS",2012,10,19,293,20.02,42.657092,-67.509995,1,1,0,1,0,"HB",0.024
"17155",515,"201204.306.1290.8","NMFS",2012,10,19,293,20.02,42.594533,-67.893375,0,0,0,0,0,"HB",0.024
"17156",561,"201204.307.1290.1","NMFS",2012,10,19,293,19.97,42.315433,-67.629078,0,0,0,0,0,"HB",0.024
"17157",561,"201204.308.1220.2","NMFS",2012,10,19,293,19.95,42.156597,-67.550562,3,3,0,3,0,"HB",0.024
"17158",561,"201204.309.1220.1","NMFS",2012,10,19,293,20.02,42.098443,-67.646193,7,5,2,5,2,"HB",0.024
"17159",561,"201204.310.1210.2","NMFS",2012,10,19,293,20.02,42.036948,-67.589755,18,16,2,18,0,"HB",0.024
"17160",562,"201204.311.1190.7","NMFS",2012,10,20,294,20,41.801825,-67.40904,1,1,0,0,1,"HB",0.024
"17161",561,"201204.312.1200.7","NMFS",2012,10,20,294,19.95,41.946118,-67.48238,0,0,0,0,0,"HB",0.024
"17162",522,"201204.313.1200.1","NMFS",2012,10,20,294,19.93,41.80924,-67.722517,2,1,1,2,0,"HB",0.024
"17163",562,"201204.315.1190.10","NMFS",2012,10,20,294,20,41.659827,-67.641258,0,0,0,0,0,"HB",0.024
"17164",522,"201204.316.1190.5","NMFS",2012,10,20,294,20.02,41.53545,-67.731292,1,1,0,1,0,"HB",0.024
"17165",522,"201204.317.1200.4","NMFS",2012,10,20,294,19.95,41.563565,-67.975673,0,0,0,0,0,"HB",0.024
"17166",522,"201204.318.1190.2","NMFS",2012,10,20,294,20,41.41062,-67.934272,0,0,0,0,0,"HB",0.024
"17167",522,"201204.319.1200.3","NMFS",2012,10,20,294,20,41.424897,-68.285692,3,1,2,2,1,"HB",0.024
"17168",522,"201204.320.1230.2","NMFS",2012,10,21,295,20,41.48114,-68.523697,22,22,0,22,0,"HB",0.024
"17169",522,"201204.321.1200.5","NMFS",2012,10,21,295,19.95,41.735252,-68.199465,8,6,2,6,2,"HB",0.024
"17170",522,"201204.322.1210.1","NMFS",2012,10,21,295,19.97,41.770763,-68.281438,0,0,0,0,0,"HB",0.024
"17171",522,"201204.323.1240.2","NMFS",2012,10,21,295,20,41.948298,-68.40573,0,0,0,0,0,"HB",0.024
"17172",515,"201204.324.1290.4","NMFS",2012,10,21,295,20.02,42.407342,-68.151358,0,0,0,0,0,"HB",0.024
"17173",515,"201204.325.1290.2","NMFS",2012,10,21,295,19.95,42.46429,-68.38664,0,0,0,0,0,"HB",0.024
"17174",515,"201204.326.1290.7","NMFS",2012,10,21,295,20,42.51559,-68.371425,0,0,0,0,0,"HB",0.024
"17175",515,"201204.327.1360.1","NMFS",2012,10,22,296,20.02,43.217882,-67.69074,1,1,0,1,0,"HB",0.024
"17176",515,"201204.328.1360.6","NMFS",2012,10,22,296,19.97,43.24969,-67.881613,1,1,0,1,0,"HB",0.024
"17177",512,"201204.329.1360.9","NMFS",2012,10,22,296,19.98,43.369782,-67.884715,0,0,0,0,0,"HB",0.024
"17178",465,"201204.330.1360.3","NMFS",2012,10,22,296,20.02,43.39872,-67.538978,6,6,0,6,0,"HB",0.024
"17179",465,"201204.331.1360.4","NMFS",2012,10,22,296,20,43.20906,-67.289777,4,4,0,4,0,"HB",0.024
"17180",465,"201204.332.1360.2","NMFS",2012,10,22,296,19.95,43.030278,-67.222282,13,11,2,13,0,"HB",0.024
"17181",465,"201204.333.1340.2","NMFS",2012,10,22,296,20.02,43.438568,-66.719632,14,10,4,14,0,"HB",0.024
"17182",465,"201204.334.1340.1","NMFS",2012,10,22,296,20.02,43.519963,-66.742807,6,6,0,6,0,"HB",0.024
"17183",465,"201204.335.1340.5","NMFS",2012,10,23,297,20,43.77135,-66.892795,24,18,6,24,0,"HB",0.024
"17184",465,"201204.336.1340.7","NMFS",2012,10,23,297,19.97,43.806632,-67.078285,7,7,0,7,0,"HB",0.024
"17185",511,"201204.339.1340.3","NMFS",2012,10,23,297,19.98,43.914775,-67.112258,1,1,0,1,0,"HB",0.024
"17186",511,"201204.340.1340.4","NMFS",2012,10,23,297,20.02,44.007198,-67.1697,1,0,1,1,0,"HB",0.024
"17187",511,"201204.341.1351.4","NMFS",2012,10,23,297,19.98,44.169785,-67.135953,2,0,2,2,0,"HB",0.024
"17188",511,"201204.342.1351.2","NMFS",2012,10,23,297,20.02,44.187667,-67.084232,4,3,1,4,0,"HB",0.024
"17189",511,"201204.343.1351.1","NMFS",2012,10,23,297,20,44.181337,-66.888357,5,2,3,5,0,"HB",0.024
"17190",511,"201204.344.1351.3","NMFS",2012,10,23,297,20.02,44.25568,-66.880897,0,0,0,0,0,"HB",0.024
"17191",511,"201204.345.1390.1","NMFS",2012,10,24,298,20,44.328467,-67.523233,71,39,32,62,9,"HB",0.024
"17192",511,"201204.346.1390.5","NMFS",2012,10,24,298,20,44.251053,-67.679032,32,23,9,32,0,"HB",0.024
"17193",511,"201204.347.1360.5","NMFS",2012,10,24,298,19.97,44.0444,-67.557813,4,2,2,4,0,"HB",0.024
"17194",465,"201204.348.1360.8","NMFS",2012,10,24,298,20,43.655733,-67.519252,8,8,0,8,0,"HB",0.024
"17195",512,"201204.349.1360.7","NMFS",2012,10,24,298,20,43.682447,-67.788722,2,2,0,2,0,"HB",0.024
"17196",512,"201204.350.1390.4","NMFS",2012,10,25,299,20,43.884742,-68.395033,140,109,31,140,0,"HB",0.024
"17197",512,"201204.351.1380.7","NMFS",2012,10,25,299,18.43,43.797773,-68.359853,8,5,3,8,0,"HB",0.024
"17198",512,"201204.352.1380.5","NMFS",2012,10,25,299,20.02,43.359265,-68.297853,0,0,0,0,0,"HB",0.024
"17199",513,"201204.353.1370.6","NMFS",2012,10,25,299,20.02,43.28206,-69.016792,0,0,0,0,0,"HB",0.024
"17200",514,"201204.356.3590.2","NMFS",2012,11,2,307,20.02,41.842222,-70.369097,30,12,18,13,17,"HB",0.024
"17201",514,"201204.357.3600.2","NMFS",2012,11,2,307,20,41.950803,-70.288577,134,58,76,119,15,"HB",0.024
"17202",514,"201204.358.3600.3","NMFS",2012,11,2,307,19.95,41.9551,-70.18073,14,5,9,13,1,"HB",0.024
"17203",514,"201204.360.3610.1","NMFS",2012,11,2,307,20.02,41.995568,-70.386698,161,73,88,141,20,"HB",0.024
"17204",514,"201204.361.3610.3","NMFS",2012,11,2,307,20,42.017198,-70.424078,147,77,70,124,23,"HB",0.024
"17205",514,"201204.362.1260.2","NMFS",2012,11,2,307,20,42.237142,-70.235583,4,4,0,4,0,"HB",0.024
"17206",514,"201204.363.1260.6","NMFS",2012,11,2,307,20,42.197837,-70.176155,34,31,3,34,0,"HB",0.024
"17207",514,"201204.366.1280.2","NMFS",2012,11,2,307,20,42.498243,-69.676898,0,0,0,0,0,"HB",0.024
"17208",514,"201204.367.1270.5","NMFS",2012,11,2,307,20,42.581205,-69.986355,0,0,0,0,0,"HB",0.024
"17209",514,"201204.368.1270.2","NMFS",2012,11,3,308,20.02,42.819697,-70.021053,2,2,0,2,0,"HB",0.024
"17210",513,"201204.369.1370.3","NMFS",2012,11,3,308,19.95,42.910835,-69.603442,2,2,0,2,0,"HB",0.024
"17211",515,"201204.370.1280.1","NMFS",2012,11,3,308,20,42.758872,-69.607803,1,1,0,1,0,"HB",0.024
"17212",515,"201204.371.1370.4","NMFS",2012,11,3,308,20,42.781863,-69.500862,1,1,0,1,0,"HB",0.024
"17213",515,"201204.372.1280.6","NMFS",2012,11,3,308,20.02,42.62476,-69.255502,0,0,0,0,0,"HB",0.024
"17214",515,"201204.373.1280.4","NMFS",2012,11,3,308,19.95,42.571383,-68.706945,0,0,0,0,0,"HB",0.024
"17215",515,"201204.374.1370.8","NMFS",2012,11,3,308,20,42.823525,-68.848148,0,0,0,0,0,"HB",0.024
"17216",515,"201204.375.1370.7","NMFS",2012,11,4,309,20,42.920857,-68.746023,0,0,0,0,0,"HB",0.024
"17217",515,"201204.376.1370.5","NMFS",2012,11,4,309,19.95,42.91828,-68.693573,0,0,0,0,0,"HB",0.024
"17218",515,"201204.377.1370.1","NMFS",2012,11,4,309,19.97,43.086602,-68.650162,0,0,0,0,0,"HB",0.024
"17219",512,"201204.378.1380.1","NMFS",2012,11,4,309,20,43.397808,-68.761468,44,31,13,29,15,"HB",0.024
"17220",512,"201204.379.1380.3","NMFS",2012,11,4,309,20.02,43.476887,-68.731183,11,10,1,11,0,"HB",0.024
"17221",512,"201204.380.1380.6","NMFS",2012,11,4,309,19.95,43.639495,-68.482115,17,16,1,17,0,"HB",0.024
"17222",512,"201204.381.1380.8","NMFS",2012,11,4,309,20,43.645743,-68.49175,18,14,4,18,0,"HB",0.024
"17223",512,"201204.382.1380.2","NMFS",2012,11,5,310,20,43.561167,-68.81263,27,24,3,27,0,"HB",0.024
"17224",513,"201204.383.1400.3","NMFS",2012,11,5,310,20,43.56421,-69.782353,146,81,65,135,11,"HB",0.024
"17225",513,"201204.384.1400.2","NMFS",2012,11,5,310,20,43.51264,-69.925603,35,27,8,35,0,"HB",0.024
"17226",513,"201204.385.1380.4","NMFS",2012,11,5,310,19.97,43.383867,-69.824108,13,13,0,12,1,"HB",0.024
"17227",513,"201204.386.1270.4","NMFS",2012,11,5,310,19.85,43.181327,-70.05701,1,1,0,1,0,"HB",0.024
"17228",513,"201204.387.1270.3","NMFS",2012,11,5,310,20.02,43.266937,-70.169172,21,16,5,20,1,"HB",0.024
"17229",513,"201204.388.1400.1","NMFS",2012,11,6,311,20,43.132537,-70.356022,169,78,91,148,21,"HB",0.024
"17230",513,"201204.389.1270.1","NMFS",2012,11,6,311,20,43.01809,-70.217795,6,1,5,4,2,"HB",0.024
"17231",513,"201204.390.3650.2","NMFS",2012,11,6,311,19.65,42.857322,-70.719167,361,184,177,316,45,"HB",0.024
"17232",514,"201204.392.3640.5","NMFS",2012,11,6,311,20,42.7918,-70.740178,34,19,15,32,2,"HB",0.024
"17233",514,"201204.393.3640.2","NMFS",2012,11,6,311,20.02,42.72489,-70.683048,18,10,8,13,5,"HB",0.024
"17234",514,"201204.394.3650.5","NMFS",2012,11,6,311,19.6,42.751592,-70.652797,204,110,94,186,18,"HB",0.024
"17235",514,"201204.395.3560.2","NMFS",2012,11,7,312,19.98,42.072705,-70.084458,2,0,2,2,0,"HB",0.024
"17236",514,"201204.396.1260.1","NMFS",2012,11,7,312,20.02,42.294762,-70.37077,5,2,3,5,0,"HB",0.024
"17237",514,"201204.397.3660.2","NMFS",2012,11,7,312,20,42.26308,-70.537018,26,13,13,23,3,"HB",0.024
"17238",514,"201204.398.3660.3","NMFS",2012,11,7,312,20,42.325883,-70.638475,38,16,22,33,5,"HB",0.024
"17239",514,"201204.399.3640.3","NMFS",2012,11,7,312,20,42.40295,-70.837243,278,165,113,224,54,"HB",0.024
"17240",514,"201204.400.3610.2","NMFS",2012,11,9,314,20,42.085055,-70.485913,79,59,20,74,5,"HB",0.024
"17241",514,"201204.402.3590.4","NMFS",2012,11,9,314,20,41.969978,-70.548132,169,85,84,74,95,"HB",0.024
"17242",514,"201204.403.3590.1","NMFS",2012,11,10,315,20.02,42.106242,-70.574762,57,33,24,47,10,"HB",0.024
"17243",514,"201204.404.3660.1","NMFS",2012,11,10,315,20,42.305623,-70.627605,139,72,67,117,22,"HB",0.024
"17244",514,"201204.405.3650.4","NMFS",2012,11,10,315,19.95,42.463545,-70.777565,466,263,203,373,93,"HB",0.024
"17245",514,"201204.406.1260.8","NMFS",2012,11,10,315,20,42.482977,-70.483625,33,22,11,30,3,"HB",0.024
"17246",514,"201204.407.1260.3","NMFS",2012,11,10,315,20.02,42.593512,-70.300608,2,1,1,2,0,"HB",0.024
"17247",514,"201204.408.1260.4","NMFS",2012,11,10,315,20.02,42.423812,-70.400743,3,2,1,3,0,"HB",0.024
"17248",526,"201302.190.1100.3","NMFS",2013,4,3,93,20.02,40.112153,-69.837007,0,0,0,0,0,"HB",0.024
"17249",526,"201302.191.1110.3","NMFS",2013,4,3,93,20.02,39.994713,-69.540493,0,0,0,0,0,"HB",0.024
"17250",526,"201302.192.1110.1","NMFS",2013,4,3,93,20,40.011722,-69.288423,2,1,1,2,0,"HB",0.024
"17251",526,"201302.193.1120.1","NMFS",2013,4,3,93,20.02,40.02891,-69.11708,1,0,1,1,0,"HB",0.024
"17252",526,"201302.194.1120.3","NMFS",2013,4,3,93,20.02,40.054173,-68.935647,0,0,0,0,0,"HB",0.024
"17253",526,"201302.195.1110.4","NMFS",2013,4,3,93,20,40.146168,-68.937652,0,0,0,0,0,"HB",0.024
"17254",526,"201302.196.1100.8","NMFS",2013,4,3,93,20.02,40.363773,-69.01734,0,0,0,0,0,"HB",0.024
"17255",526,"201302.197.1100.7","NMFS",2013,4,4,94,20,40.26332,-69.399095,0,0,0,0,0,"HB",0.024
"17256",526,"201302.198.1100.6","NMFS",2013,4,4,94,20,40.372493,-69.559805,0,0,0,0,0,"HB",0.024
"17257",526,"201302.199.1090.2","NMFS",2013,4,4,94,20.02,40.584605,-69.480822,0,0,0,0,0,"HB",0.024
"17258",526,"201302.200.1090.3","NMFS",2013,4,4,94,20.02,40.727958,-69.679795,0,0,0,0,0,"HB",0.024
"17259",526,"201302.201.1100.9","NMFS",2013,4,4,94,20.37,40.59718,-69.11953,0,0,0,0,0,"HB",0.024
"17260",526,"201302.202.1100.5","NMFS",2013,4,4,94,20.02,40.736792,-69.217127,0,0,0,0,0,"HB",0.024
"17261",526,"201302.203.1100.4","NMFS",2013,4,4,94,20,40.824715,-69.162675,0,0,0,0,0,"HB",0.024
"17262",521,"201302.206.1250.3","NMFS",2013,4,10,100,20,41.131313,-69.289582,0,0,0,0,0,"HB",0.024
"17263",521,"201302.207.1230.5","NMFS",2013,4,10,100,20,41.22403,-69.180085,0,0,0,0,0,"HB",0.024
"17264",521,"201302.208.1230.6","NMFS",2013,4,10,100,20,41.096055,-68.971155,0,0,0,0,0,"HB",0.024
"17265",521,"201302.209.1240.4","NMFS",2013,4,10,100,20,41.260358,-69.023085,7,5,2,7,0,"HB",0.024
"17266",521,"201302.210.1240.5","NMFS",2013,4,10,100,20,41.361035,-68.969352,1,0,1,1,0,"HB",0.024
"17267",521,"201302.211.1230.3","NMFS",2013,4,10,100,20.02,41.454278,-69.28315,0,0,0,0,0,"HB",0.024
"17268",521,"201302.212.1250.4","NMFS",2013,4,11,101,20,41.288002,-69.388593,0,0,0,0,0,"HB",0.024
"17269",521,"201302.213.1250.1","NMFS",2013,4,11,101,20,41.333058,-69.45634,0,0,0,0,0,"HB",0.024
"17270",521,"201302.214.1230.7","NMFS",2013,4,11,101,19.98,41.592068,-69.558185,0,0,0,0,0,"HB",0.024
"17271",521,"201302.215.1250.5","NMFS",2013,4,11,101,20,41.633865,-69.736432,0,0,0,0,0,"HB",0.024
"17272",521,"201302.218.1230.8","NMFS",2013,4,11,101,20.02,41.90631,-69.80113,2,2,0,2,0,"HB",0.024
"17273",521,"201302.219.1280.3","NMFS",2013,4,11,101,20.02,42.094215,-69.383063,0,0,0,0,0,"HB",0.024
"17274",521,"201302.220.1280.1","NMFS",2013,4,11,101,20,41.923018,-69.326913,0,0,0,0,0,"HB",0.024
"17275",521,"201302.221.1240.3","NMFS",2013,4,12,102,20.02,41.83271,-69.338313,0,0,0,0,0,"HB",0.024
"17276",521,"201302.222.1240.6","NMFS",2013,4,12,102,20,41.678168,-69.052152,3,3,0,3,0,"HB",0.024
"17277",522,"201302.223.1240.2","NMFS",2013,4,12,102,20.02,41.53996,-68.79464,2,1,1,2,0,"HB",0.024
"17278",522,"201302.224.1240.7","NMFS",2013,4,12,102,20,41.441877,-68.754743,0,0,0,0,0,"HB",0.024
"17279",522,"201302.226.1240.9","NMFS",2013,4,12,102,20.02,41.543132,-68.658875,0,0,0,0,0,"HB",0.024
"17280",522,"201302.227.1230.4","NMFS",2013,4,12,102,20,41.410013,-68.520857,0,0,0,0,0,"HB",0.024
"17281",522,"201302.228.1200.1","NMFS",2013,4,12,102,20.02,41.46266,-68.305447,0,0,0,0,0,"HB",0.024
"17282",522,"201302.229.1200.2","NMFS",2013,4,12,102,20,41.42031,-68.309698,0,0,0,0,0,"HB",0.024
"17283",522,"201302.230.1190.3","NMFS",2013,4,13,103,20.02,41.055972,-68.511052,6,4,2,3,3,"HB",0.024
"17284",522,"201302.231.1230.2","NMFS",2013,4,13,103,20,41.0253,-68.689057,1,0,1,0,1,"HB",0.024
"17285",522,"201302.232.1230.1","NMFS",2013,4,13,103,20,41.021043,-68.761503,0,0,0,0,0,"HB",0.024
"17286",525,"201302.233.1130.9","NMFS",2013,4,13,103,20,40.821867,-68.739573,2,1,1,1,1,"HB",0.024
"17287",525,"201302.234.1130.11","NMFS",2013,4,13,103,19.98,40.746853,-68.625515,0,0,0,0,0,"HB",0.024
"17288",525,"201302.235.1130.10","NMFS",2013,4,13,103,20,40.650988,-68.719183,1,1,0,1,0,"HB",0.024
"17289",525,"201302.236.1130.12","NMFS",2013,4,13,103,20.02,40.554838,-68.340042,0,0,0,0,0,"HB",0.024
"17290",525,"201302.237.1130.5","NMFS",2013,4,13,103,20,40.580933,-68.118643,0,0,0,0,0,"HB",0.024
"17291",525,"201302.238.1130.2","NMFS",2013,4,14,104,20,40.55714,-67.948595,0,0,0,0,0,"HB",0.024
"17292",525,"201302.239.1140.3","NMFS",2013,4,14,104,20.02,40.401238,-67.963652,0,0,0,0,0,"HB",0.024
"17293",525,"201302.240.1150.2","NMFS",2013,4,14,104,20,40.319107,-67.909622,0,0,0,0,0,"HB",0.024
"17294",525,"201302.241.1150.1","NMFS",2013,4,14,104,20.02,40.404008,-67.8672,0,0,0,0,0,"HB",0.024
"17295",525,"201302.242.1130.14","NMFS",2013,4,14,104,20.02,40.576873,-67.769642,0,0,0,0,0,"HB",0.024
"17296",525,"201302.243.1150.3","NMFS",2013,4,14,104,20.02,40.44804,-67.329557,3,3,0,3,0,"HB",0.024
"17297",525,"201302.244.1130.1","NMFS",2013,4,14,104,20,40.686563,-67.494475,0,0,0,0,0,"HB",0.024
"17298",525,"201302.245.1130.13","NMFS",2013,4,14,104,20,40.830513,-67.836953,0,0,0,0,0,"HB",0.024
"17299",525,"201302.246.1130.4","NMFS",2013,4,14,104,20,40.907562,-67.940462,0,0,0,0,0,"HB",0.024
"17300",525,"201302.247.1190.8","NMFS",2013,4,14,104,20.02,40.98127,-67.806448,0,0,0,0,0,"HB",0.024
"17301",525,"201302.248.1190.2","NMFS",2013,4,15,105,20.02,41.056253,-67.680033,0,0,0,0,0,"HB",0.024
"17302",525,"201302.249.1130.6","NMFS",2013,4,15,105,20.02,41.163472,-67.329392,0,0,0,0,0,"HB",0.024
"17303",525,"201302.251.1130.8","NMFS",2013,4,15,105,20,40.823742,-67.240982,0,0,0,0,0,"HB",0.024
"17304",525,"201302.252.1140.4","NMFS",2013,4,15,105,20,40.65459,-67.123423,0,0,0,0,0,"HB",0.024
"17305",525,"201302.253.1140.2","NMFS",2013,4,15,105,20,40.68785,-67.074217,1,1,0,1,0,"HB",0.024
"17306",525,"201302.254.1130.7","NMFS",2013,4,15,105,20.02,40.827792,-67.037652,0,0,0,0,0,"HB",0.024
"17307",562,"201302.255.1130.15","NMFS",2013,4,15,105,20,40.89885,-66.96509,0,0,0,0,0,"HB",0.024
"17308",525,"201302.256.1140.1","NMFS",2013,4,15,105,20.02,40.774603,-66.861443,0,0,0,0,0,"HB",0.024
"17309",562,"201302.257.1180.3","NMFS",2013,4,15,105,20,40.786245,-66.746572,0,0,0,0,0,"HB",0.024
"17310",562,"201302.258.1180.2","NMFS",2013,4,15,105,20.02,40.932938,-66.532525,2,2,0,2,0,"HB",0.024
"17311",562,"201302.259.1170.2","NMFS",2013,4,16,106,20.02,40.982897,-66.526932,0,0,0,0,0,"HB",0.024
"17312",562,"201302.260.1170.1","NMFS",2013,4,16,106,20.02,41.016063,-66.461082,1,1,0,1,0,"HB",0.024
"17313",562,"201302.261.1160.11","NMFS",2013,4,16,106,20,41.20485,-66.533208,0,0,0,0,0,"HB",0.024
"17314",562,"201302.262.1160.9","NMFS",2013,4,16,106,20,41.3044,-66.733333,0,0,0,0,0,"HB",0.024
"17315",562,"201302.263.1190.10","NMFS",2013,4,16,106,20,41.568692,-67.114068,0,0,0,0,0,"HB",0.024
"17316",562,"201302.265.1160.14","NMFS",2013,4,16,106,20,41.544127,-66.97262,0,0,0,0,0,"HB",0.024
"17317",552,"201302.266.1160.2","NMFS",2013,4,16,106,20,41.440198,-66.544357,0,0,0,0,0,"HB",0.024
"17318",552,"201302.267.1160.6","NMFS",2013,4,16,106,20.02,41.417183,-66.47985,0,0,0,0,0,"HB",0.024
"17319",552,"201302.268.1160.3","NMFS",2013,4,16,106,20,41.33978,-66.399698,19,19,0,19,0,"HB",0.024
"17320",552,"201302.269.1170.3","NMFS",2013,4,16,106,20.02,41.428015,-66.15355,2,1,1,2,0,"HB",0.024
"17321",552,"201302.270.1180.5","NMFS",2013,4,17,107,20.02,41.374522,-66.052682,19,16,3,19,0,"HB",0.024
"17322",552,"201302.271.1170.5","NMFS",2013,4,17,107,20,41.512143,-66.040658,2,1,1,2,0,"HB",0.024
"17323",552,"201302.272.1160.8","NMFS",2013,4,17,107,20.02,41.616505,-66.189933,5,5,0,5,0,"HB",0.024
"17324",552,"201302.273.1160.13","NMFS",2013,4,17,107,20,41.65322,-66.03169,3,3,0,3,0,"HB",0.024
"17325",551,"201302.278.1170.4","NMFS",2013,4,17,107,20,41.848343,-65.844895,3,2,1,3,0,"HB",0.024
"17326",551,"201302.280.1160.12","NMFS",2013,4,18,108,20.02,41.873887,-66.400823,7,3,4,7,0,"HB",0.024
"17327",551,"201302.281.1160.1","NMFS",2013,4,18,108,20,41.983167,-66.16372,0,0,0,0,0,"HB",0.024
"17328",551,"201302.282.1180.9","NMFS",2013,4,18,108,20,42.046925,-65.909647,15,13,2,15,0,"HB",0.024
"17329",551,"201302.284.1290.10","NMFS",2013,4,18,108,20,42.181617,-66.071583,53,50,3,53,0,"HB",0.024
"17330",464,"201302.285.1290.2","NMFS",2013,4,18,108,20.02,42.370855,-65.922808,2,1,1,2,0,"HB",0.024
"17331",551,"201302.286.1220.2","NMFS",2013,4,18,108,20,42.172085,-66.383148,3,3,0,3,0,"HB",0.024
"17332",551,"201302.287.1220.1","NMFS",2013,4,18,108,20,42.152083,-66.41987,4,2,2,4,0,"HB",0.024
"17333",551,"201302.289.1210.5","NMFS",2013,4,19,109,20,42.094213,-66.889537,0,0,0,0,0,"HB",0.024
"17334",551,"201302.290.1210.4","NMFS",2013,4,19,109,20.02,42.087748,-66.908912,0,0,0,0,0,"HB",0.024
"17335",551,"201302.291.1160.5","NMFS",2013,4,19,109,20,41.99176,-66.800957,0,0,0,0,0,"HB",0.024
"17336",551,"201302.292.1160.7","NMFS",2013,4,19,109,20.02,41.97072,-66.97093,4,2,2,3,1,"HB",0.024
"17337",522,"201302.293.1210.3","NMFS",2013,4,20,110,20.02,41.93313,-67.945997,0,0,0,0,0,"HB",0.024
"17338",522,"201302.294.1210.1","NMFS",2013,4,20,110,20,41.845567,-68.063157,0,0,0,0,0,"HB",0.024
"17339",522,"201302.297.1200.7","NMFS",2013,4,20,110,20,41.56389,-67.96609,0,0,0,0,0,"HB",0.024
"17340",522,"201302.298.1190.4","NMFS",2013,4,21,111,20.03,41.536603,-67.730023,0,0,0,0,0,"HB",0.024
"17341",562,"201302.299.1190.1","NMFS",2013,4,21,111,20,41.515677,-67.363303,0,0,0,0,0,"HB",0.024
"17342",562,"201302.300.1190.9","NMFS",2013,4,21,111,20.02,41.709142,-67.531065,1,0,1,0,1,"HB",0.024
"17343",561,"201302.301.1190.11","NMFS",2013,4,21,111,20.02,41.834602,-67.363717,9,8,1,7,2,"HB",0.024
"17344",561,"201302.302.1190.12","NMFS",2013,4,21,111,20,41.896245,-67.26569,0,0,0,0,0,"HB",0.024
"17345",561,"201302.303.1200.4","NMFS",2013,4,21,111,20.02,41.924338,-67.277043,0,0,0,0,0,"HB",0.024
"17346",561,"201302.304.1200.3","NMFS",2013,4,21,111,20,42.035063,-67.369757,0,0,0,0,0,"HB",0.024
"17347",561,"201302.305.1220.4","NMFS",2013,4,21,111,20.02,42.078722,-67.624097,1,1,0,1,0,"HB",0.024
"17348",561,"201302.306.1220.3","NMFS",2013,4,21,111,20.02,42.175752,-67.226687,4,2,2,4,0,"HB",0.024
"17349",464,"201302.307.1300.2","NMFS",2013,4,22,112,20,42.44022,-67.440932,1,0,1,1,0,"HB",0.024
"17350",464,"201302.308.1300.3","NMFS",2013,4,22,112,20.02,42.416407,-67.023708,33,28,5,32,1,"HB",0.024
"17351",464,"201302.309.1300.1","NMFS",2013,4,22,112,20,42.51761,-67.14725,1,0,1,1,0,"HB",0.024
"17352",464,"201302.310.1360.7","NMFS",2013,4,22,112,20.02,42.828173,-67.16396,7,7,0,7,0,"HB",0.024
"17353",464,"201302.311.1360.8","NMFS",2013,4,22,112,20,42.998843,-67.214033,5,1,4,5,0,"HB",0.024
"17354",465,"201302.312.1360.6","NMFS",2013,4,22,112,20.02,43.153958,-67.39083,1,1,0,1,0,"HB",0.024
"17355",465,"201302.313.1360.3","NMFS",2013,4,22,112,20.02,43.254982,-67.174708,3,3,0,3,0,"HB",0.024
"17356",465,"201302.314.1340.5","NMFS",2013,4,22,112,20.03,43.356057,-66.897883,33,24,9,33,0,"HB",0.024
"17357",465,"201302.315.1340.1","NMFS",2013,4,23,113,20.02,43.662838,-67.043225,2,0,2,2,0,"HB",0.024
"17358",465,"201302.316.1340.4","NMFS",2013,4,23,113,20,43.75865,-67.145257,2,2,0,2,0,"HB",0.024
"17359",511,"201302.317.1340.3","NMFS",2013,4,23,113,20,43.852177,-66.923487,4,1,3,4,0,"HB",0.024
"17360",511,"201302.318.1340.6","NMFS",2013,4,23,113,20,43.968308,-66.949755,3,3,0,3,0,"HB",0.024
"17361",466,"201302.319.1351.3","NMFS",2013,4,23,113,20.02,44.270077,-66.692403,5,3,2,5,0,"HB",0.024
"17362",466,"201302.321.1351.5","NMFS",2013,4,23,113,19.98,44.29102,-66.814445,4,2,2,4,0,"HB",0.024
"17363",511,"201302.322.1351.1","NMFS",2013,4,23,113,20,44.222718,-66.984787,11,4,7,11,0,"HB",0.024
"17364",511,"201302.323.1351.4","NMFS",2013,4,23,113,20.02,44.270085,-67.093833,15,3,12,14,1,"HB",0.024
"17365",511,"201302.324.1340.7","NMFS",2013,4,24,114,20.02,44.16722,-67.221217,2,2,0,2,0,"HB",0.024
"17366",511,"201302.325.1390.5","NMFS",2013,4,24,114,20,44.421143,-67.448083,159,79,80,154,5,"HB",0.024
"17367",511,"201302.326.1390.2","NMFS",2013,4,24,114,20,44.43004,-67.537523,204,102,102,180,24,"HB",0.024
"17368",511,"201302.327.1390.3","NMFS",2013,4,24,114,20,44.293627,-67.82673,416,210,206,359,57,"HB",0.024
"17369",511,"201302.328.1340.2","NMFS",2013,4,24,114,20,44.015783,-67.402563,1,1,0,1,0,"HB",0.024
"17370",512,"201302.329.1380.3","NMFS",2013,4,24,114,20.02,43.712128,-68.182003,2,1,1,2,0,"HB",0.024
"17371",512,"201302.330.1380.2","NMFS",2013,4,24,114,20,43.809248,-68.217842,9,6,3,9,0,"HB",0.024
"17372",512,"201302.332.1390.6","NMFS",2013,4,25,115,20.08,43.8945,-68.384847,50,24,26,48,2,"HB",0.024
"17373",512,"201302.333.1380.6","NMFS",2013,4,25,115,20,43.790693,-68.614872,37,21,16,37,0,"HB",0.024
"17374",512,"201302.334.1390.1","NMFS",2013,4,25,115,20,43.818597,-69.065973,843,438,405,399,444,"HB",0.024
"17375",513,"201302.335.1380.5","NMFS",2013,4,25,115,20.02,43.50261,-69.043242,13,5,8,11,2,"HB",0.024
"17376",514,"201302.336.3590.2","NMFS",2013,4,30,120,20,41.808667,-70.450453,71,47,24,41,30,"HB",0.024
"17377",514,"201302.337.3600.2","NMFS",2013,5,1,121,20.02,41.897027,-70.397275,180,89,91,123,57,"HB",0.024
"17378",514,"201302.338.3600.1","NMFS",2013,5,1,121,20,41.959737,-70.218648,29,9,20,27,2,"HB",0.024
"17379",514,"201302.339.3590.3","NMFS",2013,5,1,121,20,42.009923,-70.136623,7,3,4,7,0,"HB",0.024
"17380",514,"201302.340.3610.3","NMFS",2013,5,1,121,20.02,42.00057,-70.260128,97,18,79,95,2,"HB",0.024
"17381",514,"201302.341.3610.1","NMFS",2013,5,1,121,20,42.046748,-70.362767,30,6,24,26,4,"HB",0.024
"17382",514,"201302.342.3610.2","NMFS",2013,5,1,121,20.03,42.155938,-70.119,1,1,0,1,0,"HB",0.024
"17383",514,"201302.343.3610.4","NMFS",2013,5,1,121,20.03,42.076703,-70.001875,1,1,0,1,0,"HB",0.024
"17384",521,"201302.344.3560.2","NMFS",2013,5,1,121,20,41.81904,-69.90855,1,1,0,1,0,"HB",0.024
"17385",514,"201302.346.3560.5","NMFS",2013,5,1,121,20.02,42.089125,-70.117107,4,0,4,3,1,"HB",0.024
"17386",521,"201302.347.1270.2","NMFS",2013,5,2,122,20.03,42.192612,-69.932983,19,18,1,19,0,"HB",0.024
"17387",514,"201302.349.1270.5","NMFS",2013,5,2,122,20.02,42.555575,-70.022097,5,4,1,5,0,"HB",0.024
"17388",515,"201302.350.1280.7","NMFS",2013,5,2,122,20.02,42.700983,-69.604058,0,0,0,0,0,"HB",0.024
"17389",515,"201302.351.1280.6","NMFS",2013,5,2,122,20.02,42.732243,-69.445717,0,0,0,0,0,"HB",0.024
"17390",515,"201302.352.1280.5","NMFS",2013,5,2,122,20.02,42.45097,-69.21003,0,0,0,0,0,"HB",0.024
"17391",515,"201302.354.1370.8","NMFS",2013,5,2,122,20,42.8045,-68.942718,0,0,0,0,0,"HB",0.024
"17392",515,"201302.355.1370.4","NMFS",2013,5,3,123,20.03,42.77989,-68.754807,0,0,0,0,0,"HB",0.024
"17393",515,"201302.356.1280.4","NMFS",2013,5,3,123,20.07,42.596178,-68.742513,1,1,0,1,0,"HB",0.024
"17394",515,"201302.357.1280.2","NMFS",2013,5,3,123,20,42.43855,-68.759185,0,0,0,0,0,"HB",0.024
"17395",522,"201302.358.1240.1","NMFS",2013,5,3,123,20,42.093727,-68.80344,1,1,0,1,0,"HB",0.024
"17396",515,"201302.359.1290.1","NMFS",2013,5,3,123,20.02,42.376152,-68.411947,0,0,0,0,0,"HB",0.024
"17397",522,"201302.360.1290.8","NMFS",2013,5,3,123,20.02,42.305568,-68.404717,1,1,0,1,0,"HB",0.024
"17398",522,"201302.361.1290.4","NMFS",2013,5,3,123,20,42.230792,-68.145357,1,1,0,1,0,"HB",0.024
"17399",522,"201302.362.1290.7","NMFS",2013,5,4,124,20.03,42.282655,-68.104448,0,0,0,0,0,"HB",0.024
"17400",515,"201302.363.1290.5","NMFS",2013,5,4,124,20,42.47535,-68.166087,0,0,0,0,0,"HB",0.024
"17401",515,"201302.364.1290.9","NMFS",2013,5,4,124,20.03,42.594097,-67.950308,2,2,0,2,0,"HB",0.024
"17402",515,"201302.365.1290.3","NMFS",2013,5,4,124,20,42.726393,-67.7079,3,2,1,3,0,"HB",0.024
"17403",515,"201302.366.1360.1","NMFS",2013,5,4,124,20.12,43.145127,-67.711763,1,1,0,1,0,"HB",0.024
"17404",465,"201302.367.1360.2","NMFS",2013,5,4,124,20.02,43.597712,-67.62084,1,1,0,1,0,"HB",0.024
"17405",512,"201302.368.1360.9","NMFS",2013,5,4,124,20,43.439015,-68.029355,3,3,0,3,0,"HB",0.024
"17406",512,"201302.369.1380.7","NMFS",2013,5,4,124,20,43.456833,-68.212905,4,4,0,4,0,"HB",0.024
"17407",512,"201302.370.1380.8","NMFS",2013,5,5,125,20,43.418545,-68.237608,1,0,1,1,0,"HB",0.024
"17408",512,"201302.371.1380.1","NMFS",2013,5,5,125,20,43.338202,-68.401347,4,4,0,4,0,"HB",0.024
"17409",515,"201302.372.1360.4","NMFS",2013,5,5,125,20,43.2053,-68.1351,1,1,0,1,0,"HB",0.024
"17410",515,"201302.373.1360.5","NMFS",2013,5,5,125,20,43.08264,-68.170745,1,1,0,1,0,"HB",0.024
"17411",515,"201302.374.1370.3","NMFS",2013,5,5,125,20.02,43.007873,-68.663262,1,1,0,1,0,"HB",0.024
"17412",515,"201302.375.1370.6","NMFS",2013,5,5,125,20.02,43.136163,-68.809522,3,3,0,3,0,"HB",0.024
"17413",515,"201302.376.1370.5","NMFS",2013,5,5,125,18.77,43.083667,-69.0155,5,4,1,5,0,"HB",0.024
"17414",513,"201302.377.1370.2","NMFS",2013,5,5,125,20,43.025975,-69.621497,5,5,0,5,0,"HB",0.024
"17415",513,"201302.378.1370.7","NMFS",2013,5,5,125,20,43.117055,-69.856648,0,0,0,0,0,"HB",0.024
"17416",513,"201302.379.1380.4","NMFS",2013,5,6,126,20,43.395463,-69.571678,1,1,0,1,0,"HB",0.024
"17417",513,"201302.380.1400.3","NMFS",2013,5,6,126,20,43.519478,-69.927808,35,22,13,32,3,"HB",0.024
"17418",513,"201302.381.1270.3","NMFS",2013,5,6,126,20.02,43.30038,-70.00065,16,15,1,16,0,"HB",0.024
"17419",513,"201302.382.1270.1","NMFS",2013,5,6,126,20.02,43.256098,-69.969153,22,22,0,22,0,"HB",0.024
"17420",513,"201302.383.1400.2","NMFS",2013,5,6,126,20.02,43.041077,-70.37181,44,16,28,41,3,"HB",0.024
"17421",513,"201302.384.1270.4","NMFS",2013,5,6,126,20,43.016515,-70.36054,30,11,19,29,1,"HB",0.024
"17422",513,"201302.385.1400.1","NMFS",2013,5,6,126,20.03,42.960782,-70.406448,21,8,13,20,1,"HB",0.024
"17423",513,"201302.386.3650.3","NMFS",2013,5,6,126,20.02,42.857715,-70.7043,186,93,93,172,14,"HB",0.024
"17424",513,"201302.387.3640.2","NMFS",2013,5,6,126,20.13,42.840862,-70.743563,35,21,14,34,1,"HB",0.024
"17425",514,"201302.391.1260.8","NMFS",2013,5,7,127,20.02,42.748922,-70.287192,6,5,1,6,0,"HB",0.024
"17426",514,"201302.392.1260.5","NMFS",2013,5,7,127,20,42.60417,-70.105245,5,5,0,5,0,"HB",0.024
"17427",514,"201302.393.1260.11","NMFS",2013,5,7,127,20,42.641407,-70.264317,1,1,0,1,0,"HB",0.024
"17428",514,"201302.395.3660.2","NMFS",2013,5,7,127,20,42.50878,-70.674218,71,18,53,65,6,"HB",0.024
"17429",514,"201302.396.3650.1","NMFS",2013,5,7,127,20.03,42.516007,-70.719665,86,40,46,82,4,"HB",0.024
"17430",514,"201302.397.3650.4","NMFS",2013,5,7,127,20,42.39193,-70.74885,55,33,22,51,4,"HB",0.024
"17431",514,"201302.398.3640.3","NMFS",2013,5,7,127,17.53,42.332442,-70.76332,163,69,94,131,32,"HB",0.024
"17432",514,"201302.399.3660.1","NMFS",2013,5,7,127,20.03,42.334047,-70.6554,9,5,4,8,1,"HB",0.024
"17433",514,"201302.400.3640.1","NMFS",2013,5,8,128,20.02,42.2609,-70.63809,93,55,38,73,20,"HB",0.024
"17434",514,"201302.401.3660.3","NMFS",2013,5,8,128,20.02,42.267177,-70.54196,14,5,9,13,1,"HB",0.024
"17435",514,"201302.402.1260.3","NMFS",2013,5,8,128,20.02,42.381823,-70.530658,17,5,12,17,0,"HB",0.024
"17436",514,"201302.404.1260.15","NMFS",2013,5,8,128,20,42.446997,-70.281695,12,11,1,12,0,"HB",0.024
"17437",514,"201302.405.1260.2","NMFS",2013,5,8,128,17.5,42.37785,-70.294975,3,3,0,3,0,"HB",0.024
"17438",514,"201302.406.1260.16","NMFS",2013,5,8,128,20.02,42.243903,-70.167437,0,0,0,0,0,"HB",0.024
"17439",514,"201302.407.1260.4","NMFS",2013,5,8,128,20.02,42.253117,-70.332493,13,7,6,12,1,"HB",0.024
"17440",514,"201302.408.1260.1","NMFS",2013,5,8,128,20.02,42.15814,-70.44151,35,14,21,26,9,"HB",0.024
"17441",514,"201302.409.3590.1","NMFS",2013,5,8,128,20,41.964355,-70.541105,83,48,35,51,32,"HB",0.024
"17442",514,"201302.410.3600.3","NMFS",2013,5,9,129,20.02,41.937335,-70.336,338,118,220,268,70,"HB",0.024
"17443",526,"201304.154.1100.7","NMFS",2013,9,18,261,20,40.13717,-69.87553,3,2,1,3,0,"HB",0.024
"17444",526,"201304.218.1100.6","NMFS",2013,9,29,272,20.02,40.460648,-69.860937,0,0,0,0,0,"HB",0.024
"17445",526,"201304.219.1100.9","NMFS",2013,9,29,272,20.02,40.393185,-69.760827,0,0,0,0,0,"HB",0.024
"17446",526,"201304.220.1100.1","NMFS",2013,9,29,272,19.97,40.235732,-69.306578,0,0,0,0,0,"HB",0.024
"17447",526,"201304.221.1100.3","NMFS",2013,9,29,272,20.02,40.180773,-69.498077,1,0,1,1,0,"HB",0.024
"17448",526,"201304.222.1110.4","NMFS",2013,9,29,272,20,39.960553,-69.462947,1,0,1,1,0,"HB",0.024
"17449",526,"201304.223.1110.3","NMFS",2013,9,30,273,20.02,39.964863,-69.373938,0,0,0,0,0,"HB",0.024
"17450",526,"201304.224.1110.2","NMFS",2013,9,30,273,20.02,40.02084,-69.283855,1,1,0,1,0,"HB",0.024
"17451",526,"201304.225.1110.1","NMFS",2013,9,30,273,20,40.150882,-68.888005,0,0,0,0,0,"HB",0.024
"17452",525,"201304.226.1140.1","NMFS",2013,9,30,273,20.43,40.23214,-68.671187,0,0,0,0,0,"HB",0.024
"17453",525,"201304.228.1130.2","NMFS",2013,9,30,273,20.02,40.644888,-68.738817,0,0,0,0,0,"HB",0.024
"17454",525,"201304.229.1130.5","NMFS",2013,9,30,273,20.02,40.652382,-68.625973,0,0,0,0,0,"HB",0.024
"17455",525,"201304.230.1130.1","NMFS",2013,9,30,273,20,40.804145,-68.787167,1,1,0,1,0,"HB",0.024
"17456",526,"201304.232.1100.2","NMFS",2013,9,30,273,20.02,40.69396,-68.896755,6,4,2,6,0,"HB",0.024
"17457",526,"201304.233.1100.5","NMFS",2013,9,30,273,20.02,40.598647,-69.007905,0,0,0,0,0,"HB",0.024
"17458",526,"201304.234.1100.8","NMFS",2013,10,1,274,20.03,40.536742,-69.030357,1,1,0,1,0,"HB",0.024
"17459",526,"201304.235.1090.2","NMFS",2013,10,1,274,20,40.659787,-69.427398,0,0,0,0,0,"HB",0.024
"17460",526,"201304.236.1090.5","NMFS",2013,10,1,274,20,40.828615,-69.552405,0,0,0,0,0,"HB",0.024
"17461",521,"201304.245.1250.3","NMFS",2013,10,22,295,20.02,41.011585,-69.228133,8,3,5,8,0,"HB",0.024
"17462",521,"201304.246.1250.4","NMFS",2013,10,22,295,19.98,41.222627,-69.349792,1,1,0,1,0,"HB",0.024
"17463",521,"201304.247.1230.4","NMFS",2013,10,22,295,20.02,41.346023,-69.325947,1,1,0,1,0,"HB",0.024
"17464",521,"201304.248.1250.1","NMFS",2013,10,23,296,20,41.321365,-69.456722,4,4,0,4,0,"HB",0.024
"17465",521,"201304.250.1250.2","NMFS",2013,10,23,296,20.03,41.448045,-69.548438,20,12,8,17,3,"HB",0.024
"17466",521,"201304.251.1230.6","NMFS",2013,10,23,296,20.03,41.58571,-69.539317,4,4,0,4,0,"HB",0.024
"17467",521,"201304.253.1260.4","NMFS",2013,10,25,298,19.98,42.074075,-69.956775,20,15,5,20,0,"HB",0.024
"17468",514,"201304.254.3560.4","NMFS",2013,10,25,298,16.78,42.050458,-70.037363,8,8,0,8,0,"HB",0.024
"17469",521,"201304.255.3560.3","NMFS",2013,10,25,298,20.02,41.978707,-69.973637,17,14,3,17,0,"HB",0.024
"17470",521,"201304.256.3560.1","NMFS",2013,10,25,298,20,41.815095,-69.90244,2,1,1,2,0,"HB",0.024
"17471",521,"201304.257.1240.1","NMFS",2013,10,25,298,19.98,41.773898,-69.71519,0,0,0,0,0,"HB",0.024
"17472",521,"201304.258.1240.7","NMFS",2013,10,25,298,20.02,41.356395,-69.22572,0,0,0,0,0,"HB",0.024
"17473",521,"201304.259.1230.5","NMFS",2013,10,25,298,20.03,41.29312,-69.158033,0,0,0,0,0,"HB",0.024
"17474",521,"201304.260.1240.5","NMFS",2013,10,25,298,20,41.30696,-68.915405,0,0,0,0,0,"HB",0.024
"17475",521,"201304.261.1230.3","NMFS",2013,10,25,298,20.02,41.173683,-68.90579,0,0,0,0,0,"HB",0.024
"17476",522,"201304.262.1230.2","NMFS",2013,10,26,299,20,41.292188,-68.674752,22,17,5,22,0,"HB",0.024
"17477",522,"201304.263.1230.1","NMFS",2013,10,26,299,19.98,41.349683,-68.401518,3,3,0,3,0,"HB",0.024
"17478",522,"201304.266.1200.4","NMFS",2013,10,26,299,20,41.26049,-68.434738,0,0,0,0,0,"HB",0.024
"17479",522,"201304.267.1200.7","NMFS",2013,10,26,299,19.45,41.147478,-68.495473,1,1,0,1,0,"HB",0.024
"17480",525,"201304.268.1190.9","NMFS",2013,10,26,299,20.03,40.920958,-68.54921,0,0,0,0,0,"HB",0.024
"17481",525,"201304.269.1190.8","NMFS",2013,10,26,299,20.03,40.990413,-68.39143,4,3,1,4,0,"HB",0.024
"17482",525,"201304.270.1130.10","NMFS",2013,10,26,299,20,40.850178,-68.067657,0,0,0,0,0,"HB",0.024
"17483",525,"201304.271.1190.3","NMFS",2013,10,27,300,20,41.081023,-67.901345,1,1,0,1,0,"HB",0.024
"17484",525,"201304.272.1190.1","NMFS",2013,10,27,300,20.02,41.029142,-67.834748,0,0,0,0,0,"HB",0.024
"17485",525,"201304.273.1130.9","NMFS",2013,10,27,300,20.02,40.839292,-67.784318,0,0,0,0,0,"HB",0.024
"17486",525,"201304.274.1130.4","NMFS",2013,10,27,300,20.02,40.75989,-67.819487,1,1,0,1,0,"HB",0.024
"17487",525,"201304.276.1130.6","NMFS",2013,10,27,300,20,40.458532,-68.336188,1,1,0,1,0,"HB",0.024
"17488",525,"201304.277.1150.1","NMFS",2013,10,27,300,20.02,40.348297,-67.827922,3,3,0,3,0,"HB",0.024
"17489",525,"201304.278.1140.2","NMFS",2013,10,27,300,20,40.534597,-67.638347,1,1,0,1,0,"HB",0.024
"17490",525,"201304.279.1140.4","NMFS",2013,10,27,300,20,40.529732,-67.41985,8,8,0,8,0,"HB",0.024
"17491",525,"201304.280.1150.3","NMFS",2013,10,28,301,20,40.447095,-67.267132,1,1,0,1,0,"HB",0.024
"17492",525,"201304.281.1130.3","NMFS",2013,10,28,301,20.02,40.664653,-67.159297,2,1,1,2,0,"HB",0.024
"17493",525,"201304.282.1130.7","NMFS",2013,10,28,301,20,40.863812,-67.006067,1,1,0,1,0,"HB",0.024
"17494",525,"201304.284.1150.2","NMFS",2013,10,28,301,20,40.713333,-66.841595,18,18,0,18,0,"HB",0.024
"17495",525,"201304.285.1130.8","NMFS",2013,10,28,301,19.98,40.79622,-66.84411,6,6,0,6,0,"HB",0.024
"17496",562,"201304.286.1180.4","NMFS",2013,10,28,301,20.02,40.937338,-66.478933,28,26,2,28,0,"HB",0.024
"17497",562,"201304.287.1170.3","NMFS",2013,10,28,301,20,41.124862,-66.405452,2,2,0,2,0,"HB",0.024
"17498",562,"201304.288.1180.2","NMFS",2013,10,29,302,20,41.106355,-66.329318,7,6,1,7,0,"HB",0.024
"17499",562,"201304.289.1170.4","NMFS",2013,10,29,302,20,41.14484,-66.397565,2,2,0,2,0,"HB",0.024
"17500",552,"201304.290.1180.3","NMFS",2013,10,29,302,20.02,41.376448,-66.050707,10,9,1,10,0,"HB",0.024
"17501",562,"201304.291.1160.5","NMFS",2013,10,29,302,20,41.30072,-66.624732,1,1,0,1,0,"HB",0.024
"17502",562,"201304.292.1160.14","NMFS",2013,10,29,302,20,41.118768,-66.739045,2,2,0,2,0,"HB",0.024
"17503",562,"201304.293.1160.2","NMFS",2013,10,29,302,20.02,41.152675,-66.964463,1,1,0,1,0,"HB",0.024
"17504",562,"201304.294.1160.6","NMFS",2013,10,29,302,20.03,41.214802,-66.951478,0,0,0,0,0,"HB",0.024
"17505",562,"201304.295.1160.9","NMFS",2013,10,29,302,20.02,41.326545,-67.108637,0,0,0,0,0,"HB",0.024
"17506",552,"201304.296.1160.3","NMFS",2013,10,29,302,20,41.67926,-66.702925,24,23,1,24,0,"HB",0.024
"17507",562,"201304.297.1160.11","NMFS",2013,10,30,303,20.02,41.637093,-67.020752,0,0,0,0,0,"HB",0.024
"17508",562,"201304.298.1190.6","NMFS",2013,10,30,303,20,41.700282,-67.195368,7,7,0,7,0,"HB",0.024
"17509",562,"201304.299.1190.2","NMFS",2013,10,30,303,20.02,41.64153,-67.357427,0,0,0,0,0,"HB",0.024
"17510",562,"201304.300.1190.7","NMFS",2013,10,30,303,20,41.24043,-67.551248,0,0,0,0,0,"HB",0.024
"17511",522,"201304.301.1200.6","NMFS",2013,10,30,303,19.98,41.443492,-68.100935,1,1,0,1,0,"HB",0.024
"17512",521,"201304.302.1240.4","NMFS",2013,10,30,303,20,41.454573,-69.006103,3,2,1,3,0,"HB",0.024
"17513",521,"201304.303.1240.6","NMFS",2013,10,30,303,20.02,41.579562,-68.9028,0,0,0,0,0,"HB",0.024
"17514",521,"201304.304.1240.3","NMFS",2013,10,30,303,20,41.742828,-68.869143,0,0,0,0,0,"HB",0.024
"17515",521,"201304.305.1280.7","NMFS",2013,10,31,304,20.02,42.021333,-69.194015,0,0,0,0,0,"HB",0.024
"17516",514,"201304.307.3640.3","NMFS",2013,11,1,305,20,42.396127,-70.786497,299,171,128,208,91,"HB",0.024
"17517",514,"201304.308.3610.2","NMFS",2013,11,2,306,20,42.175188,-70.097125,24,16,8,24,0,"HB",0.024
"17518",514,"201304.309.1260.2","NMFS",2013,11,2,306,20.02,42.222265,-70.03787,0,0,0,0,0,"HB",0.024
"17519",521,"201304.310.1270.2","NMFS",2013,11,2,306,20.02,42.20713,-69.833702,0,0,0,0,0,"HB",0.024
"17520",521,"201304.311.1280.5","NMFS",2013,11,2,306,20.02,42.079428,-69.527413,1,1,0,1,0,"HB",0.024
"17521",522,"201304.314.1240.8","NMFS",2013,11,2,306,20,41.929168,-68.601238,0,0,0,0,0,"HB",0.024
"17522",522,"201304.315.1290.10","NMFS",2013,11,2,306,20.03,42.182135,-68.295812,0,0,0,0,0,"HB",0.024
"17523",522,"201304.316.1220.3","NMFS",2013,11,3,307,20.02,41.984877,-67.904828,3,1,2,3,0,"HB",0.024
"17524",522,"201304.317.1290.8","NMFS",2013,11,3,307,20.02,41.989645,-68.089055,2,2,0,2,0,"HB",0.024
"17525",522,"201304.318.1220.1","NMFS",2013,11,3,307,19.98,41.856328,-68.226003,2,2,0,2,0,"HB",0.024
"17526",522,"201304.319.1210.3","NMFS",2013,11,3,307,20,41.737712,-68.291022,2,2,0,2,0,"HB",0.024
"17527",522,"201304.320.1210.2","NMFS",2013,11,3,307,20.03,41.761057,-68.254055,4,4,0,4,0,"HB",0.024
"17528",522,"201304.321.1200.5","NMFS",2013,11,3,307,20.02,41.672957,-67.901803,0,0,0,0,0,"HB",0.024
"17529",522,"201304.322.1200.1","NMFS",2013,11,3,307,20,41.739633,-67.957613,2,1,1,2,0,"HB",0.024
"17530",561,"201304.323.1200.2","NMFS",2013,11,3,307,20,42.029645,-67.539375,0,0,0,0,0,"HB",0.024
"17531",562,"201304.324.1190.5","NMFS",2013,11,4,308,20.03,41.83064,-67.189715,2,2,0,0,2,"HB",0.024
"17532",561,"201304.325.1190.4","NMFS",2013,11,4,308,20.02,41.875237,-67.040878,5,5,0,5,0,"HB",0.024
"17533",551,"201304.326.1210.1","NMFS",2013,11,4,308,20,42.089203,-66.921983,15,14,1,15,0,"HB",0.024
"17534",551,"201304.327.1160.8","NMFS",2013,11,4,308,17.43,42.01038,-66.759992,13,9,4,12,1,"HB",0.024
"17535",551,"201304.328.1160.1","NMFS",2013,11,4,308,20.02,41.985168,-66.323817,1,1,0,1,0,"HB",0.024
"17536",552,"201304.329.1160.4","NMFS",2013,11,4,308,20.02,41.72821,-66.30221,12,12,0,12,0,"HB",0.024
"17537",552,"201304.330.1160.7","NMFS",2013,11,4,308,19.98,41.826565,-66.176487,10,9,1,10,0,"HB",0.024
"17538",551,"201304.331.1160.12","NMFS",2013,11,4,308,20,41.904082,-66.136665,6,5,1,6,0,"HB",0.024
"17539",552,"201304.332.1160.10","NMFS",2013,11,4,308,19.98,41.830223,-66.065048,2,2,0,2,0,"HB",0.024
"17540",552,"201304.333.1160.13","NMFS",2013,11,5,309,20,41.693835,-65.95043,5,3,2,5,0,"HB",0.024
"17541",552,"201304.334.1170.1","NMFS",2013,11,5,309,20.03,41.742912,-65.791688,3,3,0,3,0,"HB",0.024
"17542",551,"201304.336.1170.2","NMFS",2013,11,5,309,20,41.860705,-65.874755,1,1,0,1,0,"HB",0.024
"17543",551,"201304.338.1210.4","NMFS",2013,11,5,309,20.03,42.10873,-66.128042,0,0,0,0,0,"HB",0.024
"17544",551,"201304.339.1220.2","NMFS",2013,11,5,309,20,42.166733,-66.237905,2,2,0,2,0,"HB",0.024
"17545",551,"201304.341.1220.4","NMFS",2013,11,5,309,20,42.17015,-66.25459,2,1,1,2,0,"HB",0.024
"17546",551,"201304.342.1290.5","NMFS",2013,11,5,309,20,42.305055,-66.154325,2,2,0,2,0,"HB",0.024
"17547",551,"201304.343.1290.3","NMFS",2013,11,6,310,20.03,42.30034,-66.337457,1,1,0,1,0,"HB",0.024
"17548",551,"201304.344.1290.9","NMFS",2013,11,6,310,20.03,42.256033,-66.57213,8,6,2,8,0,"HB",0.024
"17549",464,"201304.346.1300.3","NMFS",2013,11,6,310,20,42.475013,-66.65634,1,1,0,1,0,"HB",0.024
"17550",464,"201304.347.1300.1","NMFS",2013,11,6,310,19.98,42.376507,-66.873498,1,1,0,1,0,"HB",0.024
"17551",464,"201304.348.1290.1","NMFS",2013,11,6,310,20.03,42.750703,-67.207925,1,1,0,1,0,"HB",0.024
"17552",464,"201304.349.1300.2","NMFS",2013,11,6,310,19.98,42.497362,-67.292573,1,1,0,1,0,"HB",0.024
"17553",464,"201304.350.1290.7","NMFS",2013,11,6,310,20.02,42.457628,-67.611205,2,2,0,2,0,"HB",0.024
"17554",515,"201304.351.1290.6","NMFS",2013,11,7,311,20.02,42.587925,-68.064733,0,0,0,0,0,"HB",0.024
"17555",515,"201304.352.1290.2","NMFS",2013,11,7,311,20,42.755332,-67.887187,0,0,0,0,0,"HB",0.024
"17556",464,"201304.353.1360.2","NMFS",2013,11,7,311,20,42.929465,-67.60112,2,0,2,2,0,"HB",0.024
"17557",515,"201304.354.1360.8","NMFS",2013,11,7,311,20.02,43.004052,-67.824698,0,0,0,0,0,"HB",0.024
"17558",515,"201304.355.1360.12","NMFS",2013,11,7,311,20.02,43.049897,-67.943197,0,0,0,0,0,"HB",0.024
"17559",465,"201304.356.1360.1","NMFS",2013,11,7,311,20,43.285638,-67.469888,0,0,0,0,0,"HB",0.024
"17560",465,"201304.357.1360.11","NMFS",2013,11,7,311,19.98,43.53066,-67.266912,8,8,0,8,0,"HB",0.024
"17561",465,"201304.358.1360.7","NMFS",2013,11,8,312,20.02,43.468867,-66.947805,5,5,0,5,0,"HB",0.024
"17562",465,"201304.360.1340.6","NMFS",2013,11,8,312,20,43.866925,-66.808372,61,51,10,61,0,"HB",0.024
"17563",465,"201304.361.1340.5","NMFS",2013,11,8,312,19.98,43.90729,-66.789815,27,24,3,27,0,"HB",0.024
"17564",511,"201304.363.1351.2","NMFS",2013,11,11,315,20.02,44.250108,-66.880147,0,0,0,0,0,"HB",0.024
"17565",466,"201304.364.1351.4","NMFS",2013,11,11,315,20.03,44.231707,-66.767615,1,1,0,1,0,"HB",0.024
"17566",511,"201304.365.1351.1","NMFS",2013,11,11,315,20,44.148767,-66.854895,5,3,2,5,0,"HB",0.024
"17567",511,"201304.366.1351.3","NMFS",2013,11,11,315,19.98,44.168177,-67.134382,5,4,1,5,0,"HB",0.024
"17568",511,"201304.369.1340.2","NMFS",2013,11,11,315,19.98,44.082262,-67.232245,2,2,0,2,0,"HB",0.024
"17569",511,"201304.370.1360.4","NMFS",2013,11,11,315,20.02,44.152043,-67.413335,0,0,0,0,0,"HB",0.024
"17570",511,"201304.371.1390.2","NMFS",2013,11,11,315,20,44.350882,-67.709127,563,301,262,496,67,"HB",0.024
"17571",512,"201304.372.1390.1","NMFS",2013,11,11,315,20.02,44.228763,-67.943697,436,222,214,306,130,"HB",0.024
"17572",512,"201304.373.1390.4","NMFS",2013,11,11,315,20,44.17718,-68.030265,497,250,247,406,91,"HB",0.024
"17573",512,"201304.374.1380.7","NMFS",2013,11,12,316,20,44.0051,-68.03061,246,184,62,246,0,"HB",0.024
"17574",512,"201304.375.1360.3","NMFS",2013,11,12,316,20,43.871667,-67.947293,0,0,0,0,0,"HB",0.024
"17575",512,"201304.376.1360.5","NMFS",2013,11,12,316,20,43.832797,-67.814252,2,2,0,2,0,"HB",0.024
"17576",512,"201304.379.1380.4","NMFS",2013,11,12,316,20,43.611073,-68.621545,18,15,3,18,0,"HB",0.024
"17577",512,"201304.380.1380.2","NMFS",2013,11,12,316,19.98,43.612658,-68.653542,5,5,0,5,0,"HB",0.024
"17578",513,"201304.381.1380.8","NMFS",2013,11,13,317,20.03,43.499785,-69.042595,9,5,4,9,0,"HB",0.024
"17579",513,"201304.382.1380.3","NMFS",2013,11,13,317,19.98,43.46533,-69.046548,11,11,0,11,0,"HB",0.024
"17580",512,"201304.383.1380.1","NMFS",2013,11,13,317,20.02,43.333402,-68.971227,1,1,0,1,0,"HB",0.024
"17581",513,"201304.384.1370.7","NMFS",2013,11,13,317,19.98,43.257777,-69.038722,1,1,0,1,0,"HB",0.024
"17582",515,"201304.385.1370.5","NMFS",2013,11,13,317,20.02,42.996015,-68.578077,1,1,0,1,0,"HB",0.024
"17583",515,"201304.386.1370.6","NMFS",2013,11,13,317,19.98,42.829993,-68.617813,0,0,0,0,0,"HB",0.024
"17584",515,"201304.387.1370.1","NMFS",2013,11,13,317,20,42.676045,-68.734812,0,0,0,0,0,"HB",0.024
"17585",515,"201304.388.1280.1","NMFS",2013,11,14,318,20,42.37596,-68.737387,0,0,0,0,0,"HB",0.024
"17586",515,"201304.389.1280.4","NMFS",2013,11,14,318,20.02,42.36787,-69.175288,1,1,0,1,0,"HB",0.024
"17587",515,"201304.390.1280.2","NMFS",2013,11,14,318,20,42.347268,-69.506593,0,0,0,0,0,"HB",0.024
"17588",514,"201304.391.1270.5","NMFS",2013,11,14,318,20.02,42.46943,-69.939215,0,0,0,0,0,"HB",0.024
"17589",515,"201304.392.1280.6","NMFS",2013,11,14,318,20.03,42.547815,-69.534565,1,1,0,1,0,"HB",0.024
"17590",515,"201304.393.1280.3","NMFS",2013,11,14,318,19,42.719715,-69.537378,0,0,0,0,0,"HB",0.024
"17591",513,"201304.394.1370.2","NMFS",2013,11,14,318,20.02,42.933758,-69.367768,0,0,0,0,0,"HB",0.024
"17592",513,"201304.395.1370.4","NMFS",2013,11,14,318,19.98,42.949267,-69.61911,0,0,0,0,0,"HB",0.024
"17593",513,"201304.396.1370.3","NMFS",2013,11,15,319,20.03,43.180573,-69.208828,0,0,0,0,0,"HB",0.024
"17594",513,"201304.397.1380.6","NMFS",2013,11,15,319,19.98,43.339763,-69.308165,1,1,0,1,0,"HB",0.024
"17595",513,"201304.398.1380.5","NMFS",2013,11,15,319,20,43.35601,-69.453227,1,1,0,1,0,"HB",0.024
"17596",513,"201304.400.1400.4","NMFS",2013,11,16,320,19.98,43.380972,-70.10469,76,54,22,68,8,"HB",0.024
"17597",513,"201304.401.1270.4","NMFS",2013,11,16,320,20,43.26604,-70.152087,22,19,3,22,0,"HB",0.024
"17598",513,"201304.402.1270.1","NMFS",2013,11,16,320,20,43.239387,-70.096993,2,2,0,2,0,"HB",0.024
"17599",513,"201304.403.1260.3","NMFS",2013,11,17,321,20,43.168788,-70.016352,0,0,0,0,0,"HB",0.024
"17600",513,"201304.404.1400.2","NMFS",2013,11,17,321,20.02,43.170427,-70.297812,94,58,36,89,5,"HB",0.024
"17601",513,"201304.405.1400.3","NMFS",2013,11,17,321,20,43.146422,-70.324023,87,43,44,75,12,"HB",0.024
"17602",513,"201304.406.1270.3","NMFS",2013,11,17,321,20,42.940492,-70.36827,26,20,6,26,0,"HB",0.024
"17603",514,"201304.407.3640.1","NMFS",2013,11,17,321,20,42.813817,-70.747465,15,5,10,14,1,"HB",0.024
"17604",514,"201304.408.3650.3","NMFS",2013,11,17,321,20,42.715983,-70.639538,94,47,47,76,18,"HB",0.024
"17605",514,"201304.409.3650.1","NMFS",2013,11,17,321,20,42.722127,-70.630907,98,60,38,90,8,"HB",0.024
"17606",514,"201304.410.3660.1","NMFS",2013,11,17,321,20,42.734348,-70.59279,149,72,77,97,52,"HB",0.024
"17607",514,"201304.411.1260.5","NMFS",2013,11,17,321,19.98,42.662368,-70.34811,33,16,17,31,2,"HB",0.024
"17608",514,"201304.412.1260.1","NMFS",2013,11,17,321,19.98,42.686557,-70.188068,0,0,0,0,0,"HB",0.024
"17609",514,"201304.413.1260.6","NMFS",2013,11,18,322,20.02,42.390908,-70.336577,12,5,7,12,0,"HB",0.024
"17610",514,"201304.414.3660.2","NMFS",2013,11,18,322,19.98,42.515443,-70.649132,90,40,50,72,18,"HB",0.024
"17611",514,"201304.415.3640.2","NMFS",2013,11,18,322,20,42.518572,-70.726187,532,267,265,367,165,"HB",0.024
"17612",514,"201304.416.3660.3","NMFS",2013,11,18,322,20.02,42.279552,-70.569735,76,41,35,62,14,"HB",0.024
"17613",514,"201304.417.3650.2","NMFS",2013,11,18,322,19.98,42.186103,-70.54652,43,21,22,38,5,"HB",0.024
"17614",514,"201304.418.3590.2","NMFS",2013,11,18,322,20,41.98413,-70.557477,51,27,24,31,20,"HB",0.024
"17615",514,"201304.419.3600.1","NMFS",2013,11,18,322,20.02,41.992995,-70.530145,145,81,64,84,61,"HB",0.024
"17616",514,"201304.421.3600.3","NMFS",2013,11,18,322,20,41.960473,-70.345932,155,0,155,135,20,"HB",0.024
"17617",514,"201304.422.3610.1","NMFS",2013,11,18,322,20,42.003168,-70.290418,31,9,22,28,3,"HB",0.024
"17618",514,"201304.423.3610.3","NMFS",2013,11,19,323,20,42.01223,-70.270333,23,6,17,21,2,"HB",0.024
"17619",514,"201304.424.3600.2","NMFS",2013,11,19,323,19.98,41.936072,-70.198968,2,0,2,2,0,"HB",0.024
"17620",514,"201304.425.3590.3","NMFS",2013,11,19,323,20.02,41.90637,-70.152078,0,0,0,0,0,"HB",0.024
"17621",514,"201304.426.3590.1","NMFS",2013,11,19,323,20,41.832575,-70.333855,5,3,2,3,2,"HB",0.024
"17622",526,"201402.162.1100.9","NMFS",2014,4,21,111,20.07,40.226112,-69.90447,0,0,0,0,0,"HB",0.024
"17623",526,"201402.163.1110.2","NMFS",2014,4,21,111,20.03,39.958003,-69.822545,0,0,0,0,0,"HB",0.024
"17624",526,"201402.164.1100.5","NMFS",2014,4,21,111,20.03,40.189362,-69.334312,0,0,0,0,0,"HB",0.024
"17625",526,"201402.165.1100.2","NMFS",2014,4,21,111,20,40.133633,-69.24311,0,0,0,0,0,"HB",0.024
"17626",526,"201402.166.1120.3","NMFS",2014,4,22,112,20.05,39.9895,-69.262667,0,0,0,0,0,"HB",0.024
"17627",526,"201402.167.1110.4","NMFS",2014,4,22,112,20,40.081698,-68.953032,0,0,0,0,0,"HB",0.024
"17628",526,"201402.168.1120.2","NMFS",2014,4,22,112,20.02,40.092327,-68.865222,0,0,0,0,0,"HB",0.024
"17629",525,"201402.170.1140.1","NMFS",2014,4,22,112,20,40.156118,-68.70138,0,0,0,0,0,"HB",0.024
"17630",525,"201402.171.1140.4","NMFS",2014,4,22,112,20.07,40.170197,-68.6085,0,0,0,0,0,"HB",0.024
"17631",526,"201402.172.1100.7","NMFS",2014,4,22,112,20.02,40.291673,-69.141938,0,0,0,0,0,"HB",0.024
"17632",526,"201402.173.1100.3","NMFS",2014,4,22,112,20,40.371542,-69.05476,0,0,0,0,0,"HB",0.024
"17633",526,"201402.174.1100.8","NMFS",2014,4,22,112,20,40.491952,-69.243185,0,0,0,0,0,"HB",0.024
"17634",526,"201402.175.1090.5","NMFS",2014,4,22,112,20.02,40.639335,-69.414667,0,0,0,0,0,"HB",0.024
"17635",526,"201402.176.1090.2","NMFS",2014,4,23,113,20.07,40.642892,-69.607018,0,0,0,0,0,"HB",0.024
"17636",526,"201402.177.1100.6","NMFS",2014,4,23,113,20.05,40.882715,-69.00418,2,2,0,2,0,"HB",0.024
"17637",521,"201402.178.1100.1","NMFS",2014,4,23,113,16.03,41.000333,-68.931667,0,0,0,0,0,"HB",0.024
"17638",521,"201402.180.1250.6","NMFS",2014,4,23,113,20,41.090333,-69.272667,2,2,0,1,1,"HB",0.024
"17639",521,"201402.181.1250.1","NMFS",2014,4,23,113,20,41.22608,-69.34765,0,0,0,0,0,"HB",0.024
"17640",521,"201402.182.1230.1","NMFS",2014,4,23,113,20.03,41.339215,-69.328308,0,0,0,0,0,"HB",0.024
"17641",521,"201402.187.1230.2","NMFS",2014,4,24,114,20.05,41.711768,-69.735145,0,0,0,0,0,"HB",0.024
"17642",521,"201402.189.1270.4","NMFS",2014,5,7,127,20.08,42.158147,-69.961833,8,8,0,8,0,"HB",0.024
"17643",521,"201402.190.1280.7","NMFS",2014,5,7,127,20.05,42.032478,-69.514478,0,0,0,0,0,"HB",0.024
"17644",521,"201402.191.1240.4","NMFS",2014,5,7,127,20.02,41.896958,-68.926802,1,1,0,1,0,"HB",0.024
"17645",522,"201402.192.1210.3","NMFS",2014,5,7,127,20.02,41.728652,-68.361758,0,0,0,0,0,"HB",0.024
"17646",522,"201402.193.1220.1","NMFS",2014,5,7,127,20.07,42.070375,-67.809675,3,3,0,3,0,"HB",0.024
"17647",522,"201402.194.1220.3","NMFS",2014,5,7,127,19.98,42.085713,-67.67238,6,6,0,6,0,"HB",0.024
"17648",561,"201402.195.1210.2","NMFS",2014,5,7,127,19.98,42.111485,-67.381737,2,2,0,2,0,"HB",0.024
"17649",561,"201402.196.1200.5","NMFS",2014,5,8,128,20,41.968667,-67.316667,0,0,0,0,0,"HB",0.024
"17650",561,"201402.197.1200.4","NMFS",2014,5,8,128,20.02,41.864758,-67.385813,7,2,5,5,2,"HB",0.024
"17651",562,"201402.199.1190.10","NMFS",2014,5,8,128,19.98,41.734667,-67.088333,0,0,0,0,0,"HB",0.024
"17652",562,"201402.200.1190.4","NMFS",2014,5,8,128,19.98,41.588547,-67.392845,1,1,0,1,0,"HB",0.024
"17653",522,"201402.201.1200.3","NMFS",2014,5,8,128,20,41.674407,-67.668487,0,0,0,0,0,"HB",0.024
"17654",522,"201402.202.1190.7","NMFS",2014,5,8,128,20.07,41.516182,-67.839833,1,0,1,1,0,"HB",0.024
"17655",525,"201402.203.1190.6","NMFS",2014,5,8,128,19.97,41.251263,-68.05572,0,0,0,0,0,"HB",0.024
"17656",525,"201402.204.1190.9","NMFS",2014,5,9,129,20,41.088677,-68.163623,0,0,0,0,0,"HB",0.024
"17657",522,"201402.205.1200.1","NMFS",2014,5,9,129,20.07,41.237812,-68.390013,6,4,2,5,1,"HB",0.024
"17658",522,"201402.206.1230.3","NMFS",2014,5,9,129,20.05,41.334773,-68.626467,0,0,0,0,0,"HB",0.024
"17659",522,"201402.209.1230.6","NMFS",2014,5,9,129,20,41.029607,-68.757088,0,0,0,0,0,"HB",0.024
"17660",525,"201402.210.1130.1","NMFS",2014,5,9,129,20.1,40.790057,-68.70368,0,0,0,0,0,"HB",0.024
"17661",525,"201402.211.1190.1","NMFS",2014,5,9,129,20.08,40.755585,-68.595207,0,0,0,0,0,"HB",0.024
"17662",525,"201402.212.1190.8","NMFS",2014,5,9,129,19.98,40.780035,-68.378153,0,0,0,0,0,"HB",0.024
"17663",525,"201402.213.1130.8","NMFS",2014,5,10,130,19.98,40.815572,-68.138015,0,0,0,0,0,"HB",0.024
"17664",525,"201402.215.1150.2","NMFS",2014,5,10,130,20.07,40.312445,-68.020518,0,0,0,0,0,"HB",0.024
"17665",525,"201402.216.1140.3","NMFS",2014,5,10,130,20,40.469568,-67.94338,0,0,0,0,0,"HB",0.024
"17666",525,"201402.217.1150.3","NMFS",2014,5,10,130,19.98,40.453485,-67.315177,8,6,2,8,0,"HB",0.024
"17667",525,"201402.218.1130.6","NMFS",2014,5,10,130,20.1,40.648772,-67.181033,0,0,0,0,0,"HB",0.024
"17668",525,"201402.219.1130.5","NMFS",2014,5,10,130,20.07,40.845375,-67.461583,0,0,0,0,0,"HB",0.024
"17669",525,"201402.220.1130.7","NMFS",2014,5,10,130,20.02,40.996157,-67.53591,0,0,0,0,0,"HB",0.024
"17670",562,"201402.221.1190.3","NMFS",2014,5,10,130,20,41.179267,-67.423427,0,0,0,0,0,"HB",0.024
"17671",525,"201402.222.1130.4","NMFS",2014,5,11,131,20,41.106872,-67.25027,0,0,0,0,0,"HB",0.024
"17672",562,"201402.223.1160.4","NMFS",2014,5,11,131,20.05,41.28831,-66.960593,0,0,0,0,0,"HB",0.024
"17673",562,"201402.224.1160.12","NMFS",2014,5,11,131,20.07,41.08533,-66.990277,0,0,0,0,0,"HB",0.024
"17674",525,"201402.225.1130.9","NMFS",2014,5,11,131,20.05,40.800245,-66.83888,0,0,0,0,0,"HB",0.024
"17675",562,"201402.226.1180.4","NMFS",2014,5,11,131,20.03,40.899,-66.586167,4,4,0,4,0,"HB",0.024
"17676",562,"201402.227.1170.3","NMFS",2014,5,11,131,20.03,40.9915,-66.515333,0,0,0,0,0,"HB",0.024
"17677",562,"201402.228.1180.2","NMFS",2014,5,11,131,20.07,41.014525,-66.42652,15,14,1,15,0,"HB",0.024
"17678",562,"201402.229.1170.4","NMFS",2014,5,11,131,20.1,41.055628,-66.451725,0,0,0,0,0,"HB",0.024
"17679",562,"201402.230.1160.8","NMFS",2014,5,11,131,20,41.289753,-66.566463,0,0,0,0,0,"HB",0.024
"17680",562,"201402.231.1160.2","NMFS",2014,5,11,131,20.1,41.529228,-66.642347,0,0,0,0,0,"HB",0.024
"17681",552,"201402.232.1160.14","NMFS",2014,5,12,132,20,41.554833,-66.57143,0,0,0,0,0,"HB",0.024
"17682",552,"201402.233.1160.11","NMFS",2014,5,12,132,20.02,41.47894,-66.471645,0,0,0,0,0,"HB",0.024
"17683",552,"201402.234.1160.7","NMFS",2014,5,12,132,20.12,41.314128,-66.332337,2,1,1,2,0,"HB",0.024
"17684",552,"201402.236.1180.5","NMFS",2014,5,12,132,19.38,41.323667,-66.182667,4,4,0,4,0,"HB",0.024
"17685",552,"201402.237.1160.5","NMFS",2014,5,12,132,20,41.5155,-66.166167,1,1,0,1,0,"HB",0.024
"17686",552,"201402.238.1160.3","NMFS",2014,5,12,132,20,41.766335,-66.419223,0,0,0,0,0,"HB",0.024
"17687",552,"201402.239.1160.6","NMFS",2014,5,12,132,20.07,41.730137,-66.128715,0,0,0,0,0,"HB",0.024
"17688",552,"201402.240.1170.1","NMFS",2014,5,12,132,20.07,41.639318,-65.88235,6,5,1,6,0,"HB",0.024
"17689",551,"201402.241.1170.2","NMFS",2014,5,12,132,19.98,41.854173,-65.870798,54,49,5,54,0,"HB",0.024
"17690",464,"201402.244.1290.2","NMFS",2014,5,13,133,18.87,42.169558,-65.82079,8,7,1,8,0,"HB",0.024
"17691",551,"201402.245.1160.13","NMFS",2014,5,13,133,20,42.018342,-66.09809,38,33,5,38,0,"HB",0.024
"17692",551,"201402.246.1160.1","NMFS",2014,5,13,133,20.02,42.050185,-66.174112,9,4,5,9,0,"HB",0.024
"17693",551,"201402.247.1220.2","NMFS",2014,5,13,133,20,42.169543,-66.257382,19,18,1,19,0,"HB",0.024
"17694",551,"201402.249.1220.5","NMFS",2014,5,13,133,20.08,42.155667,-66.487,2,2,0,2,0,"HB",0.024
"17695",551,"201402.250.1210.4","NMFS",2014,5,13,133,19.95,42.13873,-66.713837,4,1,3,4,0,"HB",0.024
"17696",551,"201402.251.1210.1","NMFS",2014,5,13,133,20,42.157272,-66.84386,56,48,8,56,0,"HB",0.024
"17697",551,"201402.252.1300.1","NMFS",2014,5,14,134,20,42.319635,-67.207295,2,2,0,2,0,"HB",0.024
"17698",464,"201402.253.1290.1","NMFS",2014,5,14,134,20.15,42.522365,-67.430482,3,2,1,3,0,"HB",0.024
"17699",464,"201402.255.1300.4","NMFS",2014,5,14,134,20.02,42.550213,-67.008528,11,10,1,11,0,"HB",0.024
"17700",464,"201402.256.1290.5","NMFS",2014,5,14,134,19.97,42.635377,-66.844475,0,0,0,0,0,"HB",0.024
"17701",464,"201402.257.1290.3","NMFS",2014,5,14,134,20.42,42.613333,-66.632,0,0,0,0,0,"HB",0.024
"17702",464,"201402.260.1360.13","NMFS",2014,5,14,134,20,42.930397,-66.800652,1,1,0,1,0,"HB",0.024
"17703",465,"201402.262.1340.3","NMFS",2014,5,15,135,20.03,43.302167,-66.8575,10,10,0,10,0,"HB",0.024
"17704",465,"201402.265.1360.11","NMFS",2014,5,15,135,20.02,43.522042,-67.427652,1,1,0,1,0,"HB",0.024
"17705",465,"201402.266.1360.5","NMFS",2014,5,15,135,20.02,43.543908,-67.354915,4,4,0,4,0,"HB",0.024
"17706",465,"201402.267.1340.6","NMFS",2014,5,15,135,20.02,43.819698,-66.959605,5,4,1,5,0,"HB",0.024
"17707",465,"201402.268.1340.2","NMFS",2014,5,15,135,20,43.896675,-66.8298,13,11,2,13,0,"HB",0.024
"17708",511,"201402.269.1340.4","NMFS",2014,5,15,135,20.08,44.024687,-66.958172,6,6,0,6,0,"HB",0.024
"17709",511,"201402.270.1340.7","NMFS",2014,5,15,135,18.03,44.047315,-67.083668,6,4,2,6,0,"HB",0.024
"17710",511,"201402.271.1340.1","NMFS",2014,5,15,135,20,44.039463,-67.289983,12,9,3,11,1,"HB",0.024
"17711",511,"201402.272.1351.1","NMFS",2014,5,16,136,19.98,44.349245,-67.021548,24,15,9,24,0,"HB",0.024
"17712",511,"201402.273.1351.2","NMFS",2014,5,16,136,20.08,44.292867,-67.235202,19,18,1,19,0,"HB",0.024
"17713",511,"201402.274.1351.3","NMFS",2014,5,16,136,20.12,44.315018,-67.283932,16,15,1,16,0,"HB",0.024
"17714",511,"201402.275.1351.4","NMFS",2014,5,16,136,20,44.345653,-67.286428,11,9,2,11,0,"HB",0.024
"17715",512,"201402.276.1390.8","NMFS",2014,5,16,136,20.03,44.251378,-67.914183,586,274,312,335,251,"HB",0.024
"17716",512,"201402.277.1390.4","NMFS",2014,5,17,137,20,44.165818,-67.951607,168,82,86,137,31,"HB",0.024
"17717",512,"201402.278.1380.8","NMFS",2014,5,17,137,20.07,43.933517,-68.06512,72,56,16,71,1,"HB",0.024
"17718",512,"201402.279.1380.4","NMFS",2014,5,17,137,20.07,43.79346,-68.133557,11,9,2,11,0,"HB",0.024
"17719",512,"201402.280.1380.1","NMFS",2014,5,17,137,20,43.74236,-68.439947,15,13,2,15,0,"HB",0.024
"17720",512,"201402.281.1390.1","NMFS",2014,5,17,137,20,43.940893,-68.35406,276,179,97,266,10,"HB",0.024
"17721",512,"201402.282.1390.5","NMFS",2014,5,17,137,20.07,44.088828,-68.100295,360,180,180,289,71,"HB",0.024
"17722",511,"201402.283.1380.7","NMFS",2014,5,17,137,20.03,44.168115,-67.59299,20,17,3,20,0,"HB",0.024
"17723",512,"201402.285.1360.3","NMFS",2014,5,18,138,20.03,43.81324,-67.718203,3,3,0,3,0,"HB",0.024
"17724",512,"201402.286.1360.7","NMFS",2014,5,18,138,20.12,43.771807,-67.821625,9,9,0,9,0,"HB",0.024
"17725",512,"201402.287.1360.4","NMFS",2014,5,18,138,20.03,43.622323,-67.867945,2,2,0,2,0,"HB",0.024
"17726",515,"201402.288.1360.9","NMFS",2014,5,18,138,20.02,43.293838,-67.794767,2,2,0,2,0,"HB",0.024
"17727",515,"201402.289.1360.6","NMFS",2014,5,18,138,20.08,43.108452,-67.889833,9,9,0,9,0,"HB",0.024
"17728",515,"201402.290.1360.2","NMFS",2014,5,18,138,20.02,43.095105,-67.817762,5,5,0,5,0,"HB",0.024
"17729",515,"201402.291.1360.10","NMFS",2014,5,18,138,20.02,42.843203,-67.893122,0,0,0,0,0,"HB",0.024
"17730",515,"201402.292.1290.9","NMFS",2014,5,19,139,20.03,42.773947,-67.78727,0,0,0,0,0,"HB",0.024
"17731",515,"201402.293.1290.8","NMFS",2014,5,19,139,20.07,42.414263,-68.191018,1,1,0,1,0,"HB",0.024
"17732",522,"201402.294.1290.6","NMFS",2014,5,19,139,20.03,42.23788,-67.799655,2,1,1,2,0,"HB",0.024
"17733",522,"201402.295.1290.7","NMFS",2014,5,19,139,20,42.178403,-67.928198,6,6,0,6,0,"HB",0.024
"17734",522,"201402.296.1240.2","NMFS",2014,5,19,139,20.02,42.171257,-68.309485,1,1,0,1,0,"HB",0.024
"17735",521,"201402.297.1240.3","NMFS",2014,5,19,139,20.02,42.141983,-68.923833,0,0,0,0,0,"HB",0.024
"17736",521,"201402.298.1240.1","NMFS",2014,5,19,139,20.02,41.824705,-68.959553,1,1,0,1,0,"HB",0.024
"17737",521,"201402.299.1240.6","NMFS",2014,5,20,140,20.03,41.909,-69.130167,2,2,0,2,0,"HB",0.024
"17738",521,"201402.300.1240.7","NMFS",2014,5,20,140,20.08,42.021552,-69.087572,0,0,0,0,0,"HB",0.024
"17739",515,"201402.301.1280.2","NMFS",2014,5,20,140,20.02,42.354233,-68.971082,0,0,0,0,0,"HB",0.024
"17740",515,"201402.302.1280.6","NMFS",2014,5,20,140,20,42.563967,-68.80256,1,1,0,1,0,"HB",0.024
"17741",515,"201402.303.1280.4","NMFS",2014,5,20,140,20.12,42.709952,-68.49741,0,0,0,0,0,"HB",0.024
"17742",515,"201402.304.1370.6","NMFS",2014,5,20,140,20.03,43.099378,-68.624767,1,1,0,1,0,"HB",0.024
"17743",515,"201402.305.1370.7","NMFS",2014,5,20,140,20,43.00773,-68.938715,6,6,0,6,0,"HB",0.024
"17744",513,"201402.306.1370.5","NMFS",2014,5,21,141,20,43.23918,-69.220213,7,7,0,7,0,"HB",0.024
"17745",513,"201402.307.1380.2","NMFS",2014,5,21,141,20.08,43.507833,-69.115185,5,5,0,5,0,"HB",0.024
"17746",512,"201402.308.1390.9","NMFS",2014,5,21,141,20.02,43.7955,-69.047333,690,321,369,339,351,"HB",0.024
"17747",513,"201402.309.1380.6","NMFS",2014,5,21,141,20.18,43.547695,-69.153087,23,16,7,18,5,"HB",0.024
"17748",513,"201402.310.1380.5","NMFS",2014,5,21,141,20.1,43.50218,-69.197377,2,2,0,2,0,"HB",0.024
"17749",513,"201402.311.1380.3","NMFS",2014,5,21,141,20,43.429128,-69.563367,4,4,0,4,0,"HB",0.024
"17750",513,"201402.312.1370.1","NMFS",2014,5,22,142,20.02,43.161723,-69.268088,3,3,0,3,0,"HB",0.024
"17751",515,"201402.313.1370.3","NMFS",2014,5,22,142,20.08,42.775928,-68.998025,1,1,0,1,0,"HB",0.024
"17752",515,"201402.314.1280.1","NMFS",2014,5,22,142,20.3,42.624623,-69.25445,2,2,0,2,0,"HB",0.024
"17753",513,"201402.315.1370.4","NMFS",2014,5,22,142,20.02,42.86032,-69.50694,2,2,0,2,0,"HB",0.024
"17754",515,"201402.316.1370.2","NMFS",2014,5,22,142,20.02,42.806553,-69.561798,2,2,0,2,0,"HB",0.024
"17755",514,"201402.317.1280.3","NMFS",2014,5,22,142,20.08,42.539468,-69.81082,2,2,0,2,0,"HB",0.024
"17756",514,"201402.318.1260.6","NMFS",2014,5,22,142,20.02,42.376248,-70.063477,0,0,0,0,0,"HB",0.024
"17757",521,"201402.319.1270.2","NMFS",2014,5,22,142,20.1,42.233277,-69.999012,16,15,1,16,0,"HB",0.024
"17758",514,"201402.320.3610.3","NMFS",2014,5,23,143,19.98,42.135943,-70.078408,9,9,0,9,0,"HB",0.024
"17759",514,"201402.324.3600.2","NMFS",2014,5,28,148,20.02,41.894167,-70.4115,316,124,192,231,85,"HB",0.024
"17760",514,"201402.325.3600.4","NMFS",2014,5,28,148,20,41.924833,-70.4655,182,80,102,137,45,"HB",0.024
"17761",514,"201402.326.3590.5","NMFS",2014,5,28,148,19.98,41.839667,-70.447833,32,16,16,25,7,"HB",0.024
"17762",514,"201402.327.3590.2","NMFS",2014,5,28,148,20,41.835148,-70.384042,17,4,13,10,7,"HB",0.024
"17763",514,"201402.328.3590.1","NMFS",2014,5,28,148,19.98,41.858565,-70.293193,20,5,15,13,7,"HB",0.024
"17764",514,"201402.329.3600.3","NMFS",2014,5,28,148,20.08,41.97133,-70.284187,10,6,4,10,0,"HB",0.024
"17765",514,"201402.330.3610.1","NMFS",2014,5,28,148,20.03,42.017128,-70.272425,6,2,4,6,0,"HB",0.024
"17766",514,"201402.331.3650.2","NMFS",2014,5,28,148,20.03,42.253667,-70.616833,15,7,8,14,1,"HB",0.024
"17767",514,"201402.332.3660.2","NMFS",2014,5,28,148,19.98,42.276152,-70.59523,12,3,9,12,0,"HB",0.024
"17768",514,"201402.333.3650.1","NMFS",2014,5,28,148,20.03,42.327338,-70.680938,42,19,23,41,1,"HB",0.024
"17769",514,"201402.334.3650.3","NMFS",2014,5,29,149,20.02,42.40522,-70.763732,67,48,19,59,8,"HB",0.024
"17770",514,"201402.335.3660.1","NMFS",2014,5,29,149,20.07,42.502813,-70.658955,95,33,62,90,5,"HB",0.024
"17771",514,"201402.336.3640.2","NMFS",2014,5,29,149,20.05,42.521832,-70.720995,116,68,48,100,16,"HB",0.024
"17772",514,"201402.337.3660.3","NMFS",2014,5,29,149,19.97,42.517467,-70.633597,109,44,65,95,14,"HB",0.024
"17773",514,"201402.338.1260.3","NMFS",2014,5,29,149,20.08,42.7955,-70.362333,2,1,1,2,0,"HB",0.024
"17774",513,"201402.339.1400.1","NMFS",2014,5,29,149,20.07,42.836387,-70.50702,5,2,3,5,0,"HB",0.024
"17775",514,"201402.340.3640.4","NMFS",2014,5,29,149,20,42.774722,-70.755097,88,50,38,84,4,"HB",0.024
"17776",514,"201402.341.3640.3","NMFS",2014,5,29,149,20.02,42.829167,-70.7535,94,45,49,82,12,"HB",0.024
"17777",513,"201402.343.1400.5","NMFS",2014,5,29,149,19.98,42.898473,-70.59439,54,27,27,38,16,"HB",0.024
"17778",513,"201402.344.1270.1","NMFS",2014,5,29,149,20.02,42.937,-70.366743,4,3,1,4,0,"HB",0.024
"17779",513,"201402.345.1400.2","NMFS",2014,5,30,150,20.08,43.1555,-70.311,7,4,3,6,1,"HB",0.024
"17780",513,"201402.346.1270.5","NMFS",2014,5,30,150,20.05,43.28621,-69.985628,4,3,1,4,0,"HB",0.024
"17781",514,"201402.347.1260.5","NMFS",2014,5,30,150,20.07,42.796,-70.1765,5,4,1,4,1,"HB",0.024
"17782",514,"201402.348.1270.3","NMFS",2014,5,30,150,20.05,42.747755,-70.139717,2,2,0,2,0,"HB",0.024
"17783",514,"201402.349.1260.1","NMFS",2014,5,30,150,20,42.674527,-70.223148,4,4,0,4,0,"HB",0.024
"17784",514,"201402.350.1260.4","NMFS",2014,5,30,150,20.03,42.611243,-70.307377,1,1,0,1,0,"HB",0.024
"17785",514,"201402.351.1260.2","NMFS",2014,5,30,150,20.02,42.486238,-70.339135,2,2,0,2,0,"HB",0.024
"17786",521,"201402.352.3610.2","NMFS",2014,5,31,151,20.05,42.069015,-69.981857,2,2,0,2,0,"HB",0.024
"17787",521,"201402.353.3560.2","NMFS",2014,5,31,151,19.97,41.794812,-69.893542,1,1,0,1,0,"HB",0.024
"17788",521,"201402.354.3560.3","NMFS",2014,5,31,151,19.97,41.7125,-69.8755,2,0,2,2,0,"HB",0.024
"17789",521,"201402.356.1250.8","NMFS",2014,5,31,151,20,41.576,-69.586167,3,3,0,3,0,"HB",0.024
"17790",521,"201402.357.1280.5","NMFS",2014,5,31,151,19.97,42.050452,-69.571925,3,3,0,3,0,"HB",0.024
"17791",526,"201404.208.1090.5","NMFS",2014,10,8,281,20.02,40.769577,-69.729627,0,0,0,0,0,"HB",0.024
"17792",526,"201404.210.1090.6","NMFS",2014,10,8,281,19.98,40.7155,-69.754333,0,0,0,0,0,"HB",0.024
"17793",526,"201404.211.1100.6","NMFS",2014,10,8,281,20.02,40.351605,-69.440105,0,0,0,0,0,"HB",0.024
"17794",526,"201404.212.1100.8","NMFS",2014,10,9,282,20.02,40.409253,-69.873413,2,2,0,2,0,"HB",0.024
"17795",526,"201404.213.1100.3","NMFS",2014,10,9,282,20.02,40.467985,-69.930602,2,1,1,2,0,"HB",0.024
"17796",526,"201404.223.1120.1","NMFS",2014,10,10,283,20.02,39.944522,-69.583785,20,4,16,17,3,"HB",0.024
"17797",526,"201404.224.1120.2","NMFS",2014,10,10,283,20.02,39.982908,-69.225985,56,26,30,51,5,"HB",0.024
"17798",526,"201404.225.1110.4","NMFS",2014,10,10,283,20.05,40.051097,-69.223823,0,0,0,0,0,"HB",0.024
"17799",526,"201404.226.1110.2","NMFS",2014,10,10,283,20.02,40.073832,-69.122238,0,0,0,0,0,"HB",0.024
"17800",526,"201404.227.1110.1","NMFS",2014,10,10,283,20.02,40.228587,-68.982225,0,0,0,0,0,"HB",0.024
"17801",526,"201404.228.1120.3","NMFS",2014,10,10,283,20.15,40.077045,-68.894418,0,0,0,0,0,"HB",0.024
"17802",525,"201404.229.1150.1","NMFS",2014,10,11,284,20.05,40.168743,-68.545658,2,1,1,2,0,"HB",0.024
"17803",525,"201404.230.1150.2","NMFS",2014,10,11,284,20.02,40.239167,-68.52,0,0,0,0,0,"HB",0.024
"17804",525,"201404.231.1140.1","NMFS",2014,10,11,284,19.98,40.292568,-68.502257,0,0,0,0,0,"HB",0.024
"17805",525,"201404.232.1140.4","NMFS",2014,10,11,284,20,40.270388,-68.430162,0,0,0,0,0,"HB",0.024
"17806",525,"201404.233.1140.3","NMFS",2014,10,11,284,20.02,40.379625,-68.30139,0,0,0,0,0,"HB",0.024
"17807",525,"201404.234.1140.2","NMFS",2014,10,11,284,20.07,40.349377,-67.945245,0,0,0,0,0,"HB",0.024
"17808",525,"201404.235.1130.1","NMFS",2014,10,11,284,20.02,40.651718,-68.03827,0,0,0,0,0,"HB",0.024
"17809",525,"201404.236.1190.3","NMFS",2014,10,11,284,19.98,40.854035,-68.220523,0,0,0,0,0,"HB",0.024
"17810",525,"201404.237.1190.6","NMFS",2014,10,11,284,20.02,40.901828,-68.345643,1,1,0,1,0,"HB",0.024
"17811",525,"201404.238.1190.4","NMFS",2014,10,11,284,19.98,40.789353,-68.40887,0,0,0,0,0,"HB",0.024
"17812",525,"201404.239.1130.6","NMFS",2014,10,12,285,20.05,40.574947,-68.80301,0,0,0,0,0,"HB",0.024
"17813",526,"201404.240.1100.9","NMFS",2014,10,12,285,20.02,40.816993,-69.015838,3,1,2,3,0,"HB",0.024
"17814",526,"201404.242.1100.5","NMFS",2014,10,12,285,19.37,40.847373,-68.933348,3,2,1,2,1,"HB",0.024
"17815",525,"201404.244.1130.11","NMFS",2014,10,12,285,20.03,40.863333,-68.791333,3,3,0,3,0,"HB",0.024
"17816",521,"201404.246.1230.7","NMFS",2014,10,12,285,19.98,41.023667,-68.881833,5,4,1,4,1,"HB",0.024
"17817",522,"201404.247.1230.6","NMFS",2014,10,12,285,20,41.019853,-68.75343,2,1,1,2,0,"HB",0.024
"17818",525,"201404.248.1190.9","NMFS",2014,10,12,285,20,40.991305,-68.561318,0,0,0,0,0,"HB",0.024
"17819",525,"201404.249.1190.5","NMFS",2014,10,13,286,20.02,40.973378,-68.057555,0,0,0,0,0,"HB",0.024
"17820",525,"201404.250.1130.9","NMFS",2014,10,13,286,20.02,40.75267,-67.634798,1,1,0,1,0,"HB",0.024
"17821",525,"201404.252.1130.7","NMFS",2014,10,13,286,20.02,40.602667,-67.594667,0,0,0,0,0,"HB",0.024
"17822",525,"201404.253.1130.10","NMFS",2014,10,13,286,20.02,40.93487,-67.439898,2,2,0,2,0,"HB",0.024
"17823",525,"201404.254.1130.3","NMFS",2014,10,13,286,20.05,40.939083,-67.365978,2,2,0,2,0,"HB",0.024
"17824",525,"201404.255.1130.4","NMFS",2014,10,13,286,20.02,40.906978,-67.13502,7,6,1,7,0,"HB",0.024
"17825",525,"201404.256.1130.8","NMFS",2014,10,13,286,19.98,40.94616,-67.114648,8,8,0,8,0,"HB",0.024
"17826",525,"201404.257.1130.5","NMFS",2014,10,13,286,20,40.969832,-67.086413,3,3,0,3,0,"HB",0.024
"17827",562,"201404.258.1160.4","NMFS",2014,10,13,286,20,40.874387,-66.858913,1,1,0,1,0,"HB",0.024
"17828",525,"201404.259.1150.3","NMFS",2014,10,13,286,20.02,40.695363,-66.869055,5,4,1,5,0,"HB",0.024
"17829",562,"201404.260.1180.4","NMFS",2014,10,14,287,20,40.815902,-66.704315,2,2,0,2,0,"HB",0.024
"17830",562,"201404.261.1170.4","NMFS",2014,10,14,287,20.03,40.849883,-66.711335,1,1,0,1,0,"HB",0.024
"17831",562,"201404.262.1160.9","NMFS",2014,10,14,287,20,40.871738,-66.724488,1,1,0,1,0,"HB",0.024
"17832",562,"201404.263.1180.2","NMFS",2014,10,14,287,20.02,41.046032,-66.41669,6,5,1,6,0,"HB",0.024
"17833",562,"201404.264.1170.3","NMFS",2014,10,14,287,20,41.123485,-66.378197,4,4,0,4,0,"HB",0.024
"17834",552,"201404.266.1180.5","NMFS",2014,10,14,287,20,41.2255,-66.257333,76,68,8,76,0,"HB",0.024
"17835",552,"201404.267.1180.3","NMFS",2014,10,14,287,20,41.371307,-66.056733,13,11,2,13,0,"HB",0.024
"17836",552,"201404.268.1170.1","NMFS",2014,10,14,287,20,41.4216,-66.14607,3,3,0,3,0,"HB",0.024
"17837",552,"201404.269.1170.2","NMFS",2014,10,14,287,20,41.441777,-66.019918,3,3,0,3,0,"HB",0.024
"17838",552,"201404.270.1160.7","NMFS",2014,10,15,288,20.02,41.53,-66.262,7,7,0,7,0,"HB",0.024
"17839",552,"201404.271.1160.14","NMFS",2014,10,15,288,19.98,41.544715,-66.175867,8,8,0,8,0,"HB",0.024
"17840",552,"201404.272.1160.8","NMFS",2014,10,15,288,20.03,41.578013,-66.091372,3,2,1,3,0,"HB",0.024
"17841",552,"201404.273.1160.12","NMFS",2014,10,15,288,20.02,41.655667,-66.071508,10,9,1,10,0,"HB",0.024
"17842",552,"201404.274.1160.2","NMFS",2014,10,15,288,20.02,41.660082,-65.977977,7,7,0,7,0,"HB",0.024
"17843",464,"201404.275.1290.8","NMFS",2014,10,15,288,20.08,42.273052,-65.757735,1,1,0,1,0,"HB",0.024
"17844",464,"201404.276.1290.1","NMFS",2014,10,15,288,20.02,42.372593,-66.041817,0,0,0,0,0,"HB",0.024
"17845",551,"201404.277.1220.2","NMFS",2014,10,15,288,20,42.164765,-66.237805,7,7,0,7,0,"HB",0.024
"17846",551,"201404.278.1290.10","NMFS",2014,10,15,288,20.02,42.241285,-66.411563,2,2,0,2,0,"HB",0.024
"17847",551,"201404.279.1210.1","NMFS",2014,10,15,288,20,42.154802,-66.72442,2,1,1,2,0,"HB",0.024
"17848",551,"201404.280.1210.4","NMFS",2014,10,16,289,20,42.139513,-66.626755,1,1,0,1,0,"HB",0.024
"17849",551,"201404.281.1160.11","NMFS",2014,10,16,289,20.02,42.024265,-66.54907,2,1,1,2,0,"HB",0.024
"17850",551,"201404.282.1160.3","NMFS",2014,10,16,289,20,41.850983,-66.64962,15,11,4,15,0,"HB",0.024
"17851",562,"201404.283.1200.2","NMFS",2014,10,16,289,20.02,41.76265,-67.529227,3,3,0,3,0,"HB",0.024
"17852",562,"201404.284.1190.8","NMFS",2014,10,16,289,20.03,41.651407,-67.450142,0,0,0,0,0,"HB",0.024
"17853",522,"201404.285.1200.3","NMFS",2014,10,16,289,20.02,41.649262,-67.70399,0,0,0,0,0,"HB",0.024
"17854",522,"201404.286.1190.7","NMFS",2014,10,16,289,20,41.576818,-67.759512,0,0,0,0,0,"HB",0.024
"17855",522,"201404.288.1190.10","NMFS",2014,10,16,289,19.98,41.337,-67.732667,0,0,0,0,0,"HB",0.024
"17856",525,"201404.289.1190.2","NMFS",2014,10,17,290,20.02,41.323362,-68.010568,0,0,0,0,0,"HB",0.024
"17857",522,"201404.291.1200.4","NMFS",2014,10,17,290,20,41.216167,-68.482833,1,1,0,1,0,"HB",0.024
"17858",562,"201404.299.1160.5","NMFS",2014,10,18,291,20,41.551333,-66.8945,2,2,0,2,0,"HB",0.024
"17859",562,"201404.303.1160.6","NMFS",2014,10,18,291,19.97,41.562667,-66.8215,5,5,0,5,0,"HB",0.024
"17860",562,"201404.335.1160.1","NMFS",2014,10,20,293,20.02,41.293158,-66.74302,1,1,0,1,0,"HB",0.024
"17861",562,"201404.343.1160.13","NMFS",2014,10,20,293,19.98,41.153508,-66.781955,0,0,0,0,0,"HB",0.024
"17862",562,"201404.345.1160.10","NMFS",2014,10,20,293,20.02,41.11913,-66.926472,2,2,0,2,0,"HB",0.024
"17863",522,"201404.346.1200.6","NMFS",2014,10,21,294,20.02,41.451115,-68.02896,0,0,0,0,0,"HB",0.024
"17864",522,"201404.347.1230.2","NMFS",2014,10,21,294,20,41.361948,-68.542528,14,14,0,14,0,"HB",0.024
"17865",522,"201404.348.1240.5","NMFS",2014,10,21,294,19.92,41.361117,-68.77276,3,3,0,3,0,"HB",0.024
"17866",521,"201404.349.1240.2","NMFS",2014,10,21,294,20.02,41.412825,-69.000298,0,0,0,0,0,"HB",0.024
"17867",521,"201404.350.1240.6","NMFS",2014,10,21,294,20.03,41.55491,-69.178327,0,0,0,0,0,"HB",0.024
"17868",521,"201404.351.1240.8","NMFS",2014,10,21,294,20.02,41.698208,-69.129908,0,0,0,0,0,"HB",0.024
"17869",521,"201404.352.1230.1","NMFS",2014,10,21,294,19.98,41.503895,-69.332092,0,0,0,0,0,"HB",0.024
"17870",521,"201404.353.1230.3","NMFS",2014,10,21,294,20.02,41.534272,-69.371745,0,0,0,0,0,"HB",0.024
"17871",521,"201404.356.1250.1","NMFS",2014,10,22,295,20,41.549027,-69.713587,1,1,0,1,0,"HB",0.024
"17872",521,"201404.357.1250.2","NMFS",2014,10,22,295,20,41.596333,-69.729,14,10,4,14,0,"HB",0.024
"17873",521,"201404.359.1230.8","NMFS",2014,10,22,295,20.02,41.726167,-69.752833,8,6,2,8,0,"HB",0.024
"17874",514,"201404.360.3610.3","NMFS",2014,10,22,295,19.98,42.006665,-70.256033,47,26,21,44,3,"HB",0.024
"17875",514,"201404.361.3600.3","NMFS",2014,10,22,295,20.02,41.880758,-70.281203,27,8,19,26,1,"HB",0.024
"17876",514,"201404.362.3590.3","NMFS",2014,10,23,296,20,41.835618,-70.381777,12,5,7,9,3,"HB",0.024
"17877",514,"201404.363.3590.2","NMFS",2014,10,23,296,19.98,41.82655,-70.437988,63,35,28,46,17,"HB",0.024
"17878",514,"201404.364.3590.1","NMFS",2014,10,23,296,18.53,41.789875,-70.42081,62,24,38,31,31,"HB",0.024
"17879",514,"201404.365.3600.2","NMFS",2014,10,23,296,20.03,41.959827,-70.346088,126,58,68,111,15,"HB",0.024
"17880",514,"201404.366.1280.5","NMFS",2014,10,29,302,20.03,42.343262,-69.682567,0,0,0,0,0,"HB",0.024
"17881",515,"201404.367.1280.4","NMFS",2014,10,29,302,20,42.501167,-69.4775,0,0,0,0,0,"HB",0.024
"17882",515,"201404.368.1280.7","NMFS",2014,10,29,302,20.15,42.476333,-69.321167,1,1,0,1,0,"HB",0.024
"17883",521,"201404.369.1280.3","NMFS",2014,10,29,302,20.02,42.00832,-69.375802,1,1,0,1,0,"HB",0.024
"17884",521,"201404.370.1280.1","NMFS",2014,10,29,302,19.98,42.30601,-68.88251,0,0,0,0,0,"HB",0.024
"17885",515,"201404.371.1280.6","NMFS",2014,10,29,302,20.08,42.41067,-68.67045,0,0,0,0,0,"HB",0.024
"17886",522,"201404.372.1240.7","NMFS",2014,10,30,303,20.07,42.143392,-68.724378,0,0,0,0,0,"HB",0.024
"17887",522,"201404.373.1240.4","NMFS",2014,10,30,303,20.02,42.042333,-68.643,0,0,0,0,0,"HB",0.024
"17888",522,"201404.374.1240.3","NMFS",2014,10,30,303,20.02,42.019333,-68.596,0,0,0,0,0,"HB",0.024
"17889",522,"201404.375.1240.1","NMFS",2014,10,30,303,20.02,41.98941,-68.53483,1,1,0,1,0,"HB",0.024
"17890",522,"201404.376.1210.2","NMFS",2014,10,30,303,20.13,41.87117,-67.925727,28,26,2,28,0,"HB",0.024
"17891",522,"201404.377.1210.3","NMFS",2014,10,30,303,20.02,41.899093,-67.888348,16,14,2,16,0,"HB",0.024
"17892",522,"201404.378.1220.1","NMFS",2014,10,30,303,20,42.082673,-67.915015,8,7,1,8,0,"HB",0.024
"17893",515,"201404.379.1290.3","NMFS",2014,10,30,303,19.98,42.418658,-68.058433,0,0,0,0,0,"HB",0.024
"17894",515,"201404.380.1370.7","NMFS",2014,10,31,304,20.15,42.747683,-68.619038,0,0,0,0,0,"HB",0.024
"17895",515,"201404.381.1360.1","NMFS",2014,10,31,304,20.22,42.925333,-68.2615,0,0,0,0,0,"HB",0.024
"17896",512,"201404.382.1380.4","NMFS",2014,10,31,304,19.98,43.470382,-68.504515,0,0,0,0,0,"HB",0.024
"17897",512,"201404.383.1380.1","NMFS",2014,10,31,304,20.12,43.53739,-68.560932,4,4,0,4,0,"HB",0.024
"17898",512,"201404.384.1380.6","NMFS",2014,10,31,304,20.13,43.645662,-68.491,0,0,0,0,0,"HB",0.024
"17899",512,"201404.385.1380.2","NMFS",2014,10,31,304,20.02,43.659788,-68.223085,0,0,0,0,0,"HB",0.024
"17900",511,"201404.386.1380.3","NMFS",2014,10,31,304,19.98,44.048882,-67.756332,27,20,7,27,0,"HB",0.024
"17901",511,"201404.387.1351.2","NMFS",2014,11,1,305,20,44.347158,-67.290625,37,33,4,37,0,"HB",0.024
"17902",511,"201404.389.1351.5","NMFS",2014,11,4,308,20.08,44.34898,-67.134647,25,17,8,25,0,"HB",0.024
"17903",511,"201404.390.1351.3","NMFS",2014,11,4,308,20.05,44.35496,-67.033048,50,27,23,50,0,"HB",0.024
"17904",466,"201404.392.1340.2","NMFS",2014,11,4,308,20.02,44.01206,-66.823293,74,39,35,74,0,"HB",0.024
"17905",465,"201404.393.1340.3","NMFS",2014,11,4,308,20.05,43.956667,-66.791,50,31,19,46,4,"HB",0.024
"17906",465,"201404.394.1340.4","NMFS",2014,11,4,308,19.98,43.78166,-66.79724,40,23,17,40,0,"HB",0.024
"17907",465,"201404.395.1340.1","NMFS",2014,11,4,308,20,43.659047,-66.655833,55,31,24,53,2,"HB",0.024
"17908",465,"201404.396.1340.6","NMFS",2014,11,4,308,20.05,43.592782,-66.65416,38,20,18,37,1,"HB",0.024
"17909",465,"201404.397.1340.5","NMFS",2014,11,4,308,20.07,43.610557,-66.878963,9,5,4,9,0,"HB",0.024
"17910",465,"201404.398.1360.9","NMFS",2014,11,5,309,20.03,43.312168,-67.004123,27,20,7,27,0,"HB",0.024
"17911",465,"201404.399.1360.12","NMFS",2014,11,5,309,20.02,43.211282,-67.26118,6,6,0,6,0,"HB",0.024
"17912",465,"201404.400.1360.10","NMFS",2014,11,5,309,20.02,43.408138,-67.425878,0,0,0,0,0,"HB",0.024
"17913",465,"201404.402.1360.5","NMFS",2014,11,5,309,20.07,43.174843,-67.34905,2,2,0,2,0,"HB",0.024
"17914",465,"201404.403.1360.6","NMFS",2014,11,5,309,20.25,43.045477,-67.179212,10,10,0,10,0,"HB",0.024
"17915",464,"201404.404.1360.11","NMFS",2014,11,5,309,20,42.838707,-67.086998,29,28,1,29,0,"HB",0.024
"17916",464,"201404.405.1360.2","NMFS",2014,11,5,309,20.03,42.841388,-67.13335,12,9,3,12,0,"HB",0.024
"17917",464,"201404.406.1290.5","NMFS",2014,11,5,309,19.98,42.627713,-66.830835,3,2,1,3,0,"HB",0.024
"17918",464,"201404.407.1290.7","NMFS",2014,11,6,310,20.23,42.563752,-66.727673,8,8,0,8,0,"HB",0.024
"17919",464,"201404.408.1300.1","NMFS",2014,11,6,310,20.25,42.53538,-66.945925,2,2,0,2,0,"HB",0.024
"17920",464,"201404.409.1300.3","NMFS",2014,11,6,310,20.02,42.463602,-66.954683,7,5,2,7,0,"HB",0.024
"17921",551,"201404.410.1220.4","NMFS",2014,11,6,310,19.97,42.214887,-67.101162,11,8,3,9,2,"HB",0.024
"17922",561,"201404.412.1200.7","NMFS",2014,11,6,310,20.18,42.047667,-67.184333,0,0,0,0,0,"HB",0.024
"17923",522,"201404.413.1220.3","NMFS",2014,11,6,310,20.03,42.111995,-67.735395,2,2,0,2,0,"HB",0.024
"17924",522,"201404.414.1290.6","NMFS",2014,11,6,310,20.02,42.25809,-67.707817,2,2,0,2,0,"HB",0.024
"17925",515,"201404.415.1290.2","NMFS",2014,11,6,310,20,42.471323,-67.707955,1,1,0,1,0,"HB",0.024
"17926",515,"201404.416.1290.4","NMFS",2014,11,6,310,19.93,42.555033,-67.904575,0,0,0,0,0,"HB",0.024
"17927",515,"201404.417.1360.4","NMFS",2014,11,7,311,20.22,42.802175,-67.953572,0,0,0,0,0,"HB",0.024
"17928",515,"201404.418.1370.1","NMFS",2014,11,7,311,19.98,42.809847,-69.078188,0,0,0,0,0,"HB",0.024
"17929",515,"201404.419.1370.3","NMFS",2014,11,7,311,19.92,42.773883,-69.344983,0,0,0,0,0,"HB",0.024
"17930",513,"201404.420.1370.4","NMFS",2014,11,7,311,20.18,42.874333,-69.425833,1,1,0,1,0,"HB",0.024
"17931",515,"201404.421.1370.5","NMFS",2014,11,7,311,20,43.166812,-68.970513,0,0,0,0,0,"HB",0.024
"17932",512,"201404.422.1380.7","NMFS",2014,11,7,311,20,43.38587,-68.91509,2,2,0,2,0,"HB",0.024
"17933",512,"201404.423.1390.3","NMFS",2014,11,8,312,18.15,43.923447,-68.774172,978,468,510,636,342,"HB",0.024
"17934",513,"201404.425.1390.7","NMFS",2014,11,8,312,17.02,43.65825,-69.02737,492,300,192,484,8,"HB",0.024
"17935",513,"201404.426.1380.8","NMFS",2014,11,8,312,19.98,43.559318,-69.618132,46,38,8,46,0,"HB",0.024
"17936",513,"201404.427.1380.5","NMFS",2014,11,8,312,20.02,43.364203,-69.480562,2,2,0,2,0,"HB",0.024
"17937",513,"201404.428.1370.2","NMFS",2014,11,9,313,20.08,43.13876,-69.911827,1,1,0,1,0,"HB",0.024
"17938",513,"201404.429.1370.6","NMFS",2014,11,9,313,20.1,43.056665,-69.77427,0,0,0,0,0,"HB",0.024
"17939",513,"201404.430.1280.2","NMFS",2014,11,9,313,20.03,42.94801,-69.72578,0,0,0,0,0,"HB",0.024
"17940",514,"201404.431.1270.4","NMFS",2014,11,9,313,19.97,42.67396,-69.954495,1,1,0,1,0,"HB",0.024
"17941",514,"201404.432.1270.5","NMFS",2014,11,9,313,19.98,42.737108,-69.984687,0,0,0,0,0,"HB",0.024
"17942",514,"201404.433.1270.3","NMFS",2014,11,9,313,19.97,42.81967,-70.094442,0,0,0,0,0,"HB",0.024
"17943",513,"201404.434.1270.1","NMFS",2014,11,9,313,20.1,42.948,-70.1435,0,0,0,0,0,"HB",0.024
"17944",514,"201404.435.1260.6","NMFS",2014,11,9,313,20.07,42.7965,-70.227833,5,2,3,5,0,"HB",0.024
"17945",514,"201404.436.1260.3","NMFS",2014,11,9,313,20,42.778717,-70.20353,0,0,0,0,0,"HB",0.024
"17946",514,"201404.437.3660.1","NMFS",2014,11,9,313,20,42.7175,-70.436667,81,49,32,78,3,"HB",0.024
"17947",514,"201404.438.1260.8","NMFS",2014,11,9,313,19.97,42.773077,-70.455198,17,12,5,17,0,"HB",0.024
"17948",514,"201404.439.1400.1","NMFS",2014,11,9,313,19.95,42.820795,-70.414598,1,0,1,1,0,"HB",0.024
"17949",513,"201404.440.1400.4","NMFS",2014,11,10,314,20.18,42.926578,-70.497065,160,92,68,158,2,"HB",0.024
"17950",513,"201404.441.1400.3","NMFS",2014,11,10,314,20.03,42.865373,-70.531407,98,57,41,98,0,"HB",0.024
"17951",514,"201404.442.3640.2","NMFS",2014,11,10,314,20,42.78011,-70.731778,13,7,6,13,0,"HB",0.024
"17952",514,"201404.443.3660.2","NMFS",2014,11,10,314,19.98,42.71437,-70.49633,124,74,50,109,15,"HB",0.024
"17953",514,"201404.446.1260.7","NMFS",2014,11,10,314,19.98,42.53861,-70.457485,80,45,35,73,7,"HB",0.024
"17954",514,"201404.447.3660.3","NMFS",2014,11,10,314,19.53,42.5123,-70.667455,212,97,115,168,44,"HB",0.024
"17955",514,"201404.448.3650.3","NMFS",2014,11,10,314,20,42.446333,-70.7985,568,296,272,376,192,"HB",0.024
"17956",514,"201404.449.3640.3","NMFS",2014,11,11,315,20.08,42.393128,-70.787747,409,242,167,294,115,"HB",0.024
"17957",514,"201404.452.1260.9","NMFS",2014,11,11,315,20,42.2505,-70.367833,52,39,13,50,2,"HB",0.024
"17958",514,"201404.453.3610.1","NMFS",2014,11,11,315,20.03,42.090457,-70.450603,219,146,73,196,23,"HB",0.024
"17959",514,"201404.454.3600.4","NMFS",2014,11,11,315,17.18,41.972283,-70.458092,166,79,87,141,25,"HB",0.024
"17960",514,"201404.455.3610.2","NMFS",2014,11,11,315,19.98,42.12233,-70.073637,7,5,2,7,0,"HB",0.024
"17961",521,"201404.456.1270.2","NMFS",2014,11,12,316,20.12,42.155892,-69.957657,0,0,0,0,0,"HB",0.024
"17962",521,"201404.457.1260.2","NMFS",2014,11,12,316,19.85,42.054218,-69.907115,25,23,2,25,0,"HB",0.024
"17963",521,"201404.460.3560.3","NMFS",2014,11,12,316,19.05,41.803667,-69.901667,0,0,0,0,0,"HB",0.024
"17964",521,"201404.461.3560.1","NMFS",2014,11,12,316,20.07,41.781388,-69.888845,1,0,1,1,0,"HB",0.024
"17965",514,"201404.462.3650.5","NMFS",2014,11,13,317,20.08,42.723653,-70.645825,46,23,23,40,6,"HB",0.024
"17966",514,"201404.463.3650.1","NMFS",2014,11,13,317,20.08,42.73406,-70.656778,53,24,29,47,6,"HB",0.024
"17967",526,"201502.203.1090.5","NMFS",2015,4,8,98,20,40.911737,-69.806652,0,0,0,0,0,"HB",0.024
"17968",526,"201502.204.1090.2","NMFS",2015,4,9,99,20.07,40.703717,-69.33241,0,0,0,0,0,"HB",0.024
"17969",526,"201502.205.1100.2","NMFS",2015,4,9,99,19.98,40.536275,-69.527,0,0,0,0,0,"HB",0.024
"17970",526,"201502.214.1120.2","NMFS",2015,4,10,100,20,39.94631,-69.974452,0,0,0,0,0,"HB",0.024
"17971",526,"201502.215.1110.3","NMFS",2015,4,10,100,19.98,39.973885,-69.873807,0,0,0,0,0,"HB",0.024
"17972",526,"201502.216.1110.4","NMFS",2015,4,10,100,19.97,40.045022,-69.6163,0,0,0,0,0,"HB",0.024
"17973",526,"201502.217.1100.6","NMFS",2015,4,10,100,20.08,40.158498,-69.443332,0,0,0,0,0,"HB",0.024
"17974",526,"201502.218.1100.8","NMFS",2015,4,10,100,20.08,40.23824,-69.56259,0,0,0,0,0,"HB",0.024
"17975",526,"201502.219.1100.7","NMFS",2015,4,10,100,20.05,40.323875,-69.596918,0,0,0,0,0,"HB",0.024
"17976",526,"201502.220.1100.3","NMFS",2015,4,10,100,19.98,40.371282,-69.279825,0,0,0,0,0,"HB",0.024
"17977",526,"201502.221.1110.2","NMFS",2015,4,10,100,20,40.14493,-69.01281,0,0,0,0,0,"HB",0.024
"17978",526,"201502.222.1110.1","NMFS",2015,4,10,100,19.97,40.240973,-68.963213,0,0,0,0,0,"HB",0.024
"17979",525,"201502.223.1130.9","NMFS",2015,4,11,101,20.02,40.41772,-68.776455,0,0,0,0,0,"HB",0.024
"17980",526,"201502.224.1100.5","NMFS",2015,4,11,101,20.03,40.477338,-69.021905,0,0,0,0,0,"HB",0.024
"17981",525,"201502.225.1130.5","NMFS",2015,4,11,101,19.98,40.791185,-68.719685,0,0,0,0,0,"HB",0.024
"17982",525,"201502.226.1190.11","NMFS",2015,4,11,101,19.98,40.913825,-68.438452,0,0,0,0,0,"HB",0.024
"17983",522,"201502.227.1200.2","NMFS",2015,4,11,101,20.73,41.090347,-68.571615,1,0,1,1,0,"HB",0.024
"17984",521,"201502.228.1230.6","NMFS",2015,4,11,101,19.98,41.254982,-68.858938,0,0,0,0,0,"HB",0.024
"17985",521,"201502.229.1250.3","NMFS",2015,4,11,101,19.95,41.170527,-69.272522,13,7,6,9,4,"HB",0.024
"17986",521,"201502.231.1230.1","NMFS",2015,4,12,102,20.03,41.287107,-69.224245,0,0,0,0,0,"HB",0.024
"17987",521,"201502.232.1230.2","NMFS",2015,4,12,102,20.03,41.292178,-69.167425,0,0,0,0,0,"HB",0.024
"17988",521,"201502.233.1230.4","NMFS",2015,4,12,102,19.98,41.464228,-69.28185,0,0,0,0,0,"HB",0.024
"17989",521,"201502.234.1250.2","NMFS",2015,4,12,102,19.97,41.471792,-69.401407,2,1,1,1,1,"HB",0.024
"17990",521,"201502.236.1250.5","NMFS",2015,4,12,102,20.03,41.586512,-69.626308,0,0,0,0,0,"HB",0.024
"17991",521,"201502.237.1250.4","NMFS",2015,4,12,102,20.02,41.586407,-69.7164,0,0,0,0,0,"HB",0.024
"17992",521,"201502.238.3560.3","NMFS",2015,4,12,102,20,41.78664,-69.890798,0,0,0,0,0,"HB",0.024
"17993",521,"201502.240.3560.2","NMFS",2015,4,12,102,19.98,41.818267,-69.900572,0,0,0,0,0,"HB",0.024
"17994",521,"201502.241.1240.6","NMFS",2015,4,12,102,19.98,41.737428,-69.544485,1,1,0,1,0,"HB",0.024
"17995",521,"201502.242.1240.4","NMFS",2015,4,13,103,20.03,41.53774,-69.148947,4,4,0,4,0,"HB",0.024
"17996",521,"201502.243.1240.5","NMFS",2015,4,13,103,20,41.558953,-68.836198,5,4,1,5,0,"HB",0.024
"17997",522,"201502.244.1230.7","NMFS",2015,4,13,103,20,41.409215,-68.551542,0,0,0,0,0,"HB",0.024
"17998",522,"201502.245.1230.5","NMFS",2015,4,13,103,19.97,41.585305,-68.483017,0,0,0,0,0,"HB",0.024
"17999",522,"201502.246.1200.6","NMFS",2015,4,13,103,20,41.611505,-68.423008,0,0,0,0,0,"HB",0.024
"18000",522,"201502.247.1240.3","NMFS",2015,4,13,103,20.02,41.882755,-68.402567,14,14,0,14,0,"HB",0.024
"18001",522,"201502.249.1290.11","NMFS",2015,4,13,103,20.05,41.8739,-68.280932,1,1,0,1,0,"HB",0.024
"18002",522,"201502.250.1220.1","NMFS",2015,4,13,103,19.97,41.872898,-68.191585,0,0,0,0,0,"HB",0.024
"18003",522,"201502.251.1210.2","NMFS",2015,4,13,103,20.02,41.91333,-67.95382,0,0,0,0,0,"HB",0.024
"18004",522,"201502.252.1210.3","NMFS",2015,4,13,103,19.98,41.934703,-67.84568,1,0,1,0,1,"HB",0.024
"18005",522,"201502.253.1200.3","NMFS",2015,4,13,103,19.97,41.81332,-67.699255,0,0,0,0,0,"HB",0.024
"18006",561,"201502.254.1200.4","NMFS",2015,4,13,103,20.02,41.855883,-67.434162,0,0,0,0,0,"HB",0.024
"18007",562,"201502.255.1190.5","NMFS",2015,4,14,104,20.02,41.64627,-67.318673,0,0,0,0,0,"HB",0.024
"18008",562,"201502.256.1190.1","NMFS",2015,4,14,104,18.38,41.598878,-67.445167,0,0,0,0,0,"HB",0.024
"18009",562,"201502.257.1160.7","NMFS",2015,4,14,104,19.97,41.487342,-67.091283,0,0,0,0,0,"HB",0.024
"18010",562,"201502.259.1190.10","NMFS",2015,4,14,104,20.02,41.452625,-67.53744,0,0,0,0,0,"HB",0.024
"18011",562,"201502.260.1190.4","NMFS",2015,4,14,104,19.98,41.387868,-67.56677,0,0,0,0,0,"HB",0.024
"18012",522,"201502.261.1200.5","NMFS",2015,4,14,104,20,41.535773,-67.959945,0,0,0,0,0,"HB",0.024
"18013",525,"201502.262.1190.9","NMFS",2015,4,14,104,20.3,41.222055,-68.067825,0,0,0,0,0,"HB",0.024
"18014",525,"201502.263.1190.12","NMFS",2015,4,15,105,20.02,41.19572,-67.977292,0,0,0,0,0,"HB",0.024
"18015",525,"201502.265.1190.6","NMFS",2015,4,15,105,20,40.867368,-68.302178,0,0,0,0,0,"HB",0.024
"18016",525,"201502.266.1130.8","NMFS",2015,4,15,105,19.98,40.632245,-68.337853,0,0,0,0,0,"HB",0.024
"18017",525,"201502.267.1130.2","NMFS",2015,4,15,105,20.02,40.587668,-68.092625,0,0,0,0,0,"HB",0.024
"18018",525,"201502.268.1140.1","NMFS",2015,4,15,105,20.1,40.483885,-67.854492,0,0,0,0,0,"HB",0.024
"18019",525,"201502.269.1150.3","NMFS",2015,4,15,105,19.97,40.39206,-67.8846,0,0,0,0,0,"HB",0.024
"18020",525,"201502.270.1150.1","NMFS",2015,4,15,105,19.98,40.349138,-67.740163,2,1,1,2,0,"HB",0.024
"18021",525,"201502.271.1140.3","NMFS",2015,4,15,105,20.02,40.419453,-67.59754,0,0,0,0,0,"HB",0.024
"18022",525,"201502.272.1140.4","NMFS",2015,4,16,106,20.02,40.523658,-67.538602,0,0,0,0,0,"HB",0.024
"18023",525,"201502.273.1150.2","NMFS",2015,4,16,106,20.03,40.461948,-67.251325,22,19,3,22,0,"HB",0.024
"18024",525,"201502.274.1130.6","NMFS",2015,4,16,106,20,40.68235,-67.265042,0,0,0,0,0,"HB",0.024
"18025",525,"201502.275.1130.4","NMFS",2015,4,16,106,19.98,40.742778,-67.543653,0,0,0,0,0,"HB",0.024
"18026",525,"201502.276.1130.10","NMFS",2015,4,16,106,20,40.770212,-67.66007,0,0,0,0,0,"HB",0.024
"18027",525,"201502.277.1130.7","NMFS",2015,4,16,106,20.03,40.801138,-67.702188,0,0,0,0,0,"HB",0.024
"18028",525,"201502.278.1130.1","NMFS",2015,4,16,106,20.03,40.872488,-67.77581,0,0,0,0,0,"HB",0.024
"18029",525,"201502.279.1130.3","NMFS",2015,4,16,106,20.05,41.051265,-67.564773,0,0,0,0,0,"HB",0.024
"18030",562,"201502.280.1160.12","NMFS",2015,4,16,106,20,41.130837,-67.021048,0,0,0,0,0,"HB",0.024
"18031",562,"201502.281.1160.5","NMFS",2015,4,16,106,19.97,41.020208,-66.93551,0,0,0,0,0,"HB",0.024
"18032",525,"201502.282.1140.2","NMFS",2015,4,16,106,20.03,40.73527,-66.889752,0,0,0,0,0,"HB",0.024
"18033",562,"201502.283.1170.4","NMFS",2015,4,17,107,20.02,40.971318,-66.538825,0,0,0,0,0,"HB",0.024
"18034",562,"201502.285.1180.2","NMFS",2015,4,17,107,20.02,41.120987,-66.350355,1,1,0,1,0,"HB",0.024
"18035",562,"201502.286.1170.3","NMFS",2015,4,17,107,20,41.131787,-66.404505,0,0,0,0,0,"HB",0.024
"18036",562,"201502.287.1160.9","NMFS",2015,4,17,107,19.97,41.150533,-66.551278,0,0,0,0,0,"HB",0.024
"18037",562,"201502.288.1160.1","NMFS",2015,4,17,107,20.02,41.298752,-66.755945,0,0,0,0,0,"HB",0.024
"18038",562,"201502.289.1160.8","NMFS",2015,4,17,107,20.02,41.32162,-66.526403,0,0,0,0,0,"HB",0.024
"18039",552,"201502.290.1170.1","NMFS",2015,4,17,107,20.02,41.423573,-66.188382,0,0,0,0,0,"HB",0.024
"18040",552,"201502.291.1160.6","NMFS",2015,4,17,107,20.22,41.542395,-66.246947,1,1,0,1,0,"HB",0.024
"18041",552,"201502.292.1160.2","NMFS",2015,4,17,107,19.97,41.657152,-66.194653,0,0,0,0,0,"HB",0.024
"18042",552,"201502.294.1160.17","NMFS",2015,4,18,108,20.02,41.656908,-66.001728,2,2,0,2,0,"HB",0.024
"18043",552,"201502.296.1160.15","NMFS",2015,4,18,108,20.02,41.620582,-65.998592,2,2,0,2,0,"HB",0.024
"18044",552,"201502.297.1170.2","NMFS",2015,4,18,108,20,41.782625,-65.82516,50,48,2,50,0,"HB",0.024
"18045",551,"201502.299.1180.5","NMFS",2015,4,18,108,19.98,41.901355,-65.75825,36,33,3,36,0,"HB",0.024
"18046",551,"201502.300.1180.1","NMFS",2015,4,18,108,20,41.942603,-65.772262,24,20,4,24,0,"HB",0.024
"18047",551,"201502.301.1220.2","NMFS",2015,4,18,108,20,42.095695,-66.046558,4,3,1,4,0,"HB",0.024
"18048",464,"201502.302.1290.5","NMFS",2015,4,18,108,20.02,42.380135,-65.881643,5,4,1,5,0,"HB",0.024
"18049",464,"201502.303.1290.3","NMFS",2015,4,18,108,20.05,42.462042,-65.962337,0,0,0,0,0,"HB",0.024
"18050",464,"201502.304.1290.8","NMFS",2015,4,18,108,19.98,42.621335,-66.704285,1,0,1,1,0,"HB",0.024
"18051",464,"201502.306.1360.11","NMFS",2015,4,19,109,20.02,42.893593,-66.938647,3,1,2,3,0,"HB",0.024
"18052",464,"201502.307.1360.12","NMFS",2015,4,19,109,19.98,42.901828,-67.01253,8,7,1,8,0,"HB",0.024
"18053",464,"201502.308.1360.6","NMFS",2015,4,19,109,19.98,42.869955,-67.139715,20,19,1,20,0,"HB",0.024
"18054",464,"201502.309.1290.9","NMFS",2015,4,19,109,20.02,42.635863,-66.906083,7,5,2,7,0,"HB",0.024
"18055",464,"201502.311.1300.4","NMFS",2015,4,19,109,20,42.430913,-66.695982,26,21,5,26,0,"HB",0.024
"18056",464,"201502.312.1300.1","NMFS",2015,4,19,109,20.03,42.386592,-66.734757,58,48,10,58,0,"HB",0.024
"18057",551,"201502.313.1210.1","NMFS",2015,4,19,109,20,42.158612,-66.949477,2,1,1,2,0,"HB",0.024
"18058",551,"201502.314.1220.4","NMFS",2015,4,20,110,20.02,42.18373,-66.869582,4,4,0,4,0,"HB",0.024
"18059",551,"201502.316.1210.5","NMFS",2015,4,20,110,20.02,42.150462,-66.659097,15,11,4,15,0,"HB",0.024
"18060",552,"201502.317.1160.4","NMFS",2015,4,20,110,20.2,41.77604,-66.556012,0,0,0,0,0,"HB",0.024
"18061",552,"201502.318.1160.11","NMFS",2015,4,20,110,19.97,41.733162,-66.543795,0,0,0,0,0,"HB",0.024
"18062",551,"201502.319.1160.10","NMFS",2015,4,20,110,20.03,41.85433,-66.860487,2,1,1,1,1,"HB",0.024
"18063",551,"201502.320.1160.3","NMFS",2015,4,20,110,20.03,41.925405,-66.891772,0,0,0,0,0,"HB",0.024
"18064",561,"201502.321.1200.1","NMFS",2015,4,20,110,20,42.067873,-67.103625,1,1,0,1,0,"HB",0.024
"18065",464,"201502.322.1300.3","NMFS",2015,4,20,110,19.93,42.453223,-67.324823,3,3,0,3,0,"HB",0.024
"18066",515,"201502.323.1290.4","NMFS",2015,4,20,110,19.97,42.477845,-67.757582,8,7,1,8,0,"HB",0.024
"18067",522,"201502.324.1290.1","NMFS",2015,4,21,111,20.02,42.310378,-67.771675,0,0,0,0,0,"HB",0.024
"18068",522,"201502.325.1220.3","NMFS",2015,4,21,111,19.98,42.157345,-67.694033,7,5,2,7,0,"HB",0.024
"18069",522,"201502.326.1290.10","NMFS",2015,4,21,111,20.12,42.202018,-67.90605,4,4,0,4,0,"HB",0.024
"18070",515,"201502.327.1290.7","NMFS",2015,4,21,111,19.95,42.471833,-68.064995,2,2,0,2,0,"HB",0.024
"18071",515,"201502.328.1290.2","NMFS",2015,4,21,111,20.03,42.611472,-68.360757,1,1,0,1,0,"HB",0.024
"18072",515,"201502.329.1360.1","NMFS",2015,4,21,111,20.02,42.80086,-68.334458,0,0,0,0,0,"HB",0.024
"18073",515,"201502.330.1280.3","NMFS",2015,4,21,111,20.02,42.534467,-68.63161,1,1,0,1,0,"HB",0.024
"18074",522,"201502.331.1240.2","NMFS",2015,4,22,112,20.03,42.225893,-68.566022,0,0,0,0,0,"HB",0.024
"18075",522,"201502.332.1240.1","NMFS",2015,4,22,112,20.03,42.247005,-68.668355,0,0,0,0,0,"HB",0.024
"18076",521,"201502.333.1240.8","NMFS",2015,4,22,112,20.03,42.067608,-69.148058,0,0,0,0,0,"HB",0.024
"18077",521,"201502.334.1280.4","NMFS",2015,4,22,112,20.05,41.961803,-69.544368,2,2,0,2,0,"HB",0.024
"18078",521,"201502.335.1240.7","NMFS",2015,4,22,112,20.03,41.92501,-69.584737,10,9,1,10,0,"HB",0.024
"18079",521,"201502.336.1270.1","NMFS",2015,4,22,112,20.02,42.146502,-69.784145,17,16,1,17,0,"HB",0.024
"18080",521,"201502.337.1280.1","NMFS",2015,4,22,112,19.97,42.243652,-69.87351,2,2,0,2,0,"HB",0.024
"18081",514,"201502.343.3650.3","NMFS",2015,4,27,117,20.07,42.429782,-70.746648,186,116,70,161,25,"HB",0.024
"18082",514,"201502.345.3640.3","NMFS",2015,4,28,118,19.95,42.337735,-70.795535,26,15,11,19,7,"HB",0.024
"18083",514,"201502.346.3640.2","NMFS",2015,4,28,118,20.15,42.255768,-70.636938,82,42,40,63,19,"HB",0.024
"18084",514,"201502.347.1260.1","NMFS",2015,4,28,118,20,42.29658,-70.552115,88,33,55,84,4,"HB",0.024
"18085",514,"201502.348.3660.5","NMFS",2015,4,28,118,20.03,42.218593,-70.512915,32,19,13,31,1,"HB",0.024
"18086",514,"201502.349.3660.3","NMFS",2015,4,28,118,20.02,42.192733,-70.509243,118,77,41,113,5,"HB",0.024
"18087",514,"201502.350.3610.3","NMFS",2015,4,28,118,19.97,42.044235,-70.48684,75,37,38,67,8,"HB",0.024
"18088",514,"201502.351.3590.3","NMFS",2015,4,28,118,20.02,41.975462,-70.554072,8,5,3,8,0,"HB",0.024
"18089",514,"201502.352.3600.3","NMFS",2015,4,28,118,20.03,41.957535,-70.472477,25,16,9,23,2,"HB",0.024
"18090",514,"201502.353.3610.2","NMFS",2015,4,28,118,20.03,41.997052,-70.38467,80,52,28,73,7,"HB",0.024
"18091",514,"201502.354.3600.1","NMFS",2015,4,28,118,20.07,41.874855,-70.329177,12,3,9,11,1,"HB",0.024
"18092",514,"201502.355.3590.1","NMFS",2015,4,28,118,20.05,41.85871,-70.261578,2,0,2,2,0,"HB",0.024
"18093",514,"201502.356.3590.2","NMFS",2015,4,28,118,19.95,41.879552,-70.2049,4,1,3,4,0,"HB",0.024
"18094",514,"201502.357.3600.2","NMFS",2015,4,29,119,19.98,41.9519,-70.226182,10,0,10,9,1,"HB",0.024
"18095",514,"201502.358.3560.1","NMFS",2015,4,29,119,19.98,42.08108,-70.092388,5,1,4,5,0,"HB",0.024
"18096",514,"201502.360.3610.4","NMFS",2015,4,29,119,20.17,42.151353,-70.130437,5,3,2,5,0,"HB",0.024
"18097",514,"201502.361.1260.8","NMFS",2015,4,29,119,20.05,42.328238,-70.161955,26,20,6,26,0,"HB",0.024
"18098",514,"201502.363.1260.5","NMFS",2015,4,29,119,19.95,42.42665,-70.350097,40,34,6,40,0,"HB",0.024
"18099",514,"201502.365.1260.7","NMFS",2015,4,29,119,20,42.486948,-70.156083,35,35,0,35,0,"HB",0.024
"18100",514,"201502.366.1260.9","NMFS",2015,4,29,119,20.03,42.645503,-70.23479,3,3,0,3,0,"HB",0.024
"18101",514,"201502.367.3660.1","NMFS",2015,4,29,119,20,42.652365,-70.482035,10,7,3,10,0,"HB",0.024
"18102",514,"201502.368.3650.2","NMFS",2015,4,30,120,20.02,42.74828,-70.670118,28,13,15,26,2,"HB",0.024
"18103",514,"201502.369.3650.1","NMFS",2015,4,30,120,20,42.763855,-70.669882,79,32,47,75,4,"HB",0.024
"18104",513,"201502.370.3640.1","NMFS",2015,4,30,120,20,42.841562,-70.744717,24,13,11,22,2,"HB",0.024
"18105",513,"201502.371.1400.3","NMFS",2015,4,30,120,19.98,42.875212,-70.458777,9,8,1,9,0,"HB",0.024
"18106",513,"201502.372.1380.6","NMFS",2015,4,30,120,20,43.378612,-69.828642,13,10,3,13,0,"HB",0.024
"18107",513,"201502.373.1380.8","NMFS",2015,4,30,120,20.02,43.399333,-69.681852,12,11,1,12,0,"HB",0.024
"18108",513,"201502.374.1370.4","NMFS",2015,4,30,120,20.02,43.197923,-69.65541,10,10,0,10,0,"HB",0.024
"18109",513,"201502.375.1370.6","NMFS",2015,5,1,121,20.12,42.895018,-69.471602,2,2,0,2,0,"HB",0.024
"18110",515,"201502.376.1280.5","NMFS",2015,5,1,121,19.95,42.622105,-69.468758,1,1,0,1,0,"HB",0.024
"18111",515,"201502.377.1280.6","NMFS",2015,5,1,121,20,42.547463,-69.541418,1,1,0,1,0,"HB",0.024
"18112",515,"201502.378.1280.2","NMFS",2015,5,1,121,20.03,42.656563,-69.366098,3,3,0,3,0,"HB",0.024
"18113",515,"201502.379.1370.5","NMFS",2015,5,1,121,20.02,42.671225,-69.06752,0,0,0,0,0,"HB",0.024
"18114",515,"201502.380.1370.1","NMFS",2015,5,1,121,20.03,42.687307,-68.959365,1,1,0,1,0,"HB",0.024
"18115",515,"201502.381.1370.7","NMFS",2015,5,1,121,20,42.859517,-68.959348,4,3,1,4,0,"HB",0.024
"18116",515,"201502.382.1370.2","NMFS",2015,5,1,121,20.02,43.104908,-68.95432,11,10,1,11,0,"HB",0.024
"18117",513,"201502.383.1380.4","NMFS",2015,5,2,122,19.95,43.30017,-69.254843,7,7,0,7,0,"HB",0.024
"18118",515,"201502.384.1370.3","NMFS",2015,5,2,122,19.98,43.236133,-68.900298,9,7,2,9,0,"HB",0.024
"18119",512,"201502.386.1380.7","NMFS",2015,5,2,122,20.03,43.61522,-68.651138,26,17,9,26,0,"HB",0.024
"18120",512,"201502.387.1380.5","NMFS",2015,5,2,122,20.03,43.456915,-68.450793,20,18,2,20,0,"HB",0.024
"18121",512,"201502.388.1380.2","NMFS",2015,5,2,122,19.98,43.51261,-68.26201,20,18,2,20,0,"HB",0.024
"18122",515,"201502.389.1360.3","NMFS",2015,5,2,122,19.98,43.259613,-68.127138,1,1,0,1,0,"HB",0.024
"18123",515,"201502.390.1360.2","NMFS",2015,5,2,122,20.02,43.294603,-67.877883,9,9,0,9,0,"HB",0.024
"18124",515,"201502.391.1360.5","NMFS",2015,5,2,122,20.02,43.27556,-67.814122,2,2,0,2,0,"HB",0.024
"18125",515,"201502.392.1360.7","NMFS",2015,5,2,122,20,43.169473,-67.863058,3,3,0,3,0,"HB",0.024
"18126",515,"201502.393.1360.4","NMFS",2015,5,3,123,20.02,42.88433,-67.804128,0,0,0,0,0,"HB",0.024
"18127",515,"201502.395.1360.13","NMFS",2015,5,3,123,20.03,43.044638,-67.776758,2,2,0,2,0,"HB",0.024
"18128",465,"201502.396.1360.8","NMFS",2015,5,3,123,20.02,43.361515,-67.413767,7,6,1,7,0,"HB",0.024
"18129",465,"201502.397.1360.9","NMFS",2015,5,3,123,19.78,43.185083,-67.094673,13,9,4,13,0,"HB",0.024
"18130",465,"201502.398.1340.1","NMFS",2015,5,3,123,20,43.08721,-67.014548,1,0,1,1,0,"HB",0.024
"18131",465,"201502.399.1340.7","NMFS",2015,5,3,123,20.05,43.246548,-66.711765,16,6,10,16,0,"HB",0.024
"18132",465,"201502.400.1340.5","NMFS",2015,5,3,123,20.08,43.50725,-66.663577,7,5,2,7,0,"HB",0.024
"18133",465,"201502.401.1340.3","NMFS",2015,5,4,124,20,43.575243,-67.049288,1,1,0,1,0,"HB",0.024
"18134",465,"201502.403.1340.9","NMFS",2015,5,4,124,20.02,43.792232,-67.126752,2,1,1,2,0,"HB",0.024
"18135",511,"201502.404.1340.10","NMFS",2015,5,4,124,19.98,43.871885,-67.271583,7,7,0,7,0,"HB",0.024
"18136",511,"201502.406.1351.2","NMFS",2015,5,4,124,20,44.18995,-67.187287,3,1,2,3,0,"HB",0.024
"18137",511,"201502.407.1351.3","NMFS",2015,5,4,124,20,44.24464,-67.23997,33,30,3,33,0,"HB",0.024
"18138",467,"201502.408.1351.4","NMFS",2015,5,4,124,20.02,44.347732,-66.957715,74,37,37,73,1,"HB",0.024
"18139",467,"201502.409.1351.1","NMFS",2015,5,4,124,20.03,44.365333,-66.880562,114,54,60,108,6,"HB",0.024
"18140",511,"201502.410.1390.7","NMFS",2015,5,4,124,20.02,44.271335,-67.648513,30,12,18,30,0,"HB",0.024
"18141",512,"201502.413.1380.9","NMFS",2015,5,5,125,20,43.851967,-68.177232,44,37,7,44,0,"HB",0.024
"18142",512,"201502.414.1390.6","NMFS",2015,5,5,125,20.02,43.998437,-68.455058,538,230,308,436,102,"HB",0.024
"18143",512,"201502.415.1390.8","NMFS",2015,5,5,125,20.05,43.870295,-68.706468,622,309,313,361,261,"HB",0.024
"18144",512,"201502.416.1390.3","NMFS",2015,5,5,125,20.03,43.801557,-69.075118,689,316,373,402,287,"HB",0.024
"18145",513,"201502.417.1380.3","NMFS",2015,5,5,125,20.02,43.625897,-69.073325,53,32,21,51,2,"HB",0.024
"18146",513,"201502.418.1400.1","NMFS",2015,5,6,126,19.98,43.51614,-69.954325,72,44,28,62,10,"HB",0.024
"18147",513,"201502.420.1400.4","NMFS",2015,5,6,126,20.02,43.007855,-70.396715,30,12,18,30,0,"HB",0.024
"18148",513,"201502.421.1270.2","NMFS",2015,5,6,126,19.98,42.972602,-70.245495,13,7,6,12,1,"HB",0.024
"18149",513,"201502.422.1270.4","NMFS",2015,5,6,126,20,42.903195,-70.229708,30,27,3,30,0,"HB",0.024
"18150",513,"201502.423.1260.2","NMFS",2015,5,6,126,20.02,43.032838,-70.038975,27,26,1,27,0,"HB",0.024
"18151",513,"201502.424.1270.5","NMFS",2015,5,6,126,20.02,42.993015,-69.969592,4,3,1,4,0,"HB",0.024
"18152",513,"201502.425.1270.3","NMFS",2015,5,6,126,20.03,42.860287,-70.087718,14,12,2,14,0,"HB",0.024
"18153",514,"201502.426.1280.7","NMFS",2015,5,7,127,20.02,42.564768,-69.875898,2,2,0,2,0,"HB",0.024
"18154",526,"201504.166.1110.2","NMFS",2015,9,16,259,20.09,39.981737,-69.462792,0,0,0,0,0,"HB",0.024
"18155",526,"201504.167.1120.3","NMFS",2015,9,16,259,20.01,39.932615,-69.386725,35,12,23,34,1,"HB",0.024
"18156",526,"201504.168.1100.8","NMFS",2015,9,16,259,19.99,40.006457,-69.4235,0,0,0,0,0,"HB",0.024
"18157",526,"201504.224.1090.5","NMFS",2015,9,28,271,20.05,40.794357,-69.882635,0,0,0,0,0,"HB",0.024
"18158",526,"201504.225.1090.2","NMFS",2015,9,28,271,20,40.66905,-69.53905,0,0,0,0,0,"HB",0.024
"18159",526,"201504.226.1090.4","NMFS",2015,9,28,271,20.03,40.625875,-69.342815,0,0,0,0,0,"HB",0.024
"18160",526,"201504.227.1100.2","NMFS",2015,9,28,271,20.02,40.525497,-69.095902,0,0,0,0,0,"HB",0.024
"18161",526,"201504.228.1100.1","NMFS",2015,9,28,271,20.02,40.548352,-68.995998,0,0,0,0,0,"HB",0.024
"18162",525,"201504.231.1130.2","NMFS",2015,9,28,271,19.66,40.981215,-68.786152,6,6,0,3,3,"HB",0.024
"18163",522,"201504.232.1230.5","NMFS",2015,9,29,272,20.08,41.02813,-68.699883,1,1,0,1,0,"HB",0.024
"18164",521,"201504.233.1230.3","NMFS",2015,9,29,272,20.06,41.158902,-68.93653,1,1,0,1,0,"HB",0.024
"18165",521,"201504.234.1230.1","NMFS",2015,9,29,272,20.01,41.023858,-69.022397,5,5,0,5,0,"HB",0.024
"18166",521,"201504.235.1230.2","NMFS",2015,9,29,272,20.07,41.007957,-69.114812,0,0,0,0,0,"HB",0.024
"18167",521,"201504.236.1250.3","NMFS",2015,9,29,272,20.03,41.094415,-69.218022,2,1,1,2,0,"HB",0.024
"18168",521,"201504.238.1250.5","NMFS",2015,9,29,272,17.28,41.219607,-69.375373,5,5,0,5,0,"HB",0.024
"18169",521,"201504.242.1230.4","NMFS",2015,9,30,273,20.07,41.724192,-69.75472,3,1,2,3,0,"HB",0.024
"18170",521,"201504.244.3560.2","NMFS",2015,9,30,273,20.05,41.73077,-69.889737,0,0,0,0,0,"HB",0.024
"18171",526,"201504.247.1100.10","NMFS",2015,10,8,281,20.02,40.205323,-69.148068,0,0,0,0,0,"HB",0.024
"18172",526,"201504.248.1110.1","NMFS",2015,10,8,281,20.04,40.169907,-68.841897,0,0,0,0,0,"HB",0.024
"18173",525,"201504.249.1130.5","NMFS",2015,10,8,281,20.03,40.311067,-68.667137,0,0,0,0,0,"HB",0.024
"18174",525,"201504.250.1140.2","NMFS",2015,10,8,281,20.02,40.195803,-68.652445,0,0,0,0,0,"HB",0.024
"18175",525,"201504.251.1140.4","NMFS",2015,10,8,281,20,40.267893,-68.35868,0,0,0,0,0,"HB",0.024
"18176",525,"201504.252.1150.2","NMFS",2015,10,8,281,20.02,40.35622,-67.83026,0,0,0,0,0,"HB",0.024
"18177",525,"201504.253.1150.3","NMFS",2015,10,9,282,20.06,40.46984,-68.147652,32,26,6,32,0,"HB",0.024
"18178",525,"201504.254.1130.9","NMFS",2015,10,9,282,19.99,40.644977,-68.058947,0,0,0,0,0,"HB",0.024
"18179",525,"201504.255.1130.8","NMFS",2015,10,9,282,20.01,40.678262,-68.196828,1,1,0,1,0,"HB",0.024
"18180",525,"201504.256.1130.6","NMFS",2015,10,9,282,20.01,40.61442,-68.658,0,0,0,0,0,"HB",0.024
"18181",525,"201504.257.1190.8","NMFS",2015,10,9,282,20.04,40.83331,-68.550478,1,0,1,0,1,"HB",0.024
"18182",525,"201504.258.1190.6","NMFS",2015,10,9,282,20.02,40.80812,-68.336613,0,0,0,0,0,"HB",0.024
"18183",525,"201504.259.1190.5","NMFS",2015,10,9,282,20.01,40.88564,-68.243657,3,2,1,3,0,"HB",0.024
"18184",525,"201504.261.1190.10","NMFS",2015,10,9,282,20.03,41.213422,-67.974552,0,0,0,0,0,"HB",0.024
"18185",525,"201504.262.1190.7","NMFS",2015,10,9,282,20.06,41.111352,-67.870792,1,0,1,1,0,"HB",0.024
"18186",525,"201504.263.1130.4","NMFS",2015,10,9,282,20.1,40.92906,-67.899753,0,0,0,0,0,"HB",0.024
"18187",525,"201504.264.1130.10","NMFS",2015,10,10,283,20.02,40.720285,-67.769635,0,0,0,0,0,"HB",0.024
"18188",525,"201504.265.1140.3","NMFS",2015,10,10,283,20.02,40.549015,-67.59422,1,1,0,1,0,"HB",0.024
"18189",525,"201504.266.1130.7","NMFS",2015,10,10,283,20,40.589605,-67.345755,0,0,0,0,0,"HB",0.024
"18190",525,"201504.268.1150.4","NMFS",2015,10,10,283,19.08,40.500973,-67.171245,37,28,9,36,1,"HB",0.024
"18191",525,"201504.269.1140.1","NMFS",2015,10,10,283,20,40.597318,-67.27022,0,0,0,0,0,"HB",0.024
"18192",525,"201504.270.1130.1","NMFS",2015,10,10,283,20.01,40.714433,-67.423818,0,0,0,0,0,"HB",0.024
"18193",525,"201504.271.1130.3","NMFS",2015,10,11,284,20.07,40.801847,-67.201947,1,1,0,1,0,"HB",0.024
"18194",562,"201504.272.1160.14","NMFS",2015,10,11,284,20.09,41.047135,-66.92692,0,0,0,0,0,"HB",0.024
"18195",562,"201504.273.1160.3","NMFS",2015,10,11,284,20,41.114838,-66.832703,1,1,0,1,0,"HB",0.024
"18196",562,"201504.274.1180.4","NMFS",2015,10,11,284,20.02,40.882343,-66.582523,22,17,5,21,1,"HB",0.024
"18197",562,"201504.275.1170.4","NMFS",2015,10,11,284,20.02,40.965848,-66.542178,6,6,0,6,0,"HB",0.024
"18198",562,"201504.276.1170.2","NMFS",2015,10,11,284,20.05,41.0307,-66.478603,2,2,0,2,0,"HB",0.024
"18199",562,"201504.277.1180.3","NMFS",2015,10,11,284,20.01,41.021533,-66.415637,9,9,0,9,0,"HB",0.024
"18200",562,"201504.278.1160.4","NMFS",2015,10,11,284,20.01,41.207222,-66.481293,0,0,0,0,0,"HB",0.024
"18201",562,"201504.279.1160.2","NMFS",2015,10,11,284,19.96,41.290545,-66.985187,1,1,0,1,0,"HB",0.024
"18202",562,"201504.280.1160.5","NMFS",2015,10,11,284,20,41.422323,-66.775528,15,14,1,15,0,"HB",0.024
"18203",552,"201504.281.1160.7","NMFS",2015,10,12,285,20.12,41.691437,-66.73923,97,96,1,96,1,"HB",0.024
"18204",551,"201504.282.1160.10","NMFS",2015,10,12,285,20.01,41.837868,-66.68861,16,16,0,16,0,"HB",0.024
"18205",562,"201504.284.1160.15","NMFS",2015,10,12,285,19.99,41.782608,-66.941597,5,4,1,5,0,"HB",0.024
"18206",562,"201504.285.1160.1","NMFS",2015,10,12,285,20.04,41.574548,-67.03588,1,1,0,1,0,"HB",0.024
"18207",562,"201504.286.1190.4","NMFS",2015,10,12,285,20.03,41.659122,-67.367832,0,0,0,0,0,"HB",0.024
"18208",562,"201504.288.1200.8","NMFS",2015,10,12,285,19.48,41.813058,-67.585817,14,14,0,12,2,"HB",0.024
"18209",522,"201504.289.1200.1","NMFS",2015,10,12,285,20.02,41.715112,-67.682788,2,2,0,2,0,"HB",0.024
"18210",522,"201504.290.1190.1","NMFS",2015,10,12,285,20,41.515943,-67.84014,0,0,0,0,0,"HB",0.024
"18211",522,"201504.291.1200.2","NMFS",2015,10,13,286,20.07,41.617223,-68.069605,1,1,0,1,0,"HB",0.024
"18212",522,"201504.292.1220.1","NMFS",2015,10,13,286,20.01,41.846668,-68.202905,0,0,0,0,0,"HB",0.024
"18213",522,"201504.293.1220.4","NMFS",2015,10,13,286,20.01,41.918322,-68.144055,0,0,0,0,0,"HB",0.024
"18214",522,"201504.295.1200.7","NMFS",2015,10,13,286,20.01,41.933522,-67.81801,12,10,2,12,0,"HB",0.024
"18215",522,"201504.296.1210.4","NMFS",2015,10,13,286,19.99,42.047465,-67.714602,1,1,0,1,0,"HB",0.024
"18216",561,"201504.297.1200.6","NMFS",2015,10,13,286,20.02,41.964227,-67.587433,15,9,6,12,3,"HB",0.024
"18217",561,"201504.298.1190.2","NMFS",2015,10,13,286,19.95,41.852605,-67.308365,5,5,0,5,0,"HB",0.024
"18218",561,"201504.299.1190.9","NMFS",2015,10,13,286,20.06,41.906433,-67.271832,9,8,1,9,0,"HB",0.024
"18219",561,"201504.300.1200.3","NMFS",2015,10,14,287,19.99,42.036992,-67.168073,6,6,0,6,0,"HB",0.024
"18220",561,"201504.301.1210.2","NMFS",2015,10,14,287,20.01,42.130665,-67.284752,1,1,0,1,0,"HB",0.024
"18221",551,"201504.302.1220.3","NMFS",2015,10,14,287,20.03,42.198458,-67.044308,7,5,2,7,0,"HB",0.024
"18222",551,"201504.303.1210.1","NMFS",2015,10,14,287,20.42,42.11241,-66.946673,9,9,0,9,0,"HB",0.024
"18223",551,"201504.304.1220.2","NMFS",2015,10,14,287,20.07,42.201425,-66.867433,32,29,3,28,4,"HB",0.024
"18224",551,"201504.305.1290.3","NMFS",2015,10,14,287,20.01,42.210248,-66.76121,23,21,2,22,1,"HB",0.024
"18225",551,"201504.306.1210.3","NMFS",2015,10,14,287,20.04,42.088415,-66.530615,13,6,7,9,4,"HB",0.024
"18226",551,"201504.307.1160.9","NMFS",2015,10,14,287,20,42.055415,-66.594555,3,2,1,3,0,"HB",0.024
"18227",551,"201504.308.1160.11","NMFS",2015,10,14,287,20,41.96381,-66.351445,5,4,1,5,0,"HB",0.024
"18228",551,"201504.309.1160.8","NMFS",2015,10,15,288,20.08,41.965213,-66.16931,5,4,1,4,1,"HB",0.024
"18229",552,"201504.310.1160.6","NMFS",2015,10,15,288,20.07,41.768937,-66.34628,8,6,2,8,0,"HB",0.024
"18230",552,"201504.311.1160.12","NMFS",2015,10,15,288,20,41.665427,-65.970437,1,1,0,1,0,"HB",0.024
"18231",552,"201504.312.1180.2","NMFS",2015,10,15,288,20.04,41.625202,-65.856925,17,15,2,17,0,"HB",0.024
"18232",551,"201504.313.1170.1","NMFS",2015,10,15,288,20,41.853437,-65.873763,3,3,0,3,0,"HB",0.024
"18233",551,"201504.314.1170.3","NMFS",2015,10,15,288,20.02,41.94651,-65.827522,0,0,0,0,0,"HB",0.024
"18234",551,"201504.316.1180.5","NMFS",2015,10,15,288,20.01,42.002843,-65.88142,3,2,1,3,0,"HB",0.024
"18235",551,"201504.318.1290.9","NMFS",2015,10,16,289,20.05,42.313045,-66.080978,1,1,0,1,0,"HB",0.024
"18236",551,"201504.320.1300.2","NMFS",2015,10,16,289,20.03,42.31017,-66.746563,2,2,0,2,0,"HB",0.024
"18237",551,"201504.321.1290.10","NMFS",2015,10,16,289,19.99,42.27428,-66.968352,3,3,0,3,0,"HB",0.024
"18238",551,"201504.322.1290.1","NMFS",2015,10,16,289,20,42.26849,-67.061345,3,3,0,3,0,"HB",0.024
"18239",464,"201504.323.1300.3","NMFS",2015,10,16,289,20.02,42.44915,-67.328122,4,1,3,4,0,"HB",0.024
"18240",464,"201504.324.1290.6","NMFS",2015,10,16,289,18.5,42.707697,-67.375527,6,6,0,6,0,"HB",0.024
"18241",464,"201504.325.1290.4","NMFS",2015,10,17,290,20.16,42.662748,-67.115252,3,2,1,3,0,"HB",0.024
"18242",464,"201504.326.1300.1","NMFS",2015,10,17,290,20.01,42.594645,-67.024577,1,0,1,1,0,"HB",0.024
"18243",464,"201504.327.1290.11","NMFS",2015,10,17,290,20.03,42.655725,-67.03078,2,2,0,2,0,"HB",0.024
"18244",464,"201504.328.1360.1","NMFS",2015,10,17,290,20.07,42.827007,-66.888757,7,6,1,7,0,"HB",0.024
"18245",465,"201504.329.1340.2","NMFS",2015,10,17,290,20.02,43.003355,-66.982158,1,1,0,1,0,"HB",0.024
"18246",464,"201504.330.1340.6","NMFS",2015,10,17,290,20.01,42.984893,-66.82224,2,2,0,2,0,"HB",0.024
"18247",465,"201504.332.1360.5","NMFS",2015,10,18,291,20.12,43.543155,-67.01107,4,4,0,4,0,"HB",0.024
"18248",465,"201504.333.1340.4","NMFS",2015,10,18,291,19.99,43.70071,-66.986778,5,5,0,5,0,"HB",0.024
"18249",465,"201504.334.1340.1","NMFS",2015,10,18,291,20,43.834538,-66.735643,17,9,8,16,1,"HB",0.024
"18250",466,"201504.335.1351.2","NMFS",2015,10,18,291,20.02,44.125688,-66.788332,25,16,9,25,0,"HB",0.024
"18251",466,"201504.336.1351.4","NMFS",2015,10,18,291,20.02,44.273023,-66.700873,8,5,3,8,0,"HB",0.024
"18252",511,"201504.337.1351.1","NMFS",2015,10,18,291,20.04,44.261932,-66.92289,1,1,0,1,0,"HB",0.024
"18253",511,"201504.338.1351.3","NMFS",2015,10,18,291,20.03,44.167882,-66.913008,6,6,0,6,0,"HB",0.024
"18254",511,"201504.339.1340.7","NMFS",2015,10,18,291,20.02,44.033437,-66.945435,26,25,1,26,0,"HB",0.024
"18255",511,"201504.340.1340.5","NMFS",2015,10,18,291,20.38,43.887355,-67.2075,0,0,0,0,0,"HB",0.024
"18256",465,"201504.341.1360.7","NMFS",2015,10,19,292,20.11,43.609483,-67.320748,0,0,0,0,0,"HB",0.024
"18257",515,"201504.342.1360.10","NMFS",2015,10,19,292,20.01,43.041817,-67.702027,0,0,0,0,0,"HB",0.024
"18258",464,"201504.343.1360.9","NMFS",2015,10,19,292,20.02,42.855828,-67.612505,4,4,0,4,0,"HB",0.024
"18259",515,"201504.344.1290.12","NMFS",2015,10,19,292,20,42.70101,-68.02133,0,0,0,0,0,"HB",0.024
"18260",515,"201504.345.1290.8","NMFS",2015,10,19,292,20.01,42.659447,-68.075698,2,1,1,2,0,"HB",0.024
"18261",515,"201504.346.1290.5","NMFS",2015,10,19,292,19.98,42.50477,-68.490835,1,1,0,1,0,"HB",0.024
"18262",522,"201504.347.1240.5","NMFS",2015,10,19,292,20.09,42.219393,-68.568775,0,0,0,0,0,"HB",0.024
"18263",522,"201504.348.1240.1","NMFS",2015,10,20,293,20.08,42.080572,-68.467993,0,0,0,0,0,"HB",0.024
"18264",522,"201504.349.1240.7","NMFS",2015,10,20,293,19.99,41.855252,-68.493488,1,1,0,1,0,"HB",0.024
"18265",522,"201504.350.1240.6","NMFS",2015,10,20,293,20.03,41.652497,-68.53868,0,0,0,0,0,"HB",0.024
"18266",522,"201504.351.1240.8","NMFS",2015,10,20,293,20.02,41.577752,-68.770345,0,0,0,0,0,"HB",0.024
"18267",521,"201504.353.1240.9","NMFS",2015,10,20,293,20.03,41.380153,-69.112885,1,0,1,1,0,"HB",0.024
"18268",521,"201504.354.1240.4","NMFS",2015,10,20,293,20.09,41.605163,-69.003352,0,0,0,0,0,"HB",0.024
"18269",521,"201504.355.1240.2","NMFS",2015,10,20,293,20,41.701792,-69.412035,0,0,0,0,0,"HB",0.024
"18270",521,"201504.356.1280.5","NMFS",2015,10,21,294,20.05,41.985658,-69.203465,0,0,0,0,0,"HB",0.024
"18271",521,"201504.357.1280.2","NMFS",2015,10,21,294,20.01,42.262667,-69.293578,1,1,0,1,0,"HB",0.024
"18272",515,"201504.358.1280.7","NMFS",2015,10,21,294,20.03,42.496563,-69.211343,0,0,0,0,0,"HB",0.024
"18273",514,"201504.359.1280.1","NMFS",2015,10,21,294,19.99,42.537397,-69.8857,0,0,0,0,0,"HB",0.024
"18274",514,"201504.360.1270.4","NMFS",2015,10,21,294,19.99,42.394933,-69.996062,0,0,0,0,0,"HB",0.024
"18275",521,"201504.361.1270.5","NMFS",2015,10,21,294,20.01,42.140365,-69.779053,0,0,0,0,0,"HB",0.024
"18276",514,"201504.362.1260.3","NMFS",2015,10,28,301,20.01,42.194917,-70.050215,1,1,0,1,0,"HB",0.024
"18277",514,"201504.363.3610.1","NMFS",2015,10,28,301,20.02,42.11962,-70.037918,18,13,5,18,0,"HB",0.024
"18278",514,"201504.364.3560.1","NMFS",2015,10,28,301,20.03,42.080515,-70.105412,2,2,0,2,0,"HB",0.024
"18279",514,"201504.365.1260.5","NMFS",2015,10,28,301,20,42.093915,-70.31217,163,91,72,157,6,"HB",0.024
"18280",514,"201504.366.3610.2","NMFS",2015,10,28,301,20,42.071738,-70.268093,546,333,213,534,12,"HB",0.024
"18281",514,"201504.367.3600.3","NMFS",2015,10,28,301,20.09,41.978255,-70.180318,15,7,8,14,1,"HB",0.024
"18282",514,"201504.368.3590.1","NMFS",2015,10,28,301,20.03,41.896093,-70.177783,31,12,19,29,2,"HB",0.024
"18283",514,"201504.370.3600.1","NMFS",2015,10,28,301,20,41.883222,-70.313882,50,25,25,50,0,"HB",0.024
"18284",514,"201504.371.3590.2","NMFS",2015,10,28,301,20.34,41.837392,-70.429533,44,22,22,38,6,"HB",0.024
"18285",514,"201504.372.3600.2","NMFS",2015,10,29,302,19.99,42.004223,-70.525332,311,181,130,224,87,"HB",0.024
"18286",514,"201504.373.3640.2","NMFS",2015,10,29,302,20,42.285462,-70.68244,230,130,100,151,79,"HB",0.024
"18287",514,"201504.374.3650.3","NMFS",2015,10,29,302,20.06,42.369487,-70.719747,255,133,122,208,47,"HB",0.024
"18288",514,"201504.377.3660.5","NMFS",2015,10,29,302,20,42.390768,-70.708373,287,198,89,252,35,"HB",0.024
"18289",514,"201504.380.3640.5","NMFS",2015,10,30,303,16.56,42.3294,-70.75841,446,258,188,313,133,"HB",0.024
"18290",514,"201504.381.3660.3","NMFS",2015,10,30,303,20.01,42.68816,-70.419375,199,89,110,123,76,"HB",0.024
"18291",514,"201504.382.3660.1","NMFS",2015,10,30,303,20.05,42.66865,-70.531128,335,157,178,242,93,"HB",0.024
"18292",514,"201504.385.3650.1","NMFS",2015,10,30,303,18.99,42.758778,-70.652738,340,189,151,276,64,"HB",0.024
"18293",514,"201504.386.3640.1","NMFS",2015,10,30,303,20.01,42.831215,-70.760382,51,32,19,45,6,"HB",0.024
"18294",513,"201504.387.1270.2","NMFS",2015,10,30,303,20.05,42.952407,-70.164332,0,0,0,0,0,"HB",0.024
"18295",513,"201504.388.1280.3","NMFS",2015,10,31,304,20.09,43.030573,-69.810728,0,0,0,0,0,"HB",0.024
"18296",513,"201504.389.1280.4","NMFS",2015,10,31,304,20.01,42.860095,-69.716578,0,0,0,0,0,"HB",0.024
"18297",513,"201504.390.1370.7","NMFS",2015,10,31,304,20.02,42.91622,-69.672165,0,0,0,0,0,"HB",0.024
"18298",515,"201504.391.1370.1","NMFS",2015,10,31,304,20.02,42.928265,-69.186613,0,0,0,0,0,"HB",0.024
"18299",515,"201504.392.1370.5","NMFS",2015,10,31,304,20.27,42.869987,-69.075412,0,0,0,0,0,"HB",0.024
"18300",515,"201504.393.1280.6","NMFS",2015,10,31,304,19.99,42.603105,-68.72432,0,0,0,0,0,"HB",0.024
"18301",515,"201504.394.1370.4","NMFS",2015,10,31,304,20.01,42.834255,-68.721558,0,0,0,0,0,"HB",0.024
"18302",515,"201504.395.1370.6","NMFS",2015,10,31,304,20.04,42.935693,-68.692843,0,0,0,0,0,"HB",0.024
"18303",515,"201504.396.1370.3","NMFS",2015,10,31,304,20.02,43.079588,-68.728428,0,0,0,0,0,"HB",0.024
"18304",515,"201504.397.1370.2","NMFS",2015,11,1,305,20.04,43.15245,-68.690108,0,0,0,0,0,"HB",0.024
"18305",515,"201504.398.1360.8","NMFS",2015,11,1,305,19.99,43.135915,-68.297022,0,0,0,0,0,"HB",0.024
"18306",515,"201504.399.1360.2","NMFS",2015,11,1,305,19.99,43.108665,-68.170033,0,0,0,0,0,"HB",0.024
"18307",515,"201504.400.1360.11","NMFS",2015,11,1,305,19.99,43.022708,-68.038408,0,0,0,0,0,"HB",0.024
"18308",515,"201504.401.1360.6","NMFS",2015,11,1,305,20.02,43.24561,-68.16304,0,0,0,0,0,"HB",0.024
"18309",515,"201504.402.1360.3","NMFS",2015,11,1,305,19.99,43.316308,-68.024825,0,0,0,0,0,"HB",0.024
"18310",512,"201504.403.1360.4","NMFS",2015,11,1,305,20.01,43.890993,-67.764647,1,0,1,1,0,"HB",0.024
"18311",511,"201504.404.1360.12","NMFS",2015,11,1,305,20.01,43.932187,-67.621425,0,0,0,0,0,"HB",0.024
"18312",511,"201504.405.1380.1","NMFS",2015,11,1,305,20.05,44.10345,-67.757575,41,32,9,41,0,"HB",0.024
"18313",511,"201504.406.1390.3","NMFS",2015,11,2,306,20.01,44.16541,-67.811383,159,86,73,159,0,"HB",0.024
"18314",512,"201504.407.1390.7","NMFS",2015,11,2,306,19.47,44.135927,-67.891887,592,389,203,544,48,"HB",0.024
"18315",512,"201504.408.1390.6","NMFS",2015,11,2,306,19.99,44.167815,-68.025782,888,440,448,580,308,"HB",0.024
"18316",512,"201504.409.1390.1","NMFS",2015,11,2,306,20.04,43.968328,-68.288742,739,439,300,690,49,"HB",0.024
"18317",512,"201504.411.1390.8","NMFS",2015,11,2,306,17.41,43.844373,-68.58236,299,154,145,264,35,"HB",0.024
"18318",512,"201504.412.1380.3","NMFS",2015,11,3,307,20.07,43.672542,-68.376345,15,8,7,12,3,"HB",0.024
"18319",512,"201504.413.1380.2","NMFS",2015,11,3,307,20,43.517125,-68.71614,3,3,0,3,0,"HB",0.024
"18320",512,"201504.414.1380.4","NMFS",2015,11,3,307,20,43.641705,-68.669468,24,22,2,24,0,"HB",0.024
"18321",513,"201504.415.1380.6","NMFS",2015,11,3,307,20.07,43.53858,-69.082283,30,26,4,27,3,"HB",0.024
"18322",513,"201504.416.1380.8","NMFS",2015,11,3,307,20.01,43.559165,-69.185823,5,5,0,5,0,"HB",0.024
"18323",513,"201504.417.1380.5","NMFS",2015,11,3,307,20.07,43.516463,-69.491958,5,5,0,5,0,"HB",0.024
"18324",513,"201504.418.1400.3","NMFS",2015,11,4,308,20.07,43.561685,-69.696415,75,32,43,69,6,"HB",0.024
"18325",513,"201504.419.1380.7","NMFS",2015,11,4,308,20.05,43.479095,-69.785093,2,1,1,1,1,"HB",0.024
"18326",513,"201504.420.1270.3","NMFS",2015,11,4,308,19.99,43.322343,-70.008232,0,0,0,0,0,"HB",0.024
"18327",513,"201504.422.1400.5","NMFS",2015,11,4,308,20.01,43.224677,-70.180315,3,0,3,2,1,"HB",0.024
"18328",514,"201504.423.1400.6","NMFS",2015,11,4,308,20.08,42.7653,-70.552118,86,43,43,72,14,"HB",0.024
"18329",514,"201504.424.1260.4","NMFS",2015,11,4,308,20.02,42.694545,-70.165983,3,1,2,3,0,"HB",0.024
"18330",514,"201504.425.1270.7","NMFS",2015,11,5,309,20.07,42.570955,-69.90974,0,0,0,0,0,"HB",0.024
"18331",514,"201504.427.1260.7","NMFS",2015,11,5,309,19.99,42.487593,-70.15569,0,0,0,0,0,"HB",0.024
"18332",514,"201504.428.1260.6","NMFS",2015,11,5,309,19.98,42.40684,-70.056942,0,0,0,0,0,"HB",0.024
"18333",514,"201504.429.1260.2","NMFS",2015,11,5,309,20.01,42.291403,-70.369642,2,1,1,2,0,"HB",0.024
"18334",514,"201504.430.3650.5","NMFS",2015,11,5,309,18.34,42.219562,-70.555493,131,83,48,115,16,"HB",0.024
"18335",514,"201504.431.3610.3","NMFS",2015,11,5,309,19.99,42.15828,-70.474595,94,46,48,71,23,"HB",0.024
"18336",514,"201504.432.3590.3","NMFS",2015,11,5,309,20.04,41.788798,-70.408035,28,13,15,17,11,"HB",0.024
"18337",526,"201602.194.1100.5","NMFS",2016,5,11,132,20.02,40.210738,-69.817932,0,0,0,0,0,"HB",0.024
"18338",526,"201602.196.1100.6","NMFS",2016,5,11,132,20.06,40.123828,-69.658112,0,0,0,0,0,"HB",0.024
"18339",526,"201602.199.1120.6","NMFS",2016,5,11,132,20.01,40.006167,-69.214105,2,0,2,2,0,"HB",0.024
"18340",526,"201602.200.1110.3","NMFS",2016,5,11,132,20.01,40.050487,-69.206987,0,0,0,0,0,"HB",0.024
"18341",526,"201602.201.1100.9","NMFS",2016,5,11,132,20.02,40.269943,-69.625065,0,0,0,0,0,"HB",0.024
"18342",526,"201602.202.1100.2","NMFS",2016,5,11,132,20,40.572737,-69.704955,0,0,0,0,0,"HB",0.024
"18343",526,"201602.203.1090.2","NMFS",2016,5,11,132,20.05,40.715532,-69.584738,0,0,0,0,0,"HB",0.024
"18344",526,"201602.204.1100.11","NMFS",2016,5,12,133,18.3,40.518703,-69.280942,0,0,0,0,0,"HB",0.024
"18345",526,"201602.205.1100.7","NMFS",2016,5,12,133,20.01,40.663382,-69.20448,0,0,0,0,0,"HB",0.024
"18346",526,"201602.206.1100.4","NMFS",2016,5,12,133,20,40.961917,-69.136668,0,0,0,0,0,"HB",0.024
"18347",521,"201602.207.1250.4","NMFS",2016,5,12,133,20.04,41.044057,-69.294252,0,0,0,0,0,"HB",0.024
"18348",521,"201602.209.1250.1","NMFS",2016,5,12,133,19.37,41.176277,-69.373225,0,0,0,0,0,"HB",0.024
"18349",521,"201602.210.1230.3","NMFS",2016,5,12,133,20.04,41.247788,-69.300835,3,2,1,3,0,"HB",0.024
"18350",521,"201602.211.1250.2","NMFS",2016,5,12,133,20,41.553682,-69.716192,0,0,0,0,0,"HB",0.024
"18351",521,"201602.212.3560.1","NMFS",2016,5,12,133,20,41.83078,-69.914752,3,3,0,3,0,"HB",0.024
"18352",521,"201602.213.3560.3","NMFS",2016,5,12,133,16.63,41.899,-69.9305,9,5,4,8,1,"HB",0.024
"18353",514,"201602.215.1280.1","NMFS",2016,5,17,138,20,42.53979,-69.746678,1,1,0,1,0,"HB",0.024
"18354",515,"201602.216.1280.6","NMFS",2016,5,18,139,20.02,42.407907,-69.660602,0,0,0,0,0,"HB",0.024
"18355",521,"201602.217.1240.5","NMFS",2016,5,18,139,20.04,42.219625,-69.02814,0,0,0,0,0,"HB",0.024
"18356",521,"201602.218.1280.7","NMFS",2016,5,18,139,20.02,42.319358,-68.928638,1,1,0,1,0,"HB",0.024
"18357",515,"201602.219.1280.5","NMFS",2016,5,18,139,20.01,42.516385,-68.625202,0,0,0,0,0,"HB",0.024
"18358",522,"201602.220.1240.2","NMFS",2016,5,18,139,20.02,42.249985,-68.667733,0,0,0,0,0,"HB",0.024
"18359",522,"201602.221.1240.4","NMFS",2016,5,18,139,20.01,42.188523,-68.731855,0,0,0,0,0,"HB",0.024
"18360",521,"201602.222.1240.1","NMFS",2016,5,18,139,20,42.200973,-68.93709,0,0,0,0,0,"HB",0.024
"18361",521,"201602.223.1240.3","NMFS",2016,5,18,139,20.02,42.0105,-68.995992,2,2,0,2,0,"HB",0.024
"18362",522,"201602.224.1240.8","NMFS",2016,5,19,140,20,41.82983,-68.712743,0,0,0,0,0,"HB",0.024
"18363",522,"201602.225.1240.7","NMFS",2016,5,19,140,20.03,41.470363,-68.7102,2,0,2,2,0,"HB",0.024
"18364",522,"201602.226.1230.1","NMFS",2016,5,19,140,20.02,41.344172,-68.728075,1,1,0,1,0,"HB",0.024
"18365",522,"201602.227.1230.4","NMFS",2016,5,19,140,20.02,41.4738,-68.575985,0,0,0,0,0,"HB",0.024
"18366",522,"201602.228.1230.2","NMFS",2016,5,19,140,20,41.455977,-68.365242,1,1,0,1,0,"HB",0.024
"18367",525,"201602.229.1190.4","NMFS",2016,5,19,140,20.19,41.152063,-68.326468,0,0,0,0,0,"HB",0.024
"18368",522,"201602.230.1200.1","NMFS",2016,5,19,140,20.01,41.108062,-68.589873,3,3,0,1,2,"HB",0.024
"18369",525,"201602.232.1190.5","NMFS",2016,5,19,140,20.01,40.983555,-68.142413,0,0,0,0,0,"HB",0.024
"18370",525,"201602.233.1130.2","NMFS",2016,5,20,141,20.03,40.788575,-67.889958,0,0,0,0,0,"HB",0.024
"18371",525,"201602.234.1130.11","NMFS",2016,5,20,141,20.02,40.728007,-67.794328,0,0,0,0,0,"HB",0.024
"18372",525,"201602.235.1130.4","NMFS",2016,5,20,141,20,40.572737,-67.882525,1,1,0,1,0,"HB",0.024
"18373",525,"201602.236.1130.3","NMFS",2016,5,20,141,20.02,40.52741,-68.084373,0,0,0,0,0,"HB",0.024
"18374",525,"201602.237.1130.5","NMFS",2016,5,20,141,20.02,40.55495,-68.300842,0,0,0,0,0,"HB",0.024
"18375",525,"201602.238.1130.6","NMFS",2016,5,20,141,20,40.604833,-68.411167,1,1,0,1,0,"HB",0.024
"18376",525,"201602.239.1130.8","NMFS",2016,5,20,141,20.02,40.57575,-68.552405,0,0,0,0,0,"HB",0.024
"18377",525,"201602.240.1140.3","NMFS",2016,5,20,141,19.96,40.328833,-68.378833,0,0,0,0,0,"HB",0.024
"18378",525,"201602.241.1150.3","NMFS",2016,5,20,141,20,40.290507,-67.993623,1,0,1,1,0,"HB",0.024
"18379",525,"201602.242.1140.2","NMFS",2016,5,20,141,20,40.373138,-67.745358,0,0,0,0,0,"HB",0.024
"18380",525,"201602.243.1150.1","NMFS",2016,5,20,141,19.79,40.463833,-67.694333,9,8,1,9,0,"HB",0.024
"18381",525,"201602.244.1140.1","NMFS",2016,5,21,142,20.02,40.45968,-67.607978,2,2,0,2,0,"HB",0.024
"18382",525,"201602.245.1130.10","NMFS",2016,5,21,142,20.01,40.99568,-67.445927,0,0,0,0,0,"HB",0.024
"18383",525,"201602.246.1130.1","NMFS",2016,5,21,142,20,41.038917,-67.566845,0,0,0,0,0,"HB",0.024
"18384",562,"201602.247.1190.7","NMFS",2016,5,21,142,20,41.200138,-67.433892,0,0,0,0,0,"HB",0.024
"18385",562,"201602.248.1190.10","NMFS",2016,5,21,142,20,41.424782,-67.593815,1,1,0,1,0,"HB",0.024
"18386",522,"201602.249.1190.6","NMFS",2016,5,21,142,20.01,41.52901,-67.726903,0,0,0,0,0,"HB",0.024
"18387",522,"201602.251.1200.5","NMFS",2016,5,21,142,19.99,41.738478,-67.834863,0,0,0,0,0,"HB",0.024
"18388",522,"201602.252.1200.4","NMFS",2016,5,21,142,20,41.797105,-68.057505,0,0,0,0,0,"HB",0.024
"18389",522,"201602.254.1210.4","NMFS",2016,5,21,142,20.01,41.831825,-68.023255,0,0,0,0,0,"HB",0.024
"18390",522,"201602.255.1220.1","NMFS",2016,5,21,142,20.01,41.94666,-68.125827,1,1,0,1,0,"HB",0.024
"18391",522,"201602.256.1240.6","NMFS",2016,5,22,143,20.01,42.21398,-68.357785,0,0,0,0,0,"HB",0.024
"18392",515,"201602.257.1290.6","NMFS",2016,5,22,143,20.01,42.341432,-67.971117,1,1,0,1,0,"HB",0.024
"18393",515,"201602.258.1290.3","NMFS",2016,5,22,143,20.02,42.455977,-68.254677,0,0,0,0,0,"HB",0.024
"18394",515,"201602.259.1360.12","NMFS",2016,5,22,143,20.02,42.915947,-68.102672,1,1,0,1,0,"HB",0.024
"18395",515,"201602.260.1360.9","NMFS",2016,5,22,143,20.02,43.185935,-68.188067,8,8,0,8,0,"HB",0.024
"18396",515,"201602.261.1360.11","NMFS",2016,5,22,143,20.02,43.24138,-68.283565,0,0,0,0,0,"HB",0.024
"18397",512,"201602.262.1360.10","NMFS",2016,5,22,143,20.02,43.521968,-68.010998,6,6,0,6,0,"HB",0.024
"18398",512,"201602.263.1360.6","NMFS",2016,5,22,143,20.01,43.593143,-67.962192,20,16,4,19,1,"HB",0.024
"18399",465,"201602.264.1360.2","NMFS",2016,5,23,144,20.02,43.457803,-67.391648,44,41,3,44,0,"HB",0.024
"18400",465,"201602.265.1360.7","NMFS",2016,5,23,144,20.01,43.351217,-67.421497,11,11,0,11,0,"HB",0.024
"18401",515,"201602.266.1360.5","NMFS",2016,5,23,144,20.02,42.973892,-67.75449,1,1,0,1,0,"HB",0.024
"18402",515,"201602.267.1360.1","NMFS",2016,5,23,144,20.01,42.875092,-67.675755,6,6,0,6,0,"HB",0.024
"18403",464,"201602.268.1290.9","NMFS",2016,5,23,144,20.01,42.712473,-67.658208,4,3,1,4,0,"HB",0.024
"18404",464,"201602.269.1290.2","NMFS",2016,5,23,144,20,42.406833,-67.5705,7,7,0,7,0,"HB",0.024
"18405",561,"201602.270.1220.4","NMFS",2016,5,23,144,20.07,42.160473,-67.287837,13,10,3,10,3,"HB",0.024
"18406",561,"201602.271.1210.2","NMFS",2016,5,23,144,20.02,42.16084,-67.217933,11,11,0,11,0,"HB",0.024
"18407",561,"201602.272.1200.6","NMFS",2016,5,24,145,20.01,42.037342,-67.423228,0,0,0,0,0,"HB",0.024
"18408",522,"201602.273.1200.2","NMFS",2016,5,24,145,20.04,41.950747,-67.702052,17,6,11,17,0,"HB",0.024
"18409",522,"201602.275.1200.3","NMFS",2016,5,24,145,20.04,41.7875,-67.752833,0,0,0,0,0,"HB",0.024
"18410",562,"201602.276.1190.1","NMFS",2016,5,24,145,20.01,41.560573,-67.298947,1,1,0,1,0,"HB",0.024
"18411",562,"201602.277.1190.8","NMFS",2016,5,24,145,19.99,41.456617,-67.398315,0,0,0,0,0,"HB",0.024
"18412",562,"201602.278.1190.2","NMFS",2016,5,24,145,20.02,41.516292,-67.249732,0,0,0,0,0,"HB",0.024
"18413",562,"201602.280.1190.12","NMFS",2016,5,24,145,19.99,41.487798,-67.117715,0,0,0,0,0,"HB",0.024
"18414",562,"201602.281.1160.3","NMFS",2016,5,24,145,20.05,41.6006,-66.955115,0,0,0,0,0,"HB",0.024
"18415",562,"201602.282.1160.6","NMFS",2016,5,24,145,20.04,41.53916,-66.84603,0,0,0,0,0,"HB",0.024
"18416",562,"201602.283.1160.2","NMFS",2016,5,24,145,20,41.483007,-66.63622,0,0,0,0,0,"HB",0.024
"18417",562,"201602.284.1160.7","NMFS",2016,5,25,146,20.01,41.403305,-66.579577,1,1,0,1,0,"HB",0.024
"18418",562,"201602.285.1160.12","NMFS",2016,5,25,146,20.03,41.206187,-67.089637,1,1,0,1,0,"HB",0.024
"18419",525,"201602.286.1130.9","NMFS",2016,5,25,146,20.02,41.07062,-67.196422,0,0,0,0,0,"HB",0.024
"18420",562,"201602.287.1160.9","NMFS",2016,5,25,146,20.01,41.097137,-67.012972,0,0,0,0,0,"HB",0.024
"18421",562,"201602.288.1160.4","NMFS",2016,5,25,146,20.02,41.037468,-66.922912,0,0,0,0,0,"HB",0.024
"18422",562,"201602.289.1180.3","NMFS",2016,5,25,146,20.05,40.902938,-66.56318,63,53,10,63,0,"HB",0.024
"18423",562,"201602.292.1180.6","NMFS",2016,5,25,146,19.53,40.996928,-66.440747,47,41,6,47,0,"HB",0.024
"18424",562,"201602.293.1170.2","NMFS",2016,5,25,146,20,41.037765,-66.473705,1,1,0,1,0,"HB",0.024
"18425",562,"201602.294.1160.10","NMFS",2016,5,25,146,20.03,41.204733,-66.440177,4,4,0,4,0,"HB",0.024
"18426",562,"201602.295.1170.4","NMFS",2016,5,25,146,20,41.16315,-66.364662,2,2,0,2,0,"HB",0.024
"18427",552,"201602.296.1170.1","NMFS",2016,5,26,147,20.02,41.194047,-66.310667,3,3,0,3,0,"HB",0.024
"18428",552,"201602.297.1160.13","NMFS",2016,5,26,147,20.03,41.372743,-66.302155,8,8,0,8,0,"HB",0.024
"18429",552,"201602.298.1170.3","NMFS",2016,5,26,147,20.01,41.461893,-66.11386,7,6,1,7,0,"HB",0.024
"18430",552,"201602.299.1160.14","NMFS",2016,5,26,147,20.01,41.584243,-66.218265,2,2,0,2,0,"HB",0.024
"18431",552,"201602.300.1160.5","NMFS",2016,5,26,147,20.01,41.560235,-66.438027,0,0,0,0,0,"HB",0.024
"18432",552,"201602.301.1160.11","NMFS",2016,5,26,147,20.01,41.585837,-66.504368,0,0,0,0,0,"HB",0.024
"18433",552,"201602.302.1160.8","NMFS",2016,5,26,147,20.01,41.82511,-66.412938,12,7,5,12,0,"HB",0.024
"18434",551,"201602.303.1160.1","NMFS",2016,5,26,147,20,41.935737,-66.12194,1,1,0,1,0,"HB",0.024
"18435",551,"201602.304.1180.2","NMFS",2016,5,26,147,20,42.064973,-65.959108,22,20,2,22,0,"HB",0.024
"18436",551,"201602.305.1180.1","NMFS",2016,5,26,147,20.02,41.94322,-65.735798,11,9,2,11,0,"HB",0.024
"18437",464,"201602.306.1290.7","NMFS",2016,5,26,147,20.05,42.076273,-65.747658,18,15,3,18,0,"HB",0.024
"18438",464,"201602.307.1290.10","NMFS",2016,5,26,147,20,42.189517,-65.643883,36,35,1,36,0,"HB",0.024
"18439",551,"201602.308.1220.2","NMFS",2016,5,27,148,20.02,42.15636,-66.143848,16,13,3,16,0,"HB",0.024
"18440",551,"201602.309.1210.1","NMFS",2016,5,27,148,20.03,42.13055,-66.263197,39,25,14,39,0,"HB",0.024
"18441",464,"201602.310.1290.4","NMFS",2016,5,27,148,20.01,42.433845,-66.431892,12,11,1,12,0,"HB",0.024
"18442",464,"201602.311.1290.8","NMFS",2016,5,27,148,20.01,42.565133,-66.469265,7,5,2,7,0,"HB",0.024
"18443",464,"201602.312.1300.2","NMFS",2016,5,27,148,20,42.475828,-66.833897,27,26,1,27,0,"HB",0.024
"18444",551,"201602.313.1300.1","NMFS",2016,5,27,148,20.02,42.30864,-66.632327,21,19,2,21,0,"HB",0.024
"18445",551,"201602.315.1220.3","NMFS",2016,5,27,148,20.02,42.200192,-66.795607,39,36,3,39,0,"HB",0.024
"18446",551,"201602.316.1210.3","NMFS",2016,5,27,148,20.02,42.153575,-66.89895,22,16,6,22,0,"HB",0.024
"18447",464,"201602.317.1300.3","NMFS",2016,5,28,149,20.01,42.40475,-67.075695,32,28,4,31,1,"HB",0.024
"18448",464,"201602.318.1290.1","NMFS",2016,5,28,149,20.03,42.692777,-66.992888,6,5,1,6,0,"HB",0.024
"18449",464,"201602.319.1290.5","NMFS",2016,5,28,149,20.02,42.72191,-67.072292,5,2,3,5,0,"HB",0.024
"18450",464,"201602.320.1360.3","NMFS",2016,5,28,149,20,42.862412,-67.025277,6,4,2,6,0,"HB",0.024
"18451",465,"201602.322.1340.6","NMFS",2016,5,28,149,20.02,43.313905,-66.857558,2,2,0,2,0,"HB",0.024
"18452",465,"201602.323.1340.8","NMFS",2016,5,28,149,20.01,43.410598,-66.7337,12,8,4,11,1,"HB",0.024
"18453",465,"201602.324.1340.2","NMFS",2016,5,28,149,20.01,43.46859,-66.738755,5,3,2,5,0,"HB",0.024
"18454",465,"201602.325.1340.3","NMFS",2016,5,29,150,20.01,43.678827,-67.073273,9,7,2,9,0,"HB",0.024
"18455",465,"201602.326.1340.1","NMFS",2016,5,29,150,19.98,43.645513,-67.225498,5,2,3,5,0,"HB",0.024
"18456",511,"201602.327.1340.5","NMFS",2016,5,29,150,20.04,44.032918,-67.186977,6,5,1,6,0,"HB",0.024
"18457",466,"201602.328.1340.4","NMFS",2016,5,29,150,20.02,44.016553,-66.677518,33,16,17,31,2,"HB",0.024
"18458",466,"201602.329.1351.4","NMFS",2016,5,29,150,20.03,44.303668,-66.824655,17,12,5,17,0,"HB",0.024
"18459",511,"201602.330.1351.3","NMFS",2016,5,29,150,20.02,44.265883,-66.863927,13,10,3,13,0,"HB",0.024
"18460",511,"201602.331.1351.2","NMFS",2016,5,29,150,20,44.21005,-67.075933,16,10,6,16,0,"HB",0.024
"18461",511,"201602.332.1351.1","NMFS",2016,5,29,150,20.01,44.27427,-67.072733,17,12,5,17,0,"HB",0.024
"18462",511,"201602.333.1390.6","NMFS",2016,5,29,150,19.99,44.431068,-67.470305,269,185,84,231,38,"HB",0.024
"18463",511,"201602.334.1390.1","NMFS",2016,5,30,151,20.02,44.242183,-67.75128,97,62,35,96,1,"HB",0.024
"18464",512,"201602.335.1390.4","NMFS",2016,5,30,151,20.11,44.123795,-67.913198,300,154,146,276,24,"HB",0.024
"18465",512,"201602.336.1380.4","NMFS",2016,5,30,151,20.01,44.022145,-67.926722,70,49,21,70,0,"HB",0.024
"18466",512,"201602.337.1360.4","NMFS",2016,5,30,151,20.04,43.861178,-67.907732,5,2,3,5,0,"HB",0.024
"18467",512,"201602.338.1360.8","NMFS",2016,5,30,151,20.09,43.798202,-67.805445,6,2,4,6,0,"HB",0.024
"18468",512,"201602.339.1390.3","NMFS",2016,5,30,151,19.95,43.988583,-68.219142,164,100,64,159,5,"HB",0.024
"18469",512,"201602.341.1390.2","NMFS",2016,5,30,151,20.02,43.77414,-68.744485,190,105,85,114,76,"HB",0.024
"18470",513,"201602.342.1380.2","NMFS",2016,5,31,152,20.01,43.64294,-69.22309,38,23,15,38,0,"HB",0.024
"18471",513,"201602.343.1380.3","NMFS",2016,5,31,152,20.06,43.65826,-69.39428,88,44,44,77,11,"HB",0.024
"18472",513,"201602.344.1380.5","NMFS",2016,5,31,152,20.11,43.533802,-69.764548,29,17,12,28,1,"HB",0.024
"18473",513,"201602.345.1400.1","NMFS",2016,5,31,152,20.02,43.593987,-69.839178,74,46,28,49,25,"HB",0.024
"18474",513,"201602.346.1400.3","NMFS",2016,5,31,152,20,43.505102,-69.943557,23,14,9,20,3,"HB",0.024
"18475",513,"201602.347.1380.7","NMFS",2016,5,31,152,20.02,43.38472,-69.588537,6,5,1,6,0,"HB",0.024
"18476",513,"201602.348.1370.5","NMFS",2016,5,31,152,19.99,43.249358,-69.252102,6,5,1,6,0,"HB",0.024
"18477",513,"201602.349.1380.8","NMFS",2016,6,1,153,20,43.42388,-69.055923,8,7,1,8,0,"HB",0.024
"18478",513,"201602.350.1380.6","NMFS",2016,6,1,153,20.01,43.500167,-69.041333,8,7,1,8,0,"HB",0.024
"18479",512,"201602.351.1380.1","NMFS",2016,6,1,153,19.99,43.392167,-68.785643,57,47,10,45,12,"HB",0.024
"18480",515,"201602.352.1370.3","NMFS",2016,6,1,153,20.06,43.000343,-68.751578,1,1,0,1,0,"HB",0.024
"18481",515,"201602.353.1370.1","NMFS",2016,6,1,153,19.99,42.870612,-68.785555,9,9,0,9,0,"HB",0.024
"18482",515,"201602.354.1370.2","NMFS",2016,6,1,153,20.01,42.661297,-68.99073,0,0,0,0,0,"HB",0.024
"18483",515,"201602.355.1370.6","NMFS",2016,6,1,153,19.99,42.756918,-69.060355,1,1,0,1,0,"HB",0.024
"18484",515,"201602.356.1370.4","NMFS",2016,6,1,153,20.03,42.758172,-69.304292,4,3,1,4,0,"HB",0.024
"18485",515,"201602.357.1280.3","NMFS",2016,6,1,153,20.03,42.740193,-69.567835,3,3,0,3,0,"HB",0.024
"18486",513,"201602.358.1370.7","NMFS",2016,6,2,154,20,42.93534,-69.656998,4,3,1,4,0,"HB",0.024
"18487",513,"201602.359.1280.2","NMFS",2016,6,2,154,19.99,43.042578,-69.92941,1,1,0,1,0,"HB",0.024
"18488",513,"201602.360.1270.3","NMFS",2016,6,2,154,20.21,43.051028,-70.124303,6,5,1,6,0,"HB",0.024
"18489",513,"201602.361.1260.5","NMFS",2016,6,2,154,20.05,42.927492,-70.061132,43,43,0,43,0,"HB",0.024
"18490",513,"201602.362.1270.1","NMFS",2016,6,2,154,20.05,42.931217,-69.999307,8,8,0,8,0,"HB",0.024
"18491",513,"201602.363.1280.4","NMFS",2016,6,2,154,20.05,42.837023,-69.940677,0,0,0,0,0,"HB",0.024
"18492",514,"201602.364.1260.6","NMFS",2016,6,2,154,19.93,42.719592,-70.31562,7,6,1,7,0,"HB",0.024
"18493",514,"201602.366.1260.4","NMFS",2016,6,2,154,19.99,42.814698,-70.32994,4,4,0,4,0,"HB",0.024
"18494",513,"201602.367.1270.2","NMFS",2016,6,2,154,19.98,42.955965,-70.374325,13,6,7,13,0,"HB",0.024
"18495",513,"201602.368.1400.2","NMFS",2016,6,2,154,20.07,43.048982,-70.480865,72,38,34,64,8,"HB",0.024
"18496",514,"201602.369.3640.3","NMFS",2016,6,2,154,20,42.831745,-70.7431,76,50,26,68,8,"HB",0.024
"18497",514,"201602.370.3650.1","NMFS",2016,6,3,155,19.96,42.720712,-70.610947,90,44,46,71,19,"HB",0.024
"18498",514,"201602.371.3660.2","NMFS",2016,6,3,155,20.01,42.613775,-70.488542,79,24,55,66,13,"HB",0.024
"18499",514,"201602.372.3660.3","NMFS",2016,6,3,155,20.02,42.52729,-70.621782,90,49,41,71,19,"HB",0.024
"18500",514,"201602.373.3660.1","NMFS",2016,6,3,155,20.01,42.513205,-70.700155,57,34,23,41,16,"HB",0.024
"18501",514,"201602.374.3640.1","NMFS",2016,6,3,155,20.04,42.548073,-70.721717,205,118,87,170,35,"HB",0.024
"18502",514,"201602.375.3640.2","NMFS",2016,6,3,155,19.96,42.397235,-70.85724,227,129,98,163,64,"HB",0.024
"18503",514,"201602.376.1260.1","NMFS",2016,6,3,155,20,42.371783,-70.453733,11,6,5,11,0,"HB",0.024
"18504",514,"201602.377.1260.3","NMFS",2016,6,3,155,20,42.457402,-70.309137,16,14,2,16,0,"HB",0.024
"18505",514,"201602.378.1260.2","NMFS",2016,6,3,155,18.14,42.300922,-70.293657,26,19,7,26,0,"HB",0.024
"18506",514,"201602.379.3610.3","NMFS",2016,6,3,155,20.05,42.119162,-70.073157,6,6,0,6,0,"HB",0.024
"18507",521,"201602.381.1230.6","NMFS",2016,6,4,156,19.99,41.994377,-69.87789,23,21,2,23,0,"HB",0.024
"18508",521,"201602.383.1250.7","NMFS",2016,6,4,156,20.02,41.980382,-69.895248,20,16,4,19,1,"HB",0.024
"18509",521,"201602.384.1270.4","NMFS",2016,6,4,156,20.07,42.096685,-69.810878,14,13,1,14,0,"HB",0.024
"18510",521,"201602.385.1270.5","NMFS",2016,6,4,156,20.04,42.154767,-69.95828,6,5,1,6,0,"HB",0.024
"18511",514,"201602.386.3610.1","NMFS",2016,6,4,156,18.93,41.983313,-70.325002,14,5,9,13,1,"HB",0.024
"18512",514,"201602.387.3600.1","NMFS",2016,6,4,156,19.98,41.962815,-70.306165,17,7,10,15,2,"HB",0.024
"18513",514,"201602.388.3590.1","NMFS",2016,6,4,156,20,41.810555,-70.278652,43,18,25,36,7,"HB",0.024
"18514",514,"201602.389.3590.2","NMFS",2016,6,4,156,20.01,41.897265,-70.469625,61,27,34,47,14,"HB",0.024
"18515",514,"201602.392.3600.3","NMFS",2016,6,4,156,20.19,41.937343,-70.443128,83,27,56,72,11,"HB",0.024
"18516",514,"201602.393.3590.3","NMFS",2016,6,5,157,20.01,42.036503,-70.56089,71,44,27,53,18,"HB",0.024
"18517",514,"201602.394.3600.2","NMFS",2016,6,5,157,20,42.115523,-70.517817,52,37,15,49,3,"HB",0.024
"18518",514,"201602.395.3650.3","NMFS",2016,6,7,159,20.03,42.258397,-70.602318,24,13,11,21,3,"HB",0.024
"18519",514,"201602.396.3650.2","NMFS",2016,6,7,159,20.01,42.184972,-70.569113,38,19,19,34,4,"HB",0.024
"18520",514,"201602.397.3610.2","NMFS",2016,6,7,159,20.03,42.169142,-70.499632,87,47,40,75,12,"HB",0.024
"18521",526,"201604.202.1100.9","NMFS",2016,10,4,278,20,40.499623,-69.807487,0,0,0,0,0,"HB",0.024
"18522",526,"201604.203.1100.6","NMFS",2016,10,4,278,20,40.602627,-69.73755,0,0,0,0,0,"HB",0.024
"18523",526,"201604.204.1100.5","NMFS",2016,10,4,278,20.08,40.525958,-69.525492,0,0,0,0,0,"HB",0.024
"18524",526,"201604.205.1100.1","NMFS",2016,10,4,278,19.98,40.484472,-68.994957,0,0,0,0,0,"HB",0.024
"18525",526,"201604.206.1100.2","NMFS",2016,10,5,279,20.06,40.805153,-69.018147,3,3,0,3,0,"HB",0.024
"18526",526,"201604.207.1090.4","NMFS",2016,10,5,279,20,40.98352,-69.245728,6,4,2,5,1,"HB",0.024
"18527",521,"201604.208.1230.4","NMFS",2016,10,5,279,19.98,41.143647,-69.107,0,0,0,0,0,"HB",0.024
"18528",521,"201604.209.1230.3","NMFS",2016,10,5,279,20.01,41.170832,-68.942892,4,3,1,4,0,"HB",0.024
"18529",521,"201604.210.1240.8","NMFS",2016,10,5,279,20.03,41.273007,-69.091248,2,2,0,2,0,"HB",0.024
"18530",521,"201604.211.1230.2","NMFS",2016,10,5,279,20,41.307422,-69.279507,0,0,0,0,0,"HB",0.024
"18531",521,"201604.212.1240.7","NMFS",2016,10,5,279,20.05,41.49963,-69.18112,0,0,0,0,0,"HB",0.024
"18532",521,"201604.213.1250.4","NMFS",2016,10,5,279,20.01,41.438315,-69.379398,0,0,0,0,0,"HB",0.024
"18533",521,"201604.215.1250.5","NMFS",2016,10,6,280,19.84,41.572383,-69.565495,3,3,0,3,0,"HB",0.024
"18534",521,"201604.216.1250.3","NMFS",2016,10,6,280,20.01,41.566628,-69.684115,12,11,1,12,0,"HB",0.024
"18535",526,"201604.222.1100.4","NMFS",2016,10,12,286,20.01,40.136748,-69.772005,2,2,0,1,1,"HB",0.024
"18536",526,"201604.223.1110.2","NMFS",2016,10,12,286,20.23,40.045027,-69.632748,0,0,0,0,0,"HB",0.024
"18537",526,"201604.224.1120.3","NMFS",2016,10,12,286,20.05,39.952738,-69.583442,29,16,13,27,2,"HB",0.024
"18538",526,"201604.225.1110.3","NMFS",2016,10,12,286,20.03,39.960082,-69.529537,10,7,3,9,1,"HB",0.024
"18539",526,"201604.227.1120.1","NMFS",2016,10,12,286,19.98,40.055795,-68.973512,0,0,0,0,0,"HB",0.024
"18540",526,"201604.228.1110.1","NMFS",2016,10,12,286,19.99,40.201865,-68.877422,0,0,0,0,0,"HB",0.024
"18541",525,"201604.229.1140.3","NMFS",2016,10,12,286,20.03,40.161512,-68.734172,0,0,0,0,0,"HB",0.024
"18542",525,"201604.230.1140.4","NMFS",2016,10,13,287,20.01,40.26845,-68.49532,0,0,0,0,0,"HB",0.024
"18543",525,"201604.231.1130.8","NMFS",2016,10,13,287,19.99,40.378665,-68.50048,0,0,0,0,0,"HB",0.024
"18544",525,"201604.232.1130.5","NMFS",2016,10,13,287,20,40.649293,-68.653847,0,0,0,0,0,"HB",0.024
"18545",525,"201604.234.1190.10","NMFS",2016,10,13,287,20.05,40.874148,-68.641475,1,1,0,1,0,"HB",0.024
"18546",522,"201604.235.1200.5","NMFS",2016,10,13,287,20.05,41.257808,-68.456012,1,1,0,1,0,"HB",0.024
"18547",522,"201604.237.1200.7","NMFS",2016,10,13,287,20.01,41.235152,-68.369992,5,5,0,3,2,"HB",0.024
"18548",525,"201604.238.1190.2","NMFS",2016,10,13,287,20.01,40.99098,-68.393552,0,0,0,0,0,"HB",0.024
"18549",525,"201604.239.1190.8","NMFS",2016,10,14,288,20.05,41.075318,-68.252645,0,0,0,0,0,"HB",0.024
"18550",525,"201604.240.1190.7","NMFS",2016,10,14,288,20,41.183685,-68.110232,0,0,0,0,0,"HB",0.024
"18551",522,"201604.241.1200.3","NMFS",2016,10,14,288,19.99,41.481363,-68.28151,0,0,0,0,0,"HB",0.024
"18552",522,"201604.244.1230.7","NMFS",2016,10,14,288,20,41.619725,-68.45014,2,1,1,2,0,"HB",0.024
"18553",522,"201604.245.1220.4","NMFS",2016,10,14,288,20.05,41.757912,-68.351035,1,1,0,1,0,"HB",0.024
"18554",522,"201604.246.1210.4","NMFS",2016,10,14,288,20.04,41.878748,-67.978728,2,2,0,2,0,"HB",0.024
"18555",522,"201604.247.1220.1","NMFS",2016,10,14,288,19.99,42.015125,-67.871693,0,0,0,0,0,"HB",0.024
"18556",522,"201604.248.1290.8","NMFS",2016,10,14,288,20.02,42.046463,-68.126073,1,1,0,1,0,"HB",0.024
"18557",522,"201604.249.1290.3","NMFS",2016,10,15,289,20,42.305263,-67.953375,1,1,0,1,0,"HB",0.024
"18558",515,"201604.250.1290.10","NMFS",2016,10,15,289,20,42.520097,-67.974078,2,2,0,2,0,"HB",0.024
"18559",515,"201604.251.1290.9","NMFS",2016,10,15,289,20,42.6471,-67.911293,3,3,0,3,0,"HB",0.024
"18560",464,"201604.252.1290.4","NMFS",2016,10,15,289,20,42.359123,-67.588855,0,0,0,0,0,"HB",0.024
"18561",464,"201604.253.1300.1","NMFS",2016,10,15,289,20.04,42.340747,-67.505407,1,0,1,1,0,"HB",0.024
"18562",561,"201604.254.1210.2","NMFS",2016,10,15,289,20.03,42.102998,-67.421053,2,2,0,2,0,"HB",0.024
"18563",522,"201604.256.1200.8","NMFS",2016,10,15,289,20,41.976095,-67.689283,31,23,8,28,3,"HB",0.024
"18564",522,"201604.257.1200.1","NMFS",2016,10,15,289,20.01,41.836452,-67.681012,1,1,0,1,0,"HB",0.024
"18565",562,"201604.258.1190.9","NMFS",2016,10,16,290,20.04,41.460563,-67.384633,0,0,0,0,0,"HB",0.024
"18566",562,"201604.259.1190.4","NMFS",2016,10,16,290,19.98,41.484093,-67.461313,0,0,0,0,0,"HB",0.024
"18567",562,"201604.261.1190.11","NMFS",2016,10,16,290,19.99,41.452968,-67.60451,0,0,0,0,0,"HB",0.024
"18568",562,"201604.262.1190.5","NMFS",2016,10,16,290,19.99,41.335883,-67.519983,0,0,0,0,0,"HB",0.024
"18569",525,"201604.263.1130.1","NMFS",2016,10,16,290,20.05,40.97718,-67.446603,1,1,0,1,0,"HB",0.024
"18570",525,"201604.264.1130.3","NMFS",2016,10,16,290,19.99,40.945783,-67.569868,1,1,0,1,0,"HB",0.024
"18571",525,"201604.265.1130.2","NMFS",2016,10,16,290,20.01,40.848607,-67.888615,1,1,0,1,0,"HB",0.024
"18572",525,"201604.266.1130.6","NMFS",2016,10,16,290,20.04,40.677585,-67.805287,0,0,0,0,0,"HB",0.024
"18573",525,"201604.267.1130.11","NMFS",2016,10,16,290,20.04,40.749538,-68.067128,0,0,0,0,0,"HB",0.024
"18574",525,"201604.268.1130.7","NMFS",2016,10,17,291,20.01,40.505278,-68.406322,0,0,0,0,0,"HB",0.024
"18575",525,"201604.269.1130.4","NMFS",2016,10,17,291,19.99,40.430577,-68.392152,2,0,2,2,0,"HB",0.024
"18576",525,"201604.270.1140.2","NMFS",2016,10,17,291,20.01,40.36173,-68.287503,0,0,0,0,0,"HB",0.024
"18577",525,"201604.271.1150.1","NMFS",2016,10,17,291,20.01,40.365465,-68.108478,0,0,0,0,0,"HB",0.024
"18578",525,"201604.272.1150.2","NMFS",2016,10,17,291,20,40.401812,-67.870742,1,1,0,1,0,"HB",0.024
"18579",525,"201604.273.1140.1","NMFS",2016,10,17,291,20.04,40.482748,-67.601968,0,0,0,0,0,"HB",0.024
"18580",525,"201604.274.1130.10","NMFS",2016,10,17,291,20.01,40.829842,-67.123942,4,4,0,4,0,"HB",0.024
"18581",525,"201604.275.1150.3","NMFS",2016,10,17,291,20,40.647887,-66.885198,12,6,6,12,0,"HB",0.024
"18582",562,"201604.276.1170.2","NMFS",2016,10,17,291,19.98,40.821877,-66.736305,0,0,0,0,0,"HB",0.024
"18583",562,"201604.277.1180.4","NMFS",2016,10,18,292,20.01,40.826318,-66.69091,0,0,0,0,0,"HB",0.024
"18584",562,"201604.278.1180.3","NMFS",2016,10,18,292,20.01,40.849615,-66.612418,10,7,3,10,0,"HB",0.024
"18585",562,"201604.279.1160.3","NMFS",2016,10,18,292,20.04,40.934337,-66.68975,3,3,0,3,0,"HB",0.024
"18586",562,"201604.280.1160.11","NMFS",2016,10,18,292,20.01,40.981272,-66.542717,6,6,0,6,0,"HB",0.024
"18587",562,"201604.281.1170.4","NMFS",2016,10,18,292,19.99,41.133955,-66.371812,13,13,0,13,0,"HB",0.024
"18588",552,"201604.282.1170.3","NMFS",2016,10,18,292,20.03,41.349125,-66.23172,6,6,0,6,0,"HB",0.024
"18589",552,"201604.283.1160.12","NMFS",2016,10,18,292,20.03,41.45724,-66.38708,15,14,1,15,0,"HB",0.024
"18590",552,"201604.284.1160.10","NMFS",2016,10,18,292,20,41.55265,-66.22571,8,7,1,8,0,"HB",0.024
"18591",552,"201604.285.1160.2","NMFS",2016,10,18,292,20,41.674727,-66.15929,12,12,0,12,0,"HB",0.024
"18592",552,"201604.286.1160.7","NMFS",2016,10,18,292,20.11,41.762297,-66.501442,38,36,2,38,0,"HB",0.024
"18593",552,"201604.287.1160.4","NMFS",2016,10,18,292,20,41.754037,-66.740255,5,5,0,5,0,"HB",0.024
"18594",562,"201604.288.1160.14","NMFS",2016,10,19,293,20.01,41.661388,-66.879657,0,0,0,0,0,"HB",0.024
"18595",562,"201604.290.1160.15","NMFS",2016,10,19,293,20.03,41.573217,-66.8391,1,1,0,1,0,"HB",0.024
"18596",562,"201604.291.1160.13","NMFS",2016,10,19,293,20.02,41.532002,-66.640558,6,5,1,6,0,"HB",0.024
"18597",562,"201604.292.1160.5","NMFS",2016,10,19,293,19.98,41.41565,-66.757472,10,10,0,10,0,"HB",0.024
"18598",562,"201604.293.1160.8","NMFS",2016,10,19,293,20,41.289132,-66.875923,3,3,0,3,0,"HB",0.024
"18599",562,"201604.294.1160.6","NMFS",2016,10,19,293,20.04,41.3945,-67.001035,0,0,0,0,0,"HB",0.024
"18600",562,"201604.295.1160.9","NMFS",2016,10,19,293,20.01,41.587328,-67.049675,0,0,0,0,0,"HB",0.024
"18601",561,"201604.297.1190.12","NMFS",2016,10,19,293,20.2,41.92173,-67.23816,1,1,0,1,0,"HB",0.024
"18602",561,"201604.298.1200.4","NMFS",2016,10,19,293,20.05,42.067812,-67.154685,3,3,0,3,0,"HB",0.024
"18603",551,"201604.299.1210.1","NMFS",2016,10,20,294,20,42.133583,-66.983372,5,5,0,5,0,"HB",0.024
"18604",551,"201604.300.1220.2","NMFS",2016,10,20,294,19.98,42.186155,-66.801272,18,14,4,18,0,"HB",0.024
"18605",551,"201604.301.1290.2","NMFS",2016,10,20,294,20.04,42.273585,-66.401973,3,3,0,3,0,"HB",0.024
"18606",551,"201604.303.1220.5","NMFS",2016,10,20,294,20.02,42.14722,-66.326855,24,21,3,24,0,"HB",0.024
"18607",551,"201604.306.1170.5","NMFS",2016,10,20,294,20.01,41.97426,-65.938742,5,5,0,5,0,"HB",0.024
"18608",551,"201604.307.1180.2","NMFS",2016,10,20,294,20.01,42.052208,-65.880657,12,10,2,12,0,"HB",0.024
"18609",551,"201604.308.1180.1","NMFS",2016,10,20,294,20.02,41.982562,-65.756373,1,1,0,1,0,"HB",0.024
"18610",464,"201604.309.1290.5","NMFS",2016,10,20,294,20.03,42.173793,-65.799447,0,0,0,0,0,"HB",0.024
"18611",464,"201604.312.1300.2","NMFS",2016,10,21,295,20.02,42.446903,-66.683402,1,0,1,1,0,"HB",0.024
"18612",551,"201604.313.1210.5","NMFS",2016,10,21,295,20.02,42.104593,-66.965918,16,15,1,15,1,"HB",0.024
"18613",464,"201604.314.1300.3","NMFS",2016,10,21,295,20.01,42.469598,-67.166368,5,4,1,5,0,"HB",0.024
"18614",514,"201604.316.1270.4","NMFS",2016,10,22,296,20.02,42.513582,-69.961357,0,0,0,0,0,"HB",0.024
"18615",514,"201604.317.1260.4","NMFS",2016,10,22,296,20.01,42.412768,-70.094308,0,0,0,0,0,"HB",0.024
"18616",514,"201604.318.1270.2","NMFS",2016,10,22,296,20.01,42.314575,-70.00071,0,0,0,0,0,"HB",0.024
"18617",514,"201604.319.1260.2","NMFS",2016,10,22,296,20.05,42.224803,-70.217473,1,1,0,1,0,"HB",0.024
"18618",514,"201604.321.3610.4","NMFS",2016,10,22,296,20,42.10471,-70.2472,128,76,52,128,0,"HB",0.024
"18619",514,"201604.322.3610.2","NMFS",2016,10,22,296,20.01,42.091065,-70.382268,86,43,43,79,7,"HB",0.024
"18620",514,"201604.323.3610.3","NMFS",2016,10,22,296,20.04,42.020585,-70.357773,146,65,81,133,13,"HB",0.024
"18621",514,"201604.324.3600.3","NMFS",2016,10,22,296,20.05,41.978415,-70.218593,30,17,13,30,0,"HB",0.024
"18622",514,"201604.325.3590.3","NMFS",2016,10,23,297,20.02,41.8716,-70.222742,4,4,0,4,0,"HB",0.024
"18623",514,"201604.326.3590.2","NMFS",2016,10,23,297,20.01,41.821657,-70.28974,0,0,0,0,0,"HB",0.024
"18624",514,"201604.327.3590.1","NMFS",2016,10,23,297,20.02,41.834745,-70.404902,61,33,28,33,28,"HB",0.024
"18625",514,"201604.328.3600.2","NMFS",2016,10,23,297,20.02,41.965945,-70.459213,151,81,70,109,42,"HB",0.024
"18626",514,"201604.329.3600.1","NMFS",2016,10,23,297,20,42.003155,-70.520157,192,122,70,170,22,"HB",0.024
"18627",514,"201604.330.3640.1","NMFS",2016,10,23,297,16.41,42.233828,-70.608622,237,142,95,151,86,"HB",0.024
"18628",514,"201604.331.3660.2","NMFS",2016,10,23,297,20.02,42.256897,-70.5414,81,45,36,69,12,"HB",0.024
"18629",514,"201604.333.3650.1","NMFS",2016,10,23,297,20.02,42.324998,-70.68303,452,248,204,354,98,"HB",0.024
"18630",514,"201604.334.3640.4","NMFS",2016,10,23,297,20.04,42.408483,-70.836318,659,352,307,323,336,"HB",0.024
"18631",514,"201604.335.3660.3","NMFS",2016,10,24,298,20.02,42.619367,-70.534085,569,310,259,408,161,"HB",0.024
"18632",514,"201604.336.3660.1","NMFS",2016,10,24,298,20.05,42.654967,-70.500728,132,69,63,120,12,"HB",0.024
"18633",514,"201604.337.3650.2","NMFS",2016,10,24,298,20.09,42.731825,-70.643753,278,176,102,230,48,"HB",0.024
"18634",514,"201604.338.3640.2","NMFS",2016,10,24,298,20.01,42.824647,-70.747082,266,133,133,248,18,"HB",0.024
"18635",513,"201604.339.1400.1","NMFS",2016,10,24,298,20.03,42.868595,-70.604235,75,38,37,68,7,"HB",0.024
"18636",513,"201604.340.1400.3","NMFS",2016,10,24,298,20.01,42.961495,-70.45441,42,27,15,41,1,"HB",0.024
"18637",514,"201604.341.1260.3","NMFS",2016,10,24,298,20,42.751227,-70.400652,17,9,8,8,9,"HB",0.024
"18638",514,"201604.342.1260.6","NMFS",2016,10,24,298,20,42.667945,-70.294545,0,0,0,0,0,"HB",0.024
"18639",514,"201604.343.1260.1","NMFS",2016,10,24,298,20.06,42.750713,-70.286328,4,1,3,3,1,"HB",0.024
"18640",513,"201604.344.1260.5","NMFS",2016,10,25,299,18.42,42.852485,-70.194138,3,1,2,2,1,"HB",0.024
"18641",514,"201604.345.1270.3","NMFS",2016,10,25,299,20.03,42.704288,-70.021135,0,0,0,0,0,"HB",0.024
"18642",513,"201604.346.1280.7","NMFS",2016,10,25,299,20.01,42.846685,-69.729193,0,0,0,0,0,"HB",0.024
"18643",515,"201604.347.1370.2","NMFS",2016,10,25,299,20.02,42.815193,-69.310328,0,0,0,0,0,"HB",0.024
"18644",515,"201604.349.1370.8","NMFS",2016,10,25,299,20.01,42.782075,-69.328285,6,6,0,6,0,"HB",0.024
"18645",515,"201604.351.1370.7","NMFS",2016,10,26,300,20.02,42.94851,-69.275563,0,0,0,0,0,"HB",0.024
"18646",515,"201604.352.1370.6","NMFS",2016,10,26,300,20,43.069958,-69.149645,0,0,0,0,0,"HB",0.024
"18647",513,"201604.353.1370.9","NMFS",2016,10,26,300,20.02,43.14431,-69.209343,0,0,0,0,0,"HB",0.024
"18648",513,"201604.354.1370.5","NMFS",2016,10,26,300,20,43.229397,-69.175282,0,0,0,0,0,"HB",0.024
"18649",515,"201604.355.1370.1","NMFS",2016,10,26,300,20.03,43.196342,-68.935997,0,0,0,0,0,"HB",0.024
"18650",512,"201604.356.1380.8","NMFS",2016,10,26,300,19.99,43.461663,-68.5251,0,0,0,0,0,"HB",0.024
"18651",512,"201604.357.1380.2","NMFS",2016,10,26,300,20.07,43.406038,-68.410212,0,0,0,0,0,"HB",0.024
"18652",512,"201604.358.1360.4","NMFS",2016,10,26,300,20.03,43.370152,-68.190313,1,1,0,1,0,"HB",0.024
"18653",515,"201604.359.1360.10","NMFS",2016,10,27,301,20.02,43.266723,-67.844867,2,2,0,2,0,"HB",0.024
"18654",515,"201604.360.1360.8","NMFS",2016,10,27,301,20.04,42.993287,-67.938328,1,1,0,1,0,"HB",0.024
"18655",515,"201604.361.1360.9","NMFS",2016,10,27,301,20.04,42.805213,-68.373753,1,1,0,1,0,"HB",0.024
"18656",515,"201604.362.1240.1","NMFS",2016,10,27,301,20.03,42.421343,-68.600565,0,0,0,0,0,"HB",0.024
"18657",514,"201604.363.3650.5","NMFS",2016,11,2,307,19.98,42.200585,-70.575365,238,148,90,150,88,"HB",0.024
"18658",514,"201604.364.3560.5","NMFS",2016,11,2,307,20.06,42.086548,-70.11733,0,0,0,0,0,"HB",0.024
"18659",521,"201604.365.3560.6","NMFS",2016,11,2,307,20.05,41.81492,-69.906332,0,0,0,0,0,"HB",0.024
"18660",521,"201604.366.3560.3","NMFS",2016,11,2,307,20.01,41.792017,-69.90337,2,1,1,2,0,"HB",0.024
"18661",521,"201604.367.1250.1","NMFS",2016,11,2,307,20,41.73833,-69.841697,3,1,2,3,0,"HB",0.024
"18662",521,"201604.368.1230.6","NMFS",2016,11,2,307,20.04,41.82738,-69.780855,7,7,0,7,0,"HB",0.024
"18663",521,"201604.369.1230.5","NMFS",2016,11,2,307,20.02,41.872658,-69.78779,18,17,1,18,0,"HB",0.024
"18664",521,"201604.370.1270.1","NMFS",2016,11,3,308,20,42.158127,-69.763777,2,2,0,2,0,"HB",0.024
"18665",514,"201604.371.1280.1","NMFS",2016,11,3,308,20.01,42.556935,-69.69343,0,0,0,0,0,"HB",0.024
"18666",515,"201604.372.1280.6","NMFS",2016,11,3,308,20.06,42.387763,-69.518432,2,2,0,2,0,"HB",0.024
"18667",521,"201604.373.1280.2","NMFS",2016,11,3,308,20.07,42.212312,-69.517727,0,0,0,0,0,"HB",0.024
"18668",521,"201604.374.1240.3","NMFS",2016,11,3,308,20.04,42.154055,-69.193167,0,0,0,0,0,"HB",0.024
"18669",521,"201604.375.1280.5","NMFS",2016,11,3,308,20.05,42.02018,-69.188945,0,0,0,0,0,"HB",0.024
"18670",521,"201604.376.1240.6","NMFS",2016,11,3,308,19.99,41.874205,-69.123587,0,0,0,0,0,"HB",0.024
"18671",521,"201604.377.1240.5","NMFS",2016,11,3,308,20.02,41.899657,-68.945978,0,0,0,0,0,"HB",0.024
"18672",522,"201604.378.1240.4","NMFS",2016,11,3,308,20.04,41.940122,-68.717915,0,0,0,0,0,"HB",0.024
"18673",522,"201604.379.1240.2","NMFS",2016,11,4,309,20,42.139678,-68.722162,0,0,0,0,0,"HB",0.024
"18674",515,"201604.380.1280.3","NMFS",2016,11,4,309,20.01,42.337913,-68.845697,0,0,0,0,0,"HB",0.024
"18675",464,"201604.381.1360.6","NMFS",2016,11,4,309,20.03,42.949988,-67.628863,2,2,0,2,0,"HB",0.024
"18676",464,"201604.382.1360.5","NMFS",2016,11,4,309,20.02,42.87459,-67.585545,7,5,2,6,1,"HB",0.024
"18677",464,"201604.383.1290.6","NMFS",2016,11,4,309,20.01,42.738117,-67.205992,4,3,1,4,0,"HB",0.024
"18678",464,"201604.384.1290.12","NMFS",2016,11,4,309,20.04,42.634732,-67.206122,6,4,2,6,0,"HB",0.024
"18679",464,"201604.385.1290.1","NMFS",2016,11,5,310,20,42.682233,-66.890875,9,6,3,9,0,"HB",0.024
"18680",464,"201604.386.1360.2","NMFS",2016,11,5,310,20.02,42.846985,-66.959318,13,10,3,13,0,"HB",0.024
"18681",465,"201604.387.1340.5","NMFS",2016,11,5,310,19.86,43.34067,-66.631228,8,2,6,8,0,"HB",0.024
"18682",465,"201604.388.1340.1","NMFS",2016,11,5,310,20.05,43.31301,-66.8569,16,14,2,16,0,"HB",0.024
"18683",465,"201604.389.1340.7","NMFS",2016,11,5,310,20.01,43.674065,-66.898837,13,10,3,12,1,"HB",0.024
"18684",511,"201604.390.1340.3","NMFS",2016,11,5,310,20,43.899485,-67.100383,23,17,6,23,0,"HB",0.024
"18685",465,"201604.391.1360.7","NMFS",2016,11,5,310,20.05,43.811558,-67.394398,19,17,2,19,0,"HB",0.024
"18686",511,"201604.392.1340.6","NMFS",2016,11,5,310,20,43.895132,-67.357183,12,12,0,11,1,"HB",0.024
"18687",511,"201604.393.1340.4","NMFS",2016,11,6,311,20.01,44.067005,-67.295802,1,1,0,1,0,"HB",0.024
"18688",511,"201604.394.1340.2","NMFS",2016,11,6,311,20,44.006562,-67.068033,19,16,3,19,0,"HB",0.024
"18689",466,"201604.395.1351.1","NMFS",2016,11,6,311,19.99,44.110717,-66.783353,72,38,34,71,1,"HB",0.024
"18690",466,"201604.396.1351.2","NMFS",2016,11,6,311,20.06,44.269017,-66.682757,8,5,3,8,0,"HB",0.024
"18691",466,"201604.397.1351.3","NMFS",2016,11,6,311,20.06,44.299557,-66.628213,3,2,1,3,0,"HB",0.024
"18692",511,"201604.398.1351.4","NMFS",2016,11,6,311,20.01,44.244933,-67.24927,9,8,1,9,0,"HB",0.024
"18693",511,"201604.399.1390.8","NMFS",2016,11,6,311,20.01,44.34041,-67.496445,316,171,145,286,30,"HB",0.024
"18694",511,"201604.400.1380.7","NMFS",2016,11,6,311,20.03,44.281393,-67.522042,126,84,42,125,1,"HB",0.024
"18695",511,"201604.401.1360.11","NMFS",2016,11,6,311,20.02,44.187928,-67.526785,15,11,4,15,0,"HB",0.024
"18696",511,"201604.402.1360.3","NMFS",2016,11,7,312,20,44.060325,-67.601578,6,6,0,6,0,"HB",0.024
"18697",512,"201604.403.1390.4","NMFS",2016,11,7,312,19.95,44.240873,-67.932023,537,284,253,322,215,"HB",0.024
"18698",512,"201604.404.1390.3","NMFS",2016,11,7,312,20.05,44.054998,-68.007138,425,261,164,421,4,"HB",0.024
"18699",512,"201604.405.1360.1","NMFS",2016,11,7,312,20.04,43.914832,-67.833892,21,15,6,20,1,"HB",0.024
"18700",512,"201604.406.1360.12","NMFS",2016,11,7,312,20.01,43.856615,-67.965105,26,23,3,26,0,"HB",0.024
"18701",512,"201604.407.1380.3","NMFS",2016,11,7,312,19.99,43.721543,-68.060353,4,4,0,4,0,"HB",0.024
"18702",512,"201604.409.1390.9","NMFS",2016,11,7,312,20.03,43.839413,-68.597032,350,197,153,280,70,"HB",0.024
"18703",512,"201604.410.1380.4","NMFS",2016,11,8,313,20.06,43.61592,-68.930347,262,153,109,253,9,"HB",0.024
"18704",513,"201604.412.1400.6","NMFS",2016,11,8,313,20,43.694195,-69.521853,345,197,148,232,113,"HB",0.024
"18705",513,"201604.413.1380.1","NMFS",2016,11,8,313,20,43.602187,-69.455955,36,26,10,34,2,"HB",0.024
"18706",513,"201604.414.1380.6","NMFS",2016,11,8,313,20.05,43.526543,-69.574505,8,7,1,8,0,"HB",0.024
"18707",513,"201604.415.1380.5","NMFS",2016,11,9,314,20.01,43.296743,-69.52282,4,4,0,4,0,"HB",0.024
"18708",513,"201604.416.1270.5","NMFS",2016,11,9,314,20.02,43.319252,-70.021405,10,10,0,10,0,"HB",0.024
"18709",513,"201604.418.1280.8","NMFS",2016,11,9,314,20.05,43.033818,-69.949597,0,0,0,0,0,"HB",0.024
